"CD","ND","DESTINO","NACION","HOMBRES","MUJERES","TOTAL"
" 01","CASCO ANTIGUO","1 - AREA METROPOLITANA","ESPA헲LES",220,237,457
" 01","CASCO ANTIGUO","1 - AREA METROPOLITANA","EXTRANJEROS",18,43,61
" 01","CASCO ANTIGUO","1 - AREA METROPOLITANA","TOTAL POBLACION",238,280,518
" 01","CASCO ANTIGUO","2 - RESTO DE LA PROVINCIA","ESPA헲LES",107,104,211
" 01","CASCO ANTIGUO","2 - RESTO DE LA PROVINCIA","EXTRANJEROS",4,12,16
" 01","CASCO ANTIGUO","2 - RESTO DE LA PROVINCIA","TOTAL POBLACION",111,116,227
" 01","CASCO ANTIGUO","3 - RESTO DE ANDALUCIA","ESPA헲LES",150,144,294
" 01","CASCO ANTIGUO","3 - RESTO DE ANDALUCIA","EXTRANJEROS",23,26,49
" 01","CASCO ANTIGUO","3 - RESTO DE ANDALUCIA","TOTAL POBLACION",173,170,343
" 01","CASCO ANTIGUO","4 - RESTO DE ESPA헤","ESPA헲LES",229,263,492
" 01","CASCO ANTIGUO","4 - RESTO DE ESPA헤","EXTRANJEROS",54,64,118
" 01","CASCO ANTIGUO","4 - RESTO DE ESPA헤","NO CONSTA",1,0,1
" 01","CASCO ANTIGUO","4 - RESTO DE ESPA헤","TOTAL POBLACION",284,327,611
" 01","CASCO ANTIGUO","5 - EXTRANJERO","ESPA헲LES",486,333,819
" 01","CASCO ANTIGUO","5 - EXTRANJERO","EXTRANJEROS",180,243,423
" 01","CASCO ANTIGUO","5 - EXTRANJERO","TOTAL POBLACION",666,576,1242
" 01","CASCO ANTIGUO","6 - TODOS","ESPA헲LES",760,785,1545
" 01","CASCO ANTIGUO","6 - TODOS","EXTRANJEROS",119,172,291
" 01","CASCO ANTIGUO","6 - TODOS","NO CONSTA",1,0,1
" 01","CASCO ANTIGUO","6 - TODOS","TOTAL POBLACION",880,957,1837
" 02","MACARENA","1 - AREA METROPOLITANA","ESPA헲LES",239,262,501
" 02","MACARENA","1 - AREA METROPOLITANA","EXTRANJEROS",53,79,132
" 02","MACARENA","1 - AREA METROPOLITANA","TOTAL POBLACION",292,341,633
" 02","MACARENA","2 - RESTO DE LA PROVINCIA","ESPA헲LES",158,144,302
" 02","MACARENA","2 - RESTO DE LA PROVINCIA","EXTRANJEROS",18,27,45
" 02","MACARENA","2 - RESTO DE LA PROVINCIA","TOTAL POBLACION",176,171,347
" 02","MACARENA","3 - RESTO DE ANDALUCIA","ESPA헲LES",110,102,212
" 02","MACARENA","3 - RESTO DE ANDALUCIA","EXTRANJEROS",46,40,86
" 02","MACARENA","3 - RESTO DE ANDALUCIA","TOTAL POBLACION",156,142,298
" 02","MACARENA","4 - RESTO DE ESPA헤","ESPA헲LES",200,192,392
" 02","MACARENA","4 - RESTO DE ESPA헤","EXTRANJEROS",91,83,174
" 02","MACARENA","4 - RESTO DE ESPA헤","TOTAL POBLACION",291,275,566
" 02","MACARENA","5 - EXTRANJERO","ESPA헲LES",513,423,936
" 02","MACARENA","5 - EXTRANJERO","EXTRANJEROS",333,243,576
" 02","MACARENA","5 - EXTRANJERO","TOTAL POBLACION",846,666,1512
" 02","MACARENA","6 - TODOS","ESPA헲LES",764,747,1511
" 02","MACARENA","6 - TODOS","EXTRANJEROS",245,256,501
" 02","MACARENA","6 - TODOS","TOTAL POBLACION",1009,1003,2012
" 03","NERVION","1 - AREA METROPOLITANA","ESPA헲LES",158,169,327
" 03","NERVION","1 - AREA METROPOLITANA","EXTRANJEROS",18,21,39
" 03","NERVION","1 - AREA METROPOLITANA","TOTAL POBLACION",176,190,366
" 03","NERVION","2 - RESTO DE LA PROVINCIA","ESPA헲LES",60,54,114
" 03","NERVION","2 - RESTO DE LA PROVINCIA","EXTRANJEROS",7,6,13
" 03","NERVION","2 - RESTO DE LA PROVINCIA","TOTAL POBLACION",67,60,127
" 03","NERVION","3 - RESTO DE ANDALUCIA","ESPA헲LES",93,88,181
" 03","NERVION","3 - RESTO DE ANDALUCIA","EXTRANJEROS",13,8,21
" 03","NERVION","3 - RESTO DE ANDALUCIA","TOTAL POBLACION",106,96,202
" 03","NERVION","4 - RESTO DE ESPA헤","ESPA헲LES",162,150,312
" 03","NERVION","4 - RESTO DE ESPA헤","EXTRANJEROS",25,33,58
" 03","NERVION","4 - RESTO DE ESPA헤","TOTAL POBLACION",187,183,370
" 03","NERVION","5 - EXTRANJERO","ESPA헲LES",270,261,531
" 03","NERVION","5 - EXTRANJERO","EXTRANJEROS",54,63,117
" 03","NERVION","5 - EXTRANJERO","TOTAL POBLACION",324,324,648
" 03","NERVION","6 - TODOS","ESPA헲LES",503,490,993
" 03","NERVION","6 - TODOS","EXTRANJEROS",69,75,144
" 03","NERVION","6 - TODOS","TOTAL POBLACION",572,565,1137
" 04","CERRO-AMATE","1 - AREA METROPOLITANA","ESPA헲LES",292,305,597
" 04","CERRO-AMATE","1 - AREA METROPOLITANA","EXTRANJEROS",50,68,118
" 04","CERRO-AMATE","1 - AREA METROPOLITANA","NO CONSTA",1,0,1
" 04","CERRO-AMATE","1 - AREA METROPOLITANA","TOTAL POBLACION",343,373,716
" 04","CERRO-AMATE","2 - RESTO DE LA PROVINCIA","ESPA헲LES",186,165,351
" 04","CERRO-AMATE","2 - RESTO DE LA PROVINCIA","EXTRANJEROS",16,22,38
" 04","CERRO-AMATE","2 - RESTO DE LA PROVINCIA","TOTAL POBLACION",202,187,389
" 04","CERRO-AMATE","3 - RESTO DE ANDALUCIA","ESPA헲LES",117,115,232
" 04","CERRO-AMATE","3 - RESTO DE ANDALUCIA","EXTRANJEROS",65,53,118
" 04","CERRO-AMATE","3 - RESTO DE ANDALUCIA","NO CONSTA",1,0,1
" 04","CERRO-AMATE","3 - RESTO DE ANDALUCIA","TOTAL POBLACION",183,168,351
" 04","CERRO-AMATE","4 - RESTO DE ESPA헤","ESPA헲LES",152,184,336
" 04","CERRO-AMATE","4 - RESTO DE ESPA헤","EXTRANJEROS",95,70,165
" 04","CERRO-AMATE","4 - RESTO DE ESPA헤","TOTAL POBLACION",247,254,501
" 04","CERRO-AMATE","5 - EXTRANJERO","ESPA헲LES",162,180,342
" 04","CERRO-AMATE","5 - EXTRANJERO","EXTRANJEROS",153,198,351
" 04","CERRO-AMATE","5 - EXTRANJERO","TOTAL POBLACION",315,378,693
" 04","CERRO-AMATE","6 - TODOS","ESPA헲LES",765,789,1554
" 04","CERRO-AMATE","6 - TODOS","EXTRANJEROS",243,235,478
" 04","CERRO-AMATE","6 - TODOS","NO CONSTA",2,0,2
" 04","CERRO-AMATE","6 - TODOS","TOTAL POBLACION",1010,1024,2034
" 05","SUR","1 - AREA METROPOLITANA","ESPA헲LES",287,268,555
" 05","SUR","1 - AREA METROPOLITANA","EXTRANJEROS",22,26,48
" 05","SUR","1 - AREA METROPOLITANA","TOTAL POBLACION",309,294,603
" 05","SUR","2 - RESTO DE LA PROVINCIA","ESPA헲LES",118,121,239
" 05","SUR","2 - RESTO DE LA PROVINCIA","EXTRANJEROS",18,38,56
" 05","SUR","2 - RESTO DE LA PROVINCIA","TOTAL POBLACION",136,159,295
" 05","SUR","3 - RESTO DE ANDALUCIA","ESPA헲LES",113,108,221
" 05","SUR","3 - RESTO DE ANDALUCIA","EXTRANJEROS",19,19,38
" 05","SUR","3 - RESTO DE ANDALUCIA","TOTAL POBLACION",132,127,259
" 05","SUR","4 - RESTO DE ESPA헤","ESPA헲LES",208,218,426
" 05","SUR","4 - RESTO DE ESPA헤","EXTRANJEROS",40,34,74
" 05","SUR","4 - RESTO DE ESPA헤","NO CONSTA",1,0,1
" 05","SUR","4 - RESTO DE ESPA헤","TOTAL POBLACION",249,252,501
" 05","SUR","5 - EXTRANJERO","ESPA헲LES",396,333,729
" 05","SUR","5 - EXTRANJERO","EXTRANJEROS",63,81,144
" 05","SUR","5 - EXTRANJERO","TOTAL POBLACION",459,414,873
" 05","SUR","6 - TODOS","ESPA헲LES",770,752,1522
" 05","SUR","6 - TODOS","EXTRANJEROS",106,126,232
" 05","SUR","6 - TODOS","NO CONSTA",1,0,1
" 05","SUR","6 - TODOS","TOTAL POBLACION",877,878,1755
" 06","TRIANA","1 - AREA METROPOLITANA","ESPA헲LES",255,201,456
" 06","TRIANA","1 - AREA METROPOLITANA","EXTRANJEROS",26,40,66
" 06","TRIANA","1 - AREA METROPOLITANA","TOTAL POBLACION",281,241,522
" 06","TRIANA","2 - RESTO DE LA PROVINCIA","ESPA헲LES",72,80,152
" 06","TRIANA","2 - RESTO DE LA PROVINCIA","EXTRANJEROS",9,15,24
" 06","TRIANA","2 - RESTO DE LA PROVINCIA","TOTAL POBLACION",81,95,176
" 06","TRIANA","3 - RESTO DE ANDALUCIA","ESPA헲LES",87,101,188
" 06","TRIANA","3 - RESTO DE ANDALUCIA","EXTRANJEROS",10,17,27
" 06","TRIANA","3 - RESTO DE ANDALUCIA","TOTAL POBLACION",97,118,215
" 06","TRIANA","4 - RESTO DE ESPA헤","ESPA헲LES",111,119,230
" 06","TRIANA","4 - RESTO DE ESPA헤","EXTRANJEROS",30,27,57
" 06","TRIANA","4 - RESTO DE ESPA헤","TOTAL POBLACION",141,146,287
" 06","TRIANA","5 - EXTRANJERO","ESPA헲LES",252,189,441
" 06","TRIANA","5 - EXTRANJERO","EXTRANJEROS",126,81,207
" 06","TRIANA","5 - EXTRANJERO","TOTAL POBLACION",378,270,648
" 06","TRIANA","6 - TODOS","ESPA헲LES",553,522,1075
" 06","TRIANA","6 - TODOS","EXTRANJEROS",89,108,197
" 06","TRIANA","6 - TODOS","TOTAL POBLACION",642,630,1272
" 07","NORTE","1 - AREA METROPOLITANA","ESPA헲LES",260,242,502
" 07","NORTE","1 - AREA METROPOLITANA","EXTRANJEROS",30,21,51
" 07","NORTE","1 - AREA METROPOLITANA","TOTAL POBLACION",290,263,553
" 07","NORTE","2 - RESTO DE LA PROVINCIA","ESPA헲LES",190,163,353
" 07","NORTE","2 - RESTO DE LA PROVINCIA","EXTRANJEROS",11,9,20
" 07","NORTE","2 - RESTO DE LA PROVINCIA","TOTAL POBLACION",201,172,373
" 07","NORTE","3 - RESTO DE ANDALUCIA","ESPA헲LES",66,87,153
" 07","NORTE","3 - RESTO DE ANDALUCIA","EXTRANJEROS",21,18,39
" 07","NORTE","3 - RESTO DE ANDALUCIA","NO CONSTA",0,1,1
" 07","NORTE","3 - RESTO DE ANDALUCIA","TOTAL POBLACION",87,106,193
" 07","NORTE","4 - RESTO DE ESPA헤","ESPA헲LES",122,97,219
" 07","NORTE","4 - RESTO DE ESPA헤","EXTRANJEROS",31,32,63
" 07","NORTE","4 - RESTO DE ESPA헤","NO CONSTA",0,1,1
" 07","NORTE","4 - RESTO DE ESPA헤","TOTAL POBLACION",153,130,283
" 07","NORTE","5 - EXTRANJERO","ESPA헲LES",99,99,198
" 07","NORTE","5 - EXTRANJERO","EXTRANJEROS",72,18,90
" 07","NORTE","5 - EXTRANJERO","TOTAL POBLACION",171,117,288
" 07","NORTE","6 - TODOS","ESPA헲LES",649,600,1249
" 07","NORTE","6 - TODOS","EXTRANJEROS",101,82,183
" 07","NORTE","6 - TODOS","NO CONSTA",0,2,2
" 07","NORTE","6 - TODOS","TOTAL POBLACION",750,684,1434
" 08","S. PABLO-STA. JUSTA","1 - AREA METROPOLITANA","ESPA헲LES",189,182,371
" 08","S. PABLO-STA. JUSTA","1 - AREA METROPOLITANA","EXTRANJEROS",17,25,42
" 08","S. PABLO-STA. JUSTA","1 - AREA METROPOLITANA","NO CONSTA",0,1,1
" 08","S. PABLO-STA. JUSTA","1 - AREA METROPOLITANA","TOTAL POBLACION",206,208,414
" 08","S. PABLO-STA. JUSTA","2 - RESTO DE LA PROVINCIA","ESPA헲LES",112,112,224
" 08","S. PABLO-STA. JUSTA","2 - RESTO DE LA PROVINCIA","EXTRANJEROS",8,7,15
" 08","S. PABLO-STA. JUSTA","2 - RESTO DE LA PROVINCIA","TOTAL POBLACION",120,119,239
" 08","S. PABLO-STA. JUSTA","3 - RESTO DE ANDALUCIA","ESPA헲LES",96,88,184
" 08","S. PABLO-STA. JUSTA","3 - RESTO DE ANDALUCIA","EXTRANJEROS",14,11,25
" 08","S. PABLO-STA. JUSTA","3 - RESTO DE ANDALUCIA","TOTAL POBLACION",110,99,209
" 08","S. PABLO-STA. JUSTA","4 - RESTO DE ESPA헤","ESPA헲LES",166,148,314
" 08","S. PABLO-STA. JUSTA","4 - RESTO DE ESPA헤","EXTRANJEROS",26,39,65
" 08","S. PABLO-STA. JUSTA","4 - RESTO DE ESPA헤","TOTAL POBLACION",192,187,379
" 08","S. PABLO-STA. JUSTA","5 - EXTRANJERO","ESPA헲LES",396,279,675
" 08","S. PABLO-STA. JUSTA","5 - EXTRANJERO","EXTRANJEROS",72,81,153
" 08","S. PABLO-STA. JUSTA","5 - EXTRANJERO","TOTAL POBLACION",468,360,828
" 08","S. PABLO-STA. JUSTA","6 - TODOS","ESPA헲LES",607,561,1168
" 08","S. PABLO-STA. JUSTA","6 - TODOS","EXTRANJEROS",73,91,164
" 08","S. PABLO-STA. JUSTA","6 - TODOS","NO CONSTA",0,1,1
" 08","S. PABLO-STA. JUSTA","6 - TODOS","TOTAL POBLACION",680,653,1333
" 09","ESTE","1 - AREA METROPOLITANA","ESPA헲LES",275,253,528
" 09","ESTE","1 - AREA METROPOLITANA","EXTRANJEROS",27,25,52
" 09","ESTE","1 - AREA METROPOLITANA","TOTAL POBLACION",302,278,580
" 09","ESTE","2 - RESTO DE LA PROVINCIA","ESPA헲LES",200,203,403
" 09","ESTE","2 - RESTO DE LA PROVINCIA","EXTRANJEROS",16,25,41
" 09","ESTE","2 - RESTO DE LA PROVINCIA","TOTAL POBLACION",216,228,444
" 09","ESTE","3 - RESTO DE ANDALUCIA","ESPA헲LES",168,156,324
" 09","ESTE","3 - RESTO DE ANDALUCIA","EXTRANJEROS",36,25,61
" 09","ESTE","3 - RESTO DE ANDALUCIA","TOTAL POBLACION",204,181,385
" 09","ESTE","4 - RESTO DE ESPA헤","ESPA헲LES",200,209,409
" 09","ESTE","4 - RESTO DE ESPA헤","EXTRANJEROS",67,50,117
" 09","ESTE","4 - RESTO DE ESPA헤","TOTAL POBLACION",267,259,526
" 09","ESTE","5 - EXTRANJERO","ESPA헲LES",144,144,288
" 09","ESTE","5 - EXTRANJERO","EXTRANJEROS",144,99,243
" 09","ESTE","5 - EXTRANJERO","TOTAL POBLACION",288,243,531
" 09","ESTE","6 - TODOS","ESPA헲LES",859,837,1696
" 09","ESTE","6 - TODOS","EXTRANJEROS",162,136,298
" 09","ESTE","6 - TODOS","TOTAL POBLACION",1021,973,1994
" 10","BELLAVISTA-LA PALMERA","1 - AREA METROPOLITANA","ESPA헲LES",194,191,385
" 10","BELLAVISTA-LA PALMERA","1 - AREA METROPOLITANA","EXTRANJEROS",8,15,23
" 10","BELLAVISTA-LA PALMERA","1 - AREA METROPOLITANA","TOTAL POBLACION",202,206,408
" 10","BELLAVISTA-LA PALMERA","2 - RESTO DE LA PROVINCIA","ESPA헲LES",40,49,89
" 10","BELLAVISTA-LA PALMERA","2 - RESTO DE LA PROVINCIA","EXTRANJEROS",6,6,12
" 10","BELLAVISTA-LA PALMERA","2 - RESTO DE LA PROVINCIA","TOTAL POBLACION",46,55,101
" 10","BELLAVISTA-LA PALMERA","3 - RESTO DE ANDALUCIA","ESPA헲LES",96,96,192
" 10","BELLAVISTA-LA PALMERA","3 - RESTO DE ANDALUCIA","EXTRANJEROS",10,15,25
" 10","BELLAVISTA-LA PALMERA","3 - RESTO DE ANDALUCIA","TOTAL POBLACION",106,111,217
" 10","BELLAVISTA-LA PALMERA","4 - RESTO DE ESPA헤","ESPA헲LES",112,130,242
" 10","BELLAVISTA-LA PALMERA","4 - RESTO DE ESPA헤","EXTRANJEROS",20,21,41
" 10","BELLAVISTA-LA PALMERA","4 - RESTO DE ESPA헤","TOTAL POBLACION",132,151,283
" 10","BELLAVISTA-LA PALMERA","5 - EXTRANJERO","ESPA헲LES",171,198,369
" 10","BELLAVISTA-LA PALMERA","5 - EXTRANJERO","EXTRANJEROS",72,54,126
" 10","BELLAVISTA-LA PALMERA","5 - EXTRANJERO","TOTAL POBLACION",243,252,495
" 10","BELLAVISTA-LA PALMERA","6 - TODOS","ESPA헲LES",461,488,949
" 10","BELLAVISTA-LA PALMERA","6 - TODOS","EXTRANJEROS",52,63,115
" 10","BELLAVISTA-LA PALMERA","6 - TODOS","TOTAL POBLACION",513,551,1064
" 11","LOS REMEDIOS","1 - AREA METROPOLITANA","ESPA헲LES",96,138,234
" 11","LOS REMEDIOS","1 - AREA METROPOLITANA","EXTRANJEROS",11,21,32
" 11","LOS REMEDIOS","1 - AREA METROPOLITANA","TOTAL POBLACION",107,159,266
" 11","LOS REMEDIOS","2 - RESTO DE LA PROVINCIA","ESPA헲LES",28,28,56
" 11","LOS REMEDIOS","2 - RESTO DE LA PROVINCIA","EXTRANJEROS",4,6,10
" 11","LOS REMEDIOS","2 - RESTO DE LA PROVINCIA","TOTAL POBLACION",32,34,66
" 11","LOS REMEDIOS","3 - RESTO DE ANDALUCIA","ESPA헲LES",53,57,110
" 11","LOS REMEDIOS","3 - RESTO DE ANDALUCIA","EXTRANJEROS",2,7,9
" 11","LOS REMEDIOS","3 - RESTO DE ANDALUCIA","TOTAL POBLACION",55,64,119
" 11","LOS REMEDIOS","4 - RESTO DE ESPA헤","ESPA헲LES",74,81,155
" 11","LOS REMEDIOS","4 - RESTO DE ESPA헤","EXTRANJEROS",10,21,31
" 11","LOS REMEDIOS","4 - RESTO DE ESPA헤","TOTAL POBLACION",84,102,186
" 11","LOS REMEDIOS","5 - EXTRANJERO","ESPA헲LES",126,171,297
" 11","LOS REMEDIOS","5 - EXTRANJERO","EXTRANJEROS",45,9,54
" 11","LOS REMEDIOS","5 - EXTRANJERO","TOTAL POBLACION",171,180,351
" 11","LOS REMEDIOS","6 - TODOS","ESPA헲LES",265,323,588
" 11","LOS REMEDIOS","6 - TODOS","EXTRANJEROS",32,56,88
" 11","LOS REMEDIOS","6 - TODOS","TOTAL POBLACION",297,379,676
"00","TOTAL MUNICIPIO","1 - AREA METROPOLITANA","ESPA헲LES",2465,2448,4913
"00","TOTAL MUNICIPIO","1 - AREA METROPOLITANA","EXTRANJEROS",280,384,664
"00","TOTAL MUNICIPIO","1 - AREA METROPOLITANA","NO CONSTA",1,1,2
"00","TOTAL MUNICIPIO","1 - AREA METROPOLITANA","TOTAL POBLACION",2746,2833,5579
"00","TOTAL MUNICIPIO","2 - RESTO DE LA PROVINCIA","ESPA헲LES",1271,1223,2494
"00","TOTAL MUNICIPIO","2 - RESTO DE LA PROVINCIA","EXTRANJEROS",117,173,290
"00","TOTAL MUNICIPIO","2 - RESTO DE LA PROVINCIA","TOTAL POBLACION",1388,1396,2784
"00","TOTAL MUNICIPIO","3 - RESTO DE ANDALUCIA","ESPA헲LES",1149,1142,2291
"00","TOTAL MUNICIPIO","3 - RESTO DE ANDALUCIA","EXTRANJEROS",259,239,498
"00","TOTAL MUNICIPIO","3 - RESTO DE ANDALUCIA","NO CONSTA",1,1,2
"00","TOTAL MUNICIPIO","3 - RESTO DE ANDALUCIA","TOTAL POBLACION",1409,1382,2791
"00","TOTAL MUNICIPIO","4 - RESTO DE ESPA헤","ESPA헲LES",1736,1791,3527
"00","TOTAL MUNICIPIO","4 - RESTO DE ESPA헤","EXTRANJEROS",489,474,963
"00","TOTAL MUNICIPIO","4 - RESTO DE ESPA헤","NO CONSTA",2,1,3
"00","TOTAL MUNICIPIO","4 - RESTO DE ESPA헤","TOTAL POBLACION",2227,2266,4493
"00","TOTAL MUNICIPIO","5 - EXTRANJERO","ESPA헲LES",3015,2610,5625
"00","TOTAL MUNICIPIO","5 - EXTRANJERO","EXTRANJEROS",1314,1170,2484
"00","TOTAL MUNICIPIO","5 - EXTRANJERO","TOTAL POBLACION",4329,3780,8109
"00","TOTAL MUNICIPIO","6 - TODOS","ESPA헲LES",6956,6894,13850
"00","TOTAL MUNICIPIO","6 - TODOS","EXTRANJEROS",1291,1400,2691
"00","TOTAL MUNICIPIO","6 - TODOS","NO CONSTA",4,3,7
"00","TOTAL MUNICIPIO","6 - TODOS","TOTAL POBLACION",8251,8297,16548
