"CD","ND","DESTINO","NACION","HOMBRES","MUJERES","TOTAL"
" 01","CASCO ANTIGUO","1 - AREA METROPOLITANA","ESPA헲LES",216,225,441
" 01","CASCO ANTIGUO","1 - AREA METROPOLITANA","EXTRANJEROS",26,26,52
" 01","CASCO ANTIGUO","1 - AREA METROPOLITANA","NO CONSTA",0,3,3
" 01","CASCO ANTIGUO","1 - AREA METROPOLITANA","TOTAL POBLACION",242,254,496
" 01","CASCO ANTIGUO","2 - RESTO DE LA PROVINCIA","ESPA헲LES",96,114,210
" 01","CASCO ANTIGUO","2 - RESTO DE LA PROVINCIA","EXTRANJEROS",4,16,20
" 01","CASCO ANTIGUO","2 - RESTO DE LA PROVINCIA","TOTAL POBLACION",100,130,230
" 01","CASCO ANTIGUO","3 - RESTO DE ANDALUCIA","ESPA헲LES",156,177,333
" 01","CASCO ANTIGUO","3 - RESTO DE ANDALUCIA","EXTRANJEROS",22,30,52
" 01","CASCO ANTIGUO","3 - RESTO DE ANDALUCIA","TOTAL POBLACION",178,207,385
" 01","CASCO ANTIGUO","4 - RESTO DE ESPA헤","ESPA헲LES",205,221,426
" 01","CASCO ANTIGUO","4 - RESTO DE ESPA헤","EXTRANJEROS",47,51,98
" 01","CASCO ANTIGUO","4 - RESTO DE ESPA헤","TOTAL POBLACION",252,272,524
" 01","CASCO ANTIGUO","5 - EXTRANJERO","ESPA헲LES",639,567,1206
" 01","CASCO ANTIGUO","5 - EXTRANJERO","EXTRANJEROS",63,117,180
" 01","CASCO ANTIGUO","5 - EXTRANJERO","TOTAL POBLACION",702,684,1386
" 01","CASCO ANTIGUO","6 - TODOS","ESPA헲LES",744,800,1544
" 01","CASCO ANTIGUO","6 - TODOS","EXTRANJEROS",106,136,242
" 01","CASCO ANTIGUO","6 - TODOS","NO CONSTA",0,3,3
" 01","CASCO ANTIGUO","6 - TODOS","TOTAL POBLACION",850,939,1789
" 02","MACARENA","1 - AREA METROPOLITANA","ESPA헲LES",250,260,510
" 02","MACARENA","1 - AREA METROPOLITANA","EXTRANJEROS",49,49,98
" 02","MACARENA","1 - AREA METROPOLITANA","TOTAL POBLACION",299,309,608
" 02","MACARENA","2 - RESTO DE LA PROVINCIA","ESPA헲LES",164,165,329
" 02","MACARENA","2 - RESTO DE LA PROVINCIA","EXTRANJEROS",23,42,65
" 02","MACARENA","2 - RESTO DE LA PROVINCIA","NO CONSTA",1,0,1
" 02","MACARENA","2 - RESTO DE LA PROVINCIA","TOTAL POBLACION",188,207,395
" 02","MACARENA","3 - RESTO DE ANDALUCIA","ESPA헲LES",165,133,298
" 02","MACARENA","3 - RESTO DE ANDALUCIA","EXTRANJEROS",31,44,75
" 02","MACARENA","3 - RESTO DE ANDALUCIA","TOTAL POBLACION",196,177,373
" 02","MACARENA","4 - RESTO DE ESPA헤","ESPA헲LES",182,207,389
" 02","MACARENA","4 - RESTO DE ESPA헤","EXTRANJEROS",87,82,169
" 02","MACARENA","4 - RESTO DE ESPA헤","NO CONSTA",1,1,2
" 02","MACARENA","4 - RESTO DE ESPA헤","TOTAL POBLACION",270,290,560
" 02","MACARENA","5 - EXTRANJERO","ESPA헲LES",522,477,999
" 02","MACARENA","5 - EXTRANJERO","EXTRANJEROS",396,225,621
" 02","MACARENA","5 - EXTRANJERO","TOTAL POBLACION",918,702,1620
" 02","MACARENA","6 - TODOS","ESPA헲LES",819,818,1637
" 02","MACARENA","6 - TODOS","EXTRANJEROS",234,242,476
" 02","MACARENA","6 - TODOS","NO CONSTA",2,1,3
" 02","MACARENA","6 - TODOS","TOTAL POBLACION",1055,1061,2116
" 03","NERVION","1 - AREA METROPOLITANA","ESPA헲LES",150,176,326
" 03","NERVION","1 - AREA METROPOLITANA","EXTRANJEROS",12,17,29
" 03","NERVION","1 - AREA METROPOLITANA","TOTAL POBLACION",162,193,355
" 03","NERVION","2 - RESTO DE LA PROVINCIA","ESPA헲LES",64,97,161
" 03","NERVION","2 - RESTO DE LA PROVINCIA","EXTRANJEROS",6,8,14
" 03","NERVION","2 - RESTO DE LA PROVINCIA","TOTAL POBLACION",70,105,175
" 03","NERVION","3 - RESTO DE ANDALUCIA","ESPA헲LES",109,126,235
" 03","NERVION","3 - RESTO DE ANDALUCIA","EXTRANJEROS",15,14,29
" 03","NERVION","3 - RESTO DE ANDALUCIA","TOTAL POBLACION",124,140,264
" 03","NERVION","4 - RESTO DE ESPA헤","ESPA헲LES",160,192,352
" 03","NERVION","4 - RESTO DE ESPA헤","EXTRANJEROS",27,29,56
" 03","NERVION","4 - RESTO DE ESPA헤","TOTAL POBLACION",187,221,408
" 03","NERVION","5 - EXTRANJERO","ESPA헲LES",360,279,639
" 03","NERVION","5 - EXTRANJERO","EXTRANJEROS",9,54,63
" 03","NERVION","5 - EXTRANJERO","TOTAL POBLACION",369,333,702
" 03","NERVION","6 - TODOS","ESPA헲LES",523,622,1145
" 03","NERVION","6 - TODOS","EXTRANJEROS",61,74,135
" 03","NERVION","6 - TODOS","TOTAL POBLACION",584,696,1280
" 04","CERRO-AMATE","1 - AREA METROPOLITANA","ESPA헲LES",302,280,582
" 04","CERRO-AMATE","1 - AREA METROPOLITANA","EXTRANJEROS",36,50,86
" 04","CERRO-AMATE","1 - AREA METROPOLITANA","NO CONSTA",0,1,1
" 04","CERRO-AMATE","1 - AREA METROPOLITANA","TOTAL POBLACION",338,331,669
" 04","CERRO-AMATE","2 - RESTO DE LA PROVINCIA","ESPA헲LES",157,152,309
" 04","CERRO-AMATE","2 - RESTO DE LA PROVINCIA","EXTRANJEROS",23,21,44
" 04","CERRO-AMATE","2 - RESTO DE LA PROVINCIA","TOTAL POBLACION",180,173,353
" 04","CERRO-AMATE","3 - RESTO DE ANDALUCIA","ESPA헲LES",134,136,270
" 04","CERRO-AMATE","3 - RESTO DE ANDALUCIA","EXTRANJEROS",49,40,89
" 04","CERRO-AMATE","3 - RESTO DE ANDALUCIA","NO CONSTA",1,0,1
" 04","CERRO-AMATE","3 - RESTO DE ANDALUCIA","TOTAL POBLACION",184,176,360
" 04","CERRO-AMATE","4 - RESTO DE ESPA헤","ESPA헲LES",199,183,382
" 04","CERRO-AMATE","4 - RESTO DE ESPA헤","EXTRANJEROS",71,60,131
" 04","CERRO-AMATE","4 - RESTO DE ESPA헤","NO CONSTA",0,1,1
" 04","CERRO-AMATE","4 - RESTO DE ESPA헤","TOTAL POBLACION",270,244,514
" 04","CERRO-AMATE","5 - EXTRANJERO","ESPA헲LES",261,306,567
" 04","CERRO-AMATE","5 - EXTRANJERO","EXTRANJEROS",216,126,342
" 04","CERRO-AMATE","5 - EXTRANJERO","TOTAL POBLACION",477,432,909
" 04","CERRO-AMATE","6 - TODOS","ESPA헲LES",821,785,1606
" 04","CERRO-AMATE","6 - TODOS","EXTRANJEROS",203,185,388
" 04","CERRO-AMATE","6 - TODOS","NO CONSTA",1,2,3
" 04","CERRO-AMATE","6 - TODOS","TOTAL POBLACION",1025,972,1997
" 05","SUR","1 - AREA METROPOLITANA","ESPA헲LES",309,301,610
" 05","SUR","1 - AREA METROPOLITANA","EXTRANJEROS",22,36,58
" 05","SUR","1 - AREA METROPOLITANA","TOTAL POBLACION",331,337,668
" 05","SUR","2 - RESTO DE LA PROVINCIA","ESPA헲LES",99,86,185
" 05","SUR","2 - RESTO DE LA PROVINCIA","EXTRANJEROS",7,11,18
" 05","SUR","2 - RESTO DE LA PROVINCIA","TOTAL POBLACION",106,97,203
" 05","SUR","3 - RESTO DE ANDALUCIA","ESPA헲LES",151,165,316
" 05","SUR","3 - RESTO DE ANDALUCIA","EXTRANJEROS",9,9,18
" 05","SUR","3 - RESTO DE ANDALUCIA","TOTAL POBLACION",160,174,334
" 05","SUR","4 - RESTO DE ESPA헤","ESPA헲LES",218,220,438
" 05","SUR","4 - RESTO DE ESPA헤","EXTRANJEROS",47,34,81
" 05","SUR","4 - RESTO DE ESPA헤","NO CONSTA",0,1,1
" 05","SUR","4 - RESTO DE ESPA헤","TOTAL POBLACION",265,255,520
" 05","SUR","5 - EXTRANJERO","ESPA헲LES",567,567,1134
" 05","SUR","5 - EXTRANJERO","EXTRANJEROS",90,72,162
" 05","SUR","5 - EXTRANJERO","TOTAL POBLACION",657,639,1296
" 05","SUR","6 - TODOS","ESPA헲LES",840,835,1675
" 05","SUR","6 - TODOS","EXTRANJEROS",95,98,193
" 05","SUR","6 - TODOS","NO CONSTA",0,1,1
" 05","SUR","6 - TODOS","TOTAL POBLACION",935,934,1869
" 06","TRIANA","1 - AREA METROPOLITANA","ESPA헲LES",226,211,437
" 06","TRIANA","1 - AREA METROPOLITANA","EXTRANJEROS",31,42,73
" 06","TRIANA","1 - AREA METROPOLITANA","TOTAL POBLACION",257,253,510
" 06","TRIANA","2 - RESTO DE LA PROVINCIA","ESPA헲LES",64,72,136
" 06","TRIANA","2 - RESTO DE LA PROVINCIA","EXTRANJEROS",2,11,13
" 06","TRIANA","2 - RESTO DE LA PROVINCIA","TOTAL POBLACION",66,83,149
" 06","TRIANA","3 - RESTO DE ANDALUCIA","ESPA헲LES",91,81,172
" 06","TRIANA","3 - RESTO DE ANDALUCIA","EXTRANJEROS",13,7,20
" 06","TRIANA","3 - RESTO DE ANDALUCIA","TOTAL POBLACION",104,88,192
" 06","TRIANA","4 - RESTO DE ESPA헤","ESPA헲LES",111,124,235
" 06","TRIANA","4 - RESTO DE ESPA헤","EXTRANJEROS",32,22,54
" 06","TRIANA","4 - RESTO DE ESPA헤","TOTAL POBLACION",143,146,289
" 06","TRIANA","5 - EXTRANJERO","ESPA헲LES",432,279,711
" 06","TRIANA","5 - EXTRANJERO","EXTRANJEROS",108,126,234
" 06","TRIANA","5 - EXTRANJERO","NO CONSTA",0,9,9
" 06","TRIANA","5 - EXTRANJERO","TOTAL POBLACION",540,414,954
" 06","TRIANA","6 - TODOS","ESPA헲LES",540,519,1059
" 06","TRIANA","6 - TODOS","EXTRANJEROS",90,96,186
" 06","TRIANA","6 - TODOS","NO CONSTA",0,1,1
" 06","TRIANA","6 - TODOS","TOTAL POBLACION",630,616,1246
" 07","NORTE","1 - AREA METROPOLITANA","ESPA헲LES",250,248,498
" 07","NORTE","1 - AREA METROPOLITANA","EXTRANJEROS",23,17,40
" 07","NORTE","1 - AREA METROPOLITANA","TOTAL POBLACION",273,265,538
" 07","NORTE","2 - RESTO DE LA PROVINCIA","ESPA헲LES",113,132,245
" 07","NORTE","2 - RESTO DE LA PROVINCIA","EXTRANJEROS",14,11,25
" 07","NORTE","2 - RESTO DE LA PROVINCIA","NO CONSTA",1,0,1
" 07","NORTE","2 - RESTO DE LA PROVINCIA","TOTAL POBLACION",128,143,271
" 07","NORTE","3 - RESTO DE ANDALUCIA","ESPA헲LES",77,86,163
" 07","NORTE","3 - RESTO DE ANDALUCIA","EXTRANJEROS",15,10,25
" 07","NORTE","3 - RESTO DE ANDALUCIA","TOTAL POBLACION",92,96,188
" 07","NORTE","4 - RESTO DE ESPA헤","ESPA헲LES",124,124,248
" 07","NORTE","4 - RESTO DE ESPA헤","EXTRANJEROS",26,27,53
" 07","NORTE","4 - RESTO DE ESPA헤","TOTAL POBLACION",150,151,301
" 07","NORTE","5 - EXTRANJERO","ESPA헲LES",243,369,612
" 07","NORTE","5 - EXTRANJERO","EXTRANJEROS",81,54,135
" 07","NORTE","5 - EXTRANJERO","TOTAL POBLACION",324,423,747
" 07","NORTE","6 - TODOS","ESPA헲LES",591,631,1222
" 07","NORTE","6 - TODOS","EXTRANJEROS",87,71,158
" 07","NORTE","6 - TODOS","NO CONSTA",1,0,1
" 07","NORTE","6 - TODOS","TOTAL POBLACION",679,702,1381
" 08","S. PABLO-STA. JUSTA","1 - AREA METROPOLITANA","ESPA헲LES",188,180,368
" 08","S. PABLO-STA. JUSTA","1 - AREA METROPOLITANA","EXTRANJEROS",10,8,18
" 08","S. PABLO-STA. JUSTA","1 - AREA METROPOLITANA","TOTAL POBLACION",198,188,386
" 08","S. PABLO-STA. JUSTA","2 - RESTO DE LA PROVINCIA","ESPA헲LES",87,96,183
" 08","S. PABLO-STA. JUSTA","2 - RESTO DE LA PROVINCIA","EXTRANJEROS",11,9,20
" 08","S. PABLO-STA. JUSTA","2 - RESTO DE LA PROVINCIA","NO CONSTA",1,1,2
" 08","S. PABLO-STA. JUSTA","2 - RESTO DE LA PROVINCIA","TOTAL POBLACION",99,106,205
" 08","S. PABLO-STA. JUSTA","3 - RESTO DE ANDALUCIA","ESPA헲LES",97,103,200
" 08","S. PABLO-STA. JUSTA","3 - RESTO DE ANDALUCIA","EXTRANJEROS",15,17,32
" 08","S. PABLO-STA. JUSTA","3 - RESTO DE ANDALUCIA","TOTAL POBLACION",112,120,232
" 08","S. PABLO-STA. JUSTA","4 - RESTO DE ESPA헤","ESPA헲LES",165,151,316
" 08","S. PABLO-STA. JUSTA","4 - RESTO DE ESPA헤","EXTRANJEROS",27,28,55
" 08","S. PABLO-STA. JUSTA","4 - RESTO DE ESPA헤","NO CONSTA",1,0,1
" 08","S. PABLO-STA. JUSTA","4 - RESTO DE ESPA헤","TOTAL POBLACION",193,179,372
" 08","S. PABLO-STA. JUSTA","5 - EXTRANJERO","ESPA헲LES",270,279,549
" 08","S. PABLO-STA. JUSTA","5 - EXTRANJERO","EXTRANJEROS",108,117,225
" 08","S. PABLO-STA. JUSTA","5 - EXTRANJERO","TOTAL POBLACION",378,396,774
" 08","S. PABLO-STA. JUSTA","6 - TODOS","ESPA헲LES",567,561,1128
" 08","S. PABLO-STA. JUSTA","6 - TODOS","EXTRANJEROS",75,75,150
" 08","S. PABLO-STA. JUSTA","6 - TODOS","NO CONSTA",2,1,3
" 08","S. PABLO-STA. JUSTA","6 - TODOS","TOTAL POBLACION",644,637,1281
" 09","ESTE","1 - AREA METROPOLITANA","ESPA헲LES",283,282,565
" 09","ESTE","1 - AREA METROPOLITANA","EXTRANJEROS",23,22,45
" 09","ESTE","1 - AREA METROPOLITANA","TOTAL POBLACION",306,304,610
" 09","ESTE","2 - RESTO DE LA PROVINCIA","ESPA헲LES",203,190,393
" 09","ESTE","2 - RESTO DE LA PROVINCIA","EXTRANJEROS",12,10,22
" 09","ESTE","2 - RESTO DE LA PROVINCIA","NO CONSTA",1,0,1
" 09","ESTE","2 - RESTO DE LA PROVINCIA","TOTAL POBLACION",216,200,416
" 09","ESTE","3 - RESTO DE ANDALUCIA","ESPA헲LES",136,141,277
" 09","ESTE","3 - RESTO DE ANDALUCIA","EXTRANJEROS",31,20,51
" 09","ESTE","3 - RESTO DE ANDALUCIA","TOTAL POBLACION",167,161,328
" 09","ESTE","4 - RESTO DE ESPA헤","ESPA헲LES",185,209,394
" 09","ESTE","4 - RESTO DE ESPA헤","EXTRANJEROS",88,62,150
" 09","ESTE","4 - RESTO DE ESPA헤","NO CONSTA",0,2,2
" 09","ESTE","4 - RESTO DE ESPA헤","TOTAL POBLACION",273,273,546
" 09","ESTE","5 - EXTRANJERO","ESPA헲LES",252,351,603
" 09","ESTE","5 - EXTRANJERO","EXTRANJEROS",108,108,216
" 09","ESTE","5 - EXTRANJERO","TOTAL POBLACION",360,459,819
" 09","ESTE","6 - TODOS","ESPA헲LES",835,861,1696
" 09","ESTE","6 - TODOS","EXTRANJEROS",166,126,292
" 09","ESTE","6 - TODOS","NO CONSTA",1,2,3
" 09","ESTE","6 - TODOS","TOTAL POBLACION",1002,989,1991
" 10","BELLAVISTA-LA PALMERA","1 - AREA METROPOLITANA","ESPA헲LES",195,197,392
" 10","BELLAVISTA-LA PALMERA","1 - AREA METROPOLITANA","EXTRANJEROS",15,21,36
" 10","BELLAVISTA-LA PALMERA","1 - AREA METROPOLITANA","TOTAL POBLACION",210,218,428
" 10","BELLAVISTA-LA PALMERA","2 - RESTO DE LA PROVINCIA","ESPA헲LES",64,58,122
" 10","BELLAVISTA-LA PALMERA","2 - RESTO DE LA PROVINCIA","EXTRANJEROS",3,8,11
" 10","BELLAVISTA-LA PALMERA","2 - RESTO DE LA PROVINCIA","TOTAL POBLACION",67,66,133
" 10","BELLAVISTA-LA PALMERA","3 - RESTO DE ANDALUCIA","ESPA헲LES",84,84,168
" 10","BELLAVISTA-LA PALMERA","3 - RESTO DE ANDALUCIA","EXTRANJEROS",9,10,19
" 10","BELLAVISTA-LA PALMERA","3 - RESTO DE ANDALUCIA","TOTAL POBLACION",93,94,187
" 10","BELLAVISTA-LA PALMERA","4 - RESTO DE ESPA헤","ESPA헲LES",147,121,268
" 10","BELLAVISTA-LA PALMERA","4 - RESTO DE ESPA헤","EXTRANJEROS",20,31,51
" 10","BELLAVISTA-LA PALMERA","4 - RESTO DE ESPA헤","TOTAL POBLACION",167,152,319
" 10","BELLAVISTA-LA PALMERA","5 - EXTRANJERO","ESPA헲LES",297,252,549
" 10","BELLAVISTA-LA PALMERA","5 - EXTRANJERO","EXTRANJEROS",63,27,90
" 10","BELLAVISTA-LA PALMERA","5 - EXTRANJERO","TOTAL POBLACION",360,279,639
" 10","BELLAVISTA-LA PALMERA","6 - TODOS","ESPA헲LES",523,488,1011
" 10","BELLAVISTA-LA PALMERA","6 - TODOS","EXTRANJEROS",54,73,127
" 10","BELLAVISTA-LA PALMERA","6 - TODOS","TOTAL POBLACION",577,561,1138
" 11","LOS REMEDIOS","1 - AREA METROPOLITANA","ESPA헲LES",112,100,212
" 11","LOS REMEDIOS","1 - AREA METROPOLITANA","EXTRANJEROS",12,22,34
" 11","LOS REMEDIOS","1 - AREA METROPOLITANA","NO CONSTA",1,0,1
" 11","LOS REMEDIOS","1 - AREA METROPOLITANA","TOTAL POBLACION",125,122,247
" 11","LOS REMEDIOS","2 - RESTO DE LA PROVINCIA","ESPA헲LES",23,34,57
" 11","LOS REMEDIOS","2 - RESTO DE LA PROVINCIA","EXTRANJEROS",3,2,5
" 11","LOS REMEDIOS","2 - RESTO DE LA PROVINCIA","TOTAL POBLACION",26,36,62
" 11","LOS REMEDIOS","3 - RESTO DE ANDALUCIA","ESPA헲LES",39,54,93
" 11","LOS REMEDIOS","3 - RESTO DE ANDALUCIA","EXTRANJEROS",5,9,14
" 11","LOS REMEDIOS","3 - RESTO DE ANDALUCIA","TOTAL POBLACION",44,63,107
" 11","LOS REMEDIOS","4 - RESTO DE ESPA헤","ESPA헲LES",87,87,174
" 11","LOS REMEDIOS","4 - RESTO DE ESPA헤","EXTRANJEROS",7,15,22
" 11","LOS REMEDIOS","4 - RESTO DE ESPA헤","TOTAL POBLACION",94,102,196
" 11","LOS REMEDIOS","5 - EXTRANJERO","ESPA헲LES",126,216,342
" 11","LOS REMEDIOS","5 - EXTRANJERO","EXTRANJEROS",27,18,45
" 11","LOS REMEDIOS","5 - EXTRANJERO","TOTAL POBLACION",153,234,387
" 11","LOS REMEDIOS","6 - TODOS","ESPA헲LES",275,299,574
" 11","LOS REMEDIOS","6 - TODOS","EXTRANJEROS",30,50,80
" 11","LOS REMEDIOS","6 - TODOS","NO CONSTA",1,0,1
" 11","LOS REMEDIOS","6 - TODOS","TOTAL POBLACION",306,349,655
"00","TOTAL MUNICIPIO","1 - AREA METROPOLITANA","ESPA헲LES",2481,2460,4941
"00","TOTAL MUNICIPIO","1 - AREA METROPOLITANA","EXTRANJEROS",259,310,569
"00","TOTAL MUNICIPIO","1 - AREA METROPOLITANA","NO CONSTA",1,4,5
"00","TOTAL MUNICIPIO","1 - AREA METROPOLITANA","TOTAL POBLACION",2741,2774,5515
"00","TOTAL MUNICIPIO","2 - RESTO DE LA PROVINCIA","ESPA헲LES",1134,1196,2330
"00","TOTAL MUNICIPIO","2 - RESTO DE LA PROVINCIA","EXTRANJEROS",108,149,257
"00","TOTAL MUNICIPIO","2 - RESTO DE LA PROVINCIA","NO CONSTA",4,1,5
"00","TOTAL MUNICIPIO","2 - RESTO DE LA PROVINCIA","TOTAL POBLACION",1246,1346,2592
"00","TOTAL MUNICIPIO","3 - RESTO DE ANDALUCIA","ESPA헲LES",1239,1286,2525
"00","TOTAL MUNICIPIO","3 - RESTO DE ANDALUCIA","EXTRANJEROS",214,210,424
"00","TOTAL MUNICIPIO","3 - RESTO DE ANDALUCIA","NO CONSTA",1,0,1
"00","TOTAL MUNICIPIO","3 - RESTO DE ANDALUCIA","TOTAL POBLACION",1454,1496,2950
"00","TOTAL MUNICIPIO","4 - RESTO DE ESPA헤","ESPA헲LES",1783,1839,3622
"00","TOTAL MUNICIPIO","4 - RESTO DE ESPA헤","EXTRANJEROS",479,441,920
"00","TOTAL MUNICIPIO","4 - RESTO DE ESPA헤","NO CONSTA",2,5,7
"00","TOTAL MUNICIPIO","4 - RESTO DE ESPA헤","TOTAL POBLACION",2264,2285,4549
"00","TOTAL MUNICIPIO","5 - EXTRANJERO","ESPA헲LES",3969,3942,7911
"00","TOTAL MUNICIPIO","5 - EXTRANJERO","EXTRANJEROS",1269,1044,2313
"00","TOTAL MUNICIPIO","5 - EXTRANJERO","NO CONSTA",0,9,9
"00","TOTAL MUNICIPIO","5 - EXTRANJERO","TOTAL POBLACION",5238,4995,10233
"00","TOTAL MUNICIPIO","6 - TODOS","ESPA헲LES",7078,7219,14297
"00","TOTAL MUNICIPIO","6 - TODOS","EXTRANJEROS",1201,1226,2427
"00","TOTAL MUNICIPIO","6 - TODOS","NO CONSTA",8,11,19
"00","TOTAL MUNICIPIO","6 - TODOS","TOTAL POBLACION",8287,8456,16743
