"CD","ND","DESTINO","NACION","HOMBRES","MUJERES","TOTAL"
" 01","CASCO ANTIGUO","1 - AREA METROPOLITANA","ESPA헲LES",223,234,457
" 01","CASCO ANTIGUO","1 - AREA METROPOLITANA","EXTRANJEROS",21,20,41
" 01","CASCO ANTIGUO","1 - AREA METROPOLITANA","TOTAL POBLACION",244,254,498
" 01","CASCO ANTIGUO","2 - RESTO DE LA PROVINCIA","ESPA헲LES",91,93,184
" 01","CASCO ANTIGUO","2 - RESTO DE LA PROVINCIA","EXTRANJEROS",3,10,13
" 01","CASCO ANTIGUO","2 - RESTO DE LA PROVINCIA","TOTAL POBLACION",94,103,197
" 01","CASCO ANTIGUO","3 - RESTO DE ANDALUCIA","ESPA헲LES",151,180,331
" 01","CASCO ANTIGUO","3 - RESTO DE ANDALUCIA","EXTRANJEROS",23,30,53
" 01","CASCO ANTIGUO","3 - RESTO DE ANDALUCIA","TOTAL POBLACION",174,210,384
" 01","CASCO ANTIGUO","4 - RESTO DE ESPA헤","ESPA헲LES",177,229,406
" 01","CASCO ANTIGUO","4 - RESTO DE ESPA헤","EXTRANJEROS",47,44,91
" 01","CASCO ANTIGUO","4 - RESTO DE ESPA헤","NO CONSTA",1,0,1
" 01","CASCO ANTIGUO","4 - RESTO DE ESPA헤","TOTAL POBLACION",225,273,498
" 01","CASCO ANTIGUO","5 - EXTRANJERO","ESPA헲LES",540,513,1053
" 01","CASCO ANTIGUO","5 - EXTRANJERO","EXTRANJEROS",99,81,180
" 01","CASCO ANTIGUO","5 - EXTRANJERO","NO CONSTA",0,9,9
" 01","CASCO ANTIGUO","5 - EXTRANJERO","TOTAL POBLACION",639,603,1242
" 01","CASCO ANTIGUO","6 - TODOS","ESPA헲LES",702,793,1495
" 01","CASCO ANTIGUO","6 - TODOS","EXTRANJEROS",105,113,218
" 01","CASCO ANTIGUO","6 - TODOS","NO CONSTA",1,1,2
" 01","CASCO ANTIGUO","6 - TODOS","TOTAL POBLACION",808,907,1715
" 02","MACARENA","1 - AREA METROPOLITANA","ESPA헲LES",248,262,510
" 02","MACARENA","1 - AREA METROPOLITANA","EXTRANJEROS",36,43,79
" 02","MACARENA","1 - AREA METROPOLITANA","NO CONSTA",1,0,1
" 02","MACARENA","1 - AREA METROPOLITANA","TOTAL POBLACION",285,305,590
" 02","MACARENA","2 - RESTO DE LA PROVINCIA","ESPA헲LES",154,163,317
" 02","MACARENA","2 - RESTO DE LA PROVINCIA","EXTRANJEROS",31,33,64
" 02","MACARENA","2 - RESTO DE LA PROVINCIA","TOTAL POBLACION",185,196,381
" 02","MACARENA","3 - RESTO DE ANDALUCIA","ESPA헲LES",129,139,268
" 02","MACARENA","3 - RESTO DE ANDALUCIA","EXTRANJEROS",33,50,83
" 02","MACARENA","3 - RESTO DE ANDALUCIA","TOTAL POBLACION",162,189,351
" 02","MACARENA","4 - RESTO DE ESPA헤","ESPA헲LES",208,203,411
" 02","MACARENA","4 - RESTO DE ESPA헤","EXTRANJEROS",112,109,221
" 02","MACARENA","4 - RESTO DE ESPA헤","NO CONSTA",0,1,1
" 02","MACARENA","4 - RESTO DE ESPA헤","TOTAL POBLACION",320,313,633
" 02","MACARENA","5 - EXTRANJERO","ESPA헲LES",675,747,1422
" 02","MACARENA","5 - EXTRANJERO","EXTRANJEROS",81,135,216
" 02","MACARENA","5 - EXTRANJERO","TOTAL POBLACION",756,882,1638
" 02","MACARENA","6 - TODOS","ESPA헲LES",814,850,1664
" 02","MACARENA","6 - TODOS","EXTRANJEROS",221,250,471
" 02","MACARENA","6 - TODOS","NO CONSTA",1,1,2
" 02","MACARENA","6 - TODOS","TOTAL POBLACION",1036,1101,2137
" 03","NERVION","1 - AREA METROPOLITANA","ESPA헲LES",142,155,297
" 03","NERVION","1 - AREA METROPOLITANA","EXTRANJEROS",10,17,27
" 03","NERVION","1 - AREA METROPOLITANA","TOTAL POBLACION",152,172,324
" 03","NERVION","2 - RESTO DE LA PROVINCIA","ESPA헲LES",67,77,144
" 03","NERVION","2 - RESTO DE LA PROVINCIA","EXTRANJEROS",3,4,7
" 03","NERVION","2 - RESTO DE LA PROVINCIA","TOTAL POBLACION",70,81,151
" 03","NERVION","3 - RESTO DE ANDALUCIA","ESPA헲LES",94,97,191
" 03","NERVION","3 - RESTO DE ANDALUCIA","EXTRANJEROS",9,7,16
" 03","NERVION","3 - RESTO DE ANDALUCIA","TOTAL POBLACION",103,104,207
" 03","NERVION","4 - RESTO DE ESPA헤","ESPA헲LES",169,169,338
" 03","NERVION","4 - RESTO DE ESPA헤","EXTRANJEROS",26,32,58
" 03","NERVION","4 - RESTO DE ESPA헤","TOTAL POBLACION",195,201,396
" 03","NERVION","5 - EXTRANJERO","ESPA헲LES",387,315,702
" 03","NERVION","5 - EXTRANJERO","EXTRANJEROS",0,99,99
" 03","NERVION","5 - EXTRANJERO","TOTAL POBLACION",387,414,801
" 03","NERVION","6 - TODOS","ESPA헲LES",515,533,1048
" 03","NERVION","6 - TODOS","EXTRANJEROS",48,71,119
" 03","NERVION","6 - TODOS","TOTAL POBLACION",563,604,1167
" 04","CERRO-AMATE","1 - AREA METROPOLITANA","ESPA헲LES",309,293,602
" 04","CERRO-AMATE","1 - AREA METROPOLITANA","EXTRANJEROS",33,50,83
" 04","CERRO-AMATE","1 - AREA METROPOLITANA","TOTAL POBLACION",342,343,685
" 04","CERRO-AMATE","2 - RESTO DE LA PROVINCIA","ESPA헲LES",172,175,347
" 04","CERRO-AMATE","2 - RESTO DE LA PROVINCIA","EXTRANJEROS",14,22,36
" 04","CERRO-AMATE","2 - RESTO DE LA PROVINCIA","TOTAL POBLACION",186,197,383
" 04","CERRO-AMATE","3 - RESTO DE ANDALUCIA","ESPA헲LES",117,111,228
" 04","CERRO-AMATE","3 - RESTO DE ANDALUCIA","EXTRANJEROS",59,56,115
" 04","CERRO-AMATE","3 - RESTO DE ANDALUCIA","TOTAL POBLACION",176,167,343
" 04","CERRO-AMATE","4 - RESTO DE ESPA헤","ESPA헲LES",167,178,345
" 04","CERRO-AMATE","4 - RESTO DE ESPA헤","EXTRANJEROS",97,119,216
" 04","CERRO-AMATE","4 - RESTO DE ESPA헤","NO CONSTA",1,1,2
" 04","CERRO-AMATE","4 - RESTO DE ESPA헤","TOTAL POBLACION",265,298,563
" 04","CERRO-AMATE","5 - EXTRANJERO","ESPA헲LES",450,396,846
" 04","CERRO-AMATE","5 - EXTRANJERO","EXTRANJEROS",81,63,144
" 04","CERRO-AMATE","5 - EXTRANJERO","TOTAL POBLACION",531,459,990
" 04","CERRO-AMATE","6 - TODOS","ESPA헲LES",815,801,1616
" 04","CERRO-AMATE","6 - TODOS","EXTRANJEROS",212,254,466
" 04","CERRO-AMATE","6 - TODOS","NO CONSTA",1,1,2
" 04","CERRO-AMATE","6 - TODOS","TOTAL POBLACION",1028,1056,2084
" 05","SUR","1 - AREA METROPOLITANA","ESPA헲LES",268,263,531
" 05","SUR","1 - AREA METROPOLITANA","EXTRANJEROS",17,32,49
" 05","SUR","1 - AREA METROPOLITANA","NO CONSTA",0,1,1
" 05","SUR","1 - AREA METROPOLITANA","TOTAL POBLACION",285,296,581
" 05","SUR","2 - RESTO DE LA PROVINCIA","ESPA헲LES",103,116,219
" 05","SUR","2 - RESTO DE LA PROVINCIA","EXTRANJEROS",9,16,25
" 05","SUR","2 - RESTO DE LA PROVINCIA","TOTAL POBLACION",112,132,244
" 05","SUR","3 - RESTO DE ANDALUCIA","ESPA헲LES",128,133,261
" 05","SUR","3 - RESTO DE ANDALUCIA","EXTRANJEROS",15,20,35
" 05","SUR","3 - RESTO DE ANDALUCIA","TOTAL POBLACION",143,153,296
" 05","SUR","4 - RESTO DE ESPA헤","ESPA헲LES",258,218,476
" 05","SUR","4 - RESTO DE ESPA헤","EXTRANJEROS",49,46,95
" 05","SUR","4 - RESTO DE ESPA헤","TOTAL POBLACION",307,264,571
" 05","SUR","5 - EXTRANJERO","ESPA헲LES",531,378,909
" 05","SUR","5 - EXTRANJERO","EXTRANJEROS",63,54,117
" 05","SUR","5 - EXTRANJERO","TOTAL POBLACION",594,432,1026
" 05","SUR","6 - TODOS","ESPA헲LES",816,772,1588
" 05","SUR","6 - TODOS","EXTRANJEROS",97,120,217
" 05","SUR","6 - TODOS","NO CONSTA",0,1,1
" 05","SUR","6 - TODOS","TOTAL POBLACION",913,893,1806
" 06","TRIANA","1 - AREA METROPOLITANA","ESPA헲LES",263,256,519
" 06","TRIANA","1 - AREA METROPOLITANA","EXTRANJEROS",23,28,51
" 06","TRIANA","1 - AREA METROPOLITANA","NO CONSTA",0,1,1
" 06","TRIANA","1 - AREA METROPOLITANA","TOTAL POBLACION",286,285,571
" 06","TRIANA","2 - RESTO DE LA PROVINCIA","ESPA헲LES",81,96,177
" 06","TRIANA","2 - RESTO DE LA PROVINCIA","EXTRANJEROS",10,8,18
" 06","TRIANA","2 - RESTO DE LA PROVINCIA","TOTAL POBLACION",91,104,195
" 06","TRIANA","3 - RESTO DE ANDALUCIA","ESPA헲LES",73,97,170
" 06","TRIANA","3 - RESTO DE ANDALUCIA","EXTRANJEROS",6,11,17
" 06","TRIANA","3 - RESTO DE ANDALUCIA","TOTAL POBLACION",79,108,187
" 06","TRIANA","4 - RESTO DE ESPA헤","ESPA헲LES",131,145,276
" 06","TRIANA","4 - RESTO DE ESPA헤","EXTRANJEROS",25,34,59
" 06","TRIANA","4 - RESTO DE ESPA헤","TOTAL POBLACION",156,179,335
" 06","TRIANA","5 - EXTRANJERO","ESPA헲LES",306,333,639
" 06","TRIANA","5 - EXTRANJERO","EXTRANJEROS",36,27,63
" 06","TRIANA","5 - EXTRANJERO","TOTAL POBLACION",342,360,702
" 06","TRIANA","6 - TODOS","ESPA헲LES",582,631,1213
" 06","TRIANA","6 - TODOS","EXTRANJEROS",68,84,152
" 06","TRIANA","6 - TODOS","NO CONSTA",0,1,1
" 06","TRIANA","6 - TODOS","TOTAL POBLACION",650,716,1366
" 07","NORTE","1 - AREA METROPOLITANA","ESPA헲LES",282,287,569
" 07","NORTE","1 - AREA METROPOLITANA","EXTRANJEROS",20,26,46
" 07","NORTE","1 - AREA METROPOLITANA","TOTAL POBLACION",302,313,615
" 07","NORTE","2 - RESTO DE LA PROVINCIA","ESPA헲LES",169,169,338
" 07","NORTE","2 - RESTO DE LA PROVINCIA","EXTRANJEROS",9,11,20
" 07","NORTE","2 - RESTO DE LA PROVINCIA","TOTAL POBLACION",178,180,358
" 07","NORTE","3 - RESTO DE ANDALUCIA","ESPA헲LES",74,94,168
" 07","NORTE","3 - RESTO DE ANDALUCIA","EXTRANJEROS",17,14,31
" 07","NORTE","3 - RESTO DE ANDALUCIA","TOTAL POBLACION",91,108,199
" 07","NORTE","4 - RESTO DE ESPA헤","ESPA헲LES",147,124,271
" 07","NORTE","4 - RESTO DE ESPA헤","EXTRANJEROS",30,27,57
" 07","NORTE","4 - RESTO DE ESPA헤","TOTAL POBLACION",177,151,328
" 07","NORTE","5 - EXTRANJERO","ESPA헲LES",333,198,531
" 07","NORTE","5 - EXTRANJERO","EXTRANJEROS",54,27,81
" 07","NORTE","5 - EXTRANJERO","TOTAL POBLACION",387,225,612
" 07","NORTE","6 - TODOS","ESPA헲LES",709,696,1405
" 07","NORTE","6 - TODOS","EXTRANJEROS",82,81,163
" 07","NORTE","6 - TODOS","TOTAL POBLACION",791,777,1568
" 08","S. PABLO-STA. JUSTA","1 - AREA METROPOLITANA","ESPA헲LES",138,136,274
" 08","S. PABLO-STA. JUSTA","1 - AREA METROPOLITANA","EXTRANJEROS",6,6,12
" 08","S. PABLO-STA. JUSTA","1 - AREA METROPOLITANA","TOTAL POBLACION",144,142,286
" 08","S. PABLO-STA. JUSTA","2 - RESTO DE LA PROVINCIA","ESPA헲LES",124,137,261
" 08","S. PABLO-STA. JUSTA","2 - RESTO DE LA PROVINCIA","EXTRANJEROS",4,9,13
" 08","S. PABLO-STA. JUSTA","2 - RESTO DE LA PROVINCIA","TOTAL POBLACION",128,146,274
" 08","S. PABLO-STA. JUSTA","3 - RESTO DE ANDALUCIA","ESPA헲LES",113,110,223
" 08","S. PABLO-STA. JUSTA","3 - RESTO DE ANDALUCIA","EXTRANJEROS",14,16,30
" 08","S. PABLO-STA. JUSTA","3 - RESTO DE ANDALUCIA","TOTAL POBLACION",127,126,253
" 08","S. PABLO-STA. JUSTA","4 - RESTO DE ESPA헤","ESPA헲LES",153,158,311
" 08","S. PABLO-STA. JUSTA","4 - RESTO DE ESPA헤","EXTRANJEROS",36,27,63
" 08","S. PABLO-STA. JUSTA","4 - RESTO DE ESPA헤","TOTAL POBLACION",189,185,374
" 08","S. PABLO-STA. JUSTA","5 - EXTRANJERO","ESPA헲LES",288,342,630
" 08","S. PABLO-STA. JUSTA","5 - EXTRANJERO","EXTRANJEROS",36,36,72
" 08","S. PABLO-STA. JUSTA","5 - EXTRANJERO","TOTAL POBLACION",324,378,702
" 08","S. PABLO-STA. JUSTA","6 - TODOS","ESPA헲LES",560,579,1139
" 08","S. PABLO-STA. JUSTA","6 - TODOS","EXTRANJEROS",64,62,126
" 08","S. PABLO-STA. JUSTA","6 - TODOS","TOTAL POBLACION",624,641,1265
" 09","ESTE","1 - AREA METROPOLITANA","ESPA헲LES",320,319,639
" 09","ESTE","1 - AREA METROPOLITANA","EXTRANJEROS",26,30,56
" 09","ESTE","1 - AREA METROPOLITANA","TOTAL POBLACION",346,349,695
" 09","ESTE","2 - RESTO DE LA PROVINCIA","ESPA헲LES",176,180,356
" 09","ESTE","2 - RESTO DE LA PROVINCIA","EXTRANJEROS",13,21,34
" 09","ESTE","2 - RESTO DE LA PROVINCIA","TOTAL POBLACION",189,201,390
" 09","ESTE","3 - RESTO DE ANDALUCIA","ESPA헲LES",163,152,315
" 09","ESTE","3 - RESTO DE ANDALUCIA","EXTRANJEROS",17,24,41
" 09","ESTE","3 - RESTO DE ANDALUCIA","TOTAL POBLACION",180,176,356
" 09","ESTE","4 - RESTO DE ESPA헤","ESPA헲LES",245,255,500
" 09","ESTE","4 - RESTO DE ESPA헤","EXTRANJEROS",74,59,133
" 09","ESTE","4 - RESTO DE ESPA헤","TOTAL POBLACION",319,314,633
" 09","ESTE","5 - EXTRANJERO","ESPA헲LES",441,531,972
" 09","ESTE","5 - EXTRANJERO","EXTRANJEROS",54,36,90
" 09","ESTE","5 - EXTRANJERO","TOTAL POBLACION",495,567,1062
" 09","ESTE","6 - TODOS","ESPA헲LES",953,965,1918
" 09","ESTE","6 - TODOS","EXTRANJEROS",136,138,274
" 09","ESTE","6 - TODOS","TOTAL POBLACION",1089,1103,2192
" 10","BELLAVISTA-LA PALMERA","1 - AREA METROPOLITANA","ESPA헲LES",180,197,377
" 10","BELLAVISTA-LA PALMERA","1 - AREA METROPOLITANA","EXTRANJEROS",13,16,29
" 10","BELLAVISTA-LA PALMERA","1 - AREA METROPOLITANA","TOTAL POBLACION",193,213,406
" 10","BELLAVISTA-LA PALMERA","2 - RESTO DE LA PROVINCIA","ESPA헲LES",66,71,137
" 10","BELLAVISTA-LA PALMERA","2 - RESTO DE LA PROVINCIA","EXTRANJEROS",4,8,12
" 10","BELLAVISTA-LA PALMERA","2 - RESTO DE LA PROVINCIA","TOTAL POBLACION",70,79,149
" 10","BELLAVISTA-LA PALMERA","3 - RESTO DE ANDALUCIA","ESPA헲LES",105,81,186
" 10","BELLAVISTA-LA PALMERA","3 - RESTO DE ANDALUCIA","EXTRANJEROS",8,11,19
" 10","BELLAVISTA-LA PALMERA","3 - RESTO DE ANDALUCIA","TOTAL POBLACION",113,92,205
" 10","BELLAVISTA-LA PALMERA","4 - RESTO DE ESPA헤","ESPA헲LES",149,138,287
" 10","BELLAVISTA-LA PALMERA","4 - RESTO DE ESPA헤","EXTRANJEROS",26,31,57
" 10","BELLAVISTA-LA PALMERA","4 - RESTO DE ESPA헤","TOTAL POBLACION",175,169,344
" 10","BELLAVISTA-LA PALMERA","5 - EXTRANJERO","ESPA헲LES",423,324,747
" 10","BELLAVISTA-LA PALMERA","5 - EXTRANJERO","EXTRANJEROS",54,45,99
" 10","BELLAVISTA-LA PALMERA","5 - EXTRANJERO","TOTAL POBLACION",477,369,846
" 10","BELLAVISTA-LA PALMERA","6 - TODOS","ESPA헲LES",547,523,1070
" 10","BELLAVISTA-LA PALMERA","6 - TODOS","EXTRANJEROS",57,71,128
" 10","BELLAVISTA-LA PALMERA","6 - TODOS","TOTAL POBLACION",604,594,1198
" 11","LOS REMEDIOS","1 - AREA METROPOLITANA","ESPA헲LES",114,129,243
" 11","LOS REMEDIOS","1 - AREA METROPOLITANA","EXTRANJEROS",4,13,17
" 11","LOS REMEDIOS","1 - AREA METROPOLITANA","TOTAL POBLACION",118,142,260
" 11","LOS REMEDIOS","2 - RESTO DE LA PROVINCIA","ESPA헲LES",38,32,70
" 11","LOS REMEDIOS","2 - RESTO DE LA PROVINCIA","EXTRANJEROS",0,2,2
" 11","LOS REMEDIOS","2 - RESTO DE LA PROVINCIA","TOTAL POBLACION",38,34,72
" 11","LOS REMEDIOS","3 - RESTO DE ANDALUCIA","ESPA헲LES",42,44,86
" 11","LOS REMEDIOS","3 - RESTO DE ANDALUCIA","EXTRANJEROS",2,4,6
" 11","LOS REMEDIOS","3 - RESTO DE ANDALUCIA","TOTAL POBLACION",44,48,92
" 11","LOS REMEDIOS","4 - RESTO DE ESPA헤","ESPA헲LES",81,101,182
" 11","LOS REMEDIOS","4 - RESTO DE ESPA헤","EXTRANJEROS",5,12,17
" 11","LOS REMEDIOS","4 - RESTO DE ESPA헤","TOTAL POBLACION",86,113,199
" 11","LOS REMEDIOS","5 - EXTRANJERO","ESPA헲LES",216,360,576
" 11","LOS REMEDIOS","5 - EXTRANJERO","EXTRANJEROS",27,18,45
" 11","LOS REMEDIOS","5 - EXTRANJERO","TOTAL POBLACION",243,378,621
" 11","LOS REMEDIOS","6 - TODOS","ESPA헲LES",299,346,645
" 11","LOS REMEDIOS","6 - TODOS","EXTRANJEROS",14,33,47
" 11","LOS REMEDIOS","6 - TODOS","TOTAL POBLACION",313,379,692
"00","TOTAL MUNICIPIO","1 - AREA METROPOLITANA","ESPA헲LES",2487,2531,5018
"00","TOTAL MUNICIPIO","1 - AREA METROPOLITANA","EXTRANJEROS",209,281,490
"00","TOTAL MUNICIPIO","1 - AREA METROPOLITANA","NO CONSTA",1,2,3
"00","TOTAL MUNICIPIO","1 - AREA METROPOLITANA","TOTAL POBLACION",2697,2814,5511
"00","TOTAL MUNICIPIO","2 - RESTO DE LA PROVINCIA","ESPA헲LES",1241,1309,2550
"00","TOTAL MUNICIPIO","2 - RESTO DE LA PROVINCIA","EXTRANJEROS",100,144,244
"00","TOTAL MUNICIPIO","2 - RESTO DE LA PROVINCIA","TOTAL POBLACION",1341,1453,2794
"00","TOTAL MUNICIPIO","3 - RESTO DE ANDALUCIA","ESPA헲LES",1189,1238,2427
"00","TOTAL MUNICIPIO","3 - RESTO DE ANDALUCIA","EXTRANJEROS",203,243,446
"00","TOTAL MUNICIPIO","3 - RESTO DE ANDALUCIA","TOTAL POBLACION",1392,1481,2873
"00","TOTAL MUNICIPIO","4 - RESTO DE ESPA헤","ESPA헲LES",1885,1918,3803
"00","TOTAL MUNICIPIO","4 - RESTO DE ESPA헤","EXTRANJEROS",527,540,1067
"00","TOTAL MUNICIPIO","4 - RESTO DE ESPA헤","NO CONSTA",2,2,4
"00","TOTAL MUNICIPIO","4 - RESTO DE ESPA헤","TOTAL POBLACION",2414,2460,4874
"00","TOTAL MUNICIPIO","5 - EXTRANJERO","ESPA헲LES",4590,4437,9027
"00","TOTAL MUNICIPIO","5 - EXTRANJERO","EXTRANJEROS",585,621,1206
"00","TOTAL MUNICIPIO","5 - EXTRANJERO","NO CONSTA",0,9,9
"00","TOTAL MUNICIPIO","5 - EXTRANJERO","TOTAL POBLACION",5175,5067,10242
"00","TOTAL MUNICIPIO","6 - TODOS","ESPA헲LES",7312,7489,14801
"00","TOTAL MUNICIPIO","6 - TODOS","EXTRANJEROS",1104,1277,2381
"00","TOTAL MUNICIPIO","6 - TODOS","NO CONSTA",3,5,8
"00","TOTAL MUNICIPIO","6 - TODOS","TOTAL POBLACION",8419,8771,17190
