"CD","ND","GRUPO","HOMBRES","MUJERES","TOTAL"
" 00","01 TOTAL DISTRITOS","TOTAL POBLACION",331931,366759,698690
" 01","CASCO ANTIGUO"," 00",243,262,505
" 01","CASCO ANTIGUO"," 01",255,212,467
" 01","CASCO ANTIGUO"," 02",227,227,454
" 01","CASCO ANTIGUO"," 03",250,224,474
" 01","CASCO ANTIGUO"," 04",263,233,496
" 01","CASCO ANTIGUO"," 05",265,238,503
" 01","CASCO ANTIGUO"," 06",261,250,511
" 01","CASCO ANTIGUO"," 07",252,241,493
" 01","CASCO ANTIGUO"," 08",276,241,517
" 01","CASCO ANTIGUO"," 09",262,257,519
" 01","CASCO ANTIGUO"," 10",283,243,526
" 01","CASCO ANTIGUO"," 11",246,278,524
" 01","CASCO ANTIGUO"," 12",251,255,506
" 01","CASCO ANTIGUO"," 13",249,246,495
" 01","CASCO ANTIGUO"," 14",244,243,487
" 01","CASCO ANTIGUO"," 15",230,259,489
" 01","CASCO ANTIGUO"," 16",230,231,461
" 01","CASCO ANTIGUO"," 17",203,224,427
" 01","CASCO ANTIGUO"," 18",214,186,400
" 01","CASCO ANTIGUO"," 19",187,208,395
" 01","CASCO ANTIGUO"," 20",228,217,445
" 01","CASCO ANTIGUO"," 21",220,222,442
" 01","CASCO ANTIGUO"," 22",225,252,477
" 01","CASCO ANTIGUO"," 23",233,247,480
" 01","CASCO ANTIGUO"," 24",236,278,514
" 01","CASCO ANTIGUO"," 25",248,293,541
" 01","CASCO ANTIGUO"," 26",284,360,644
" 01","CASCO ANTIGUO"," 27",271,344,615
" 01","CASCO ANTIGUO"," 28",310,354,664
" 01","CASCO ANTIGUO"," 29",305,383,688
" 01","CASCO ANTIGUO"," 30",342,405,747
" 01","CASCO ANTIGUO"," 31",369,435,804
" 01","CASCO ANTIGUO"," 32",421,425,846
" 01","CASCO ANTIGUO"," 33",421,489,910
" 01","CASCO ANTIGUO"," 34",469,484,953
" 01","CASCO ANTIGUO"," 35",514,503,1017
" 01","CASCO ANTIGUO"," 36",522,497,1019
" 01","CASCO ANTIGUO"," 37",499,540,1039
" 01","CASCO ANTIGUO"," 38",520,509,1029
" 01","CASCO ANTIGUO"," 39",532,534,1066
" 01","CASCO ANTIGUO"," 40",560,533,1093
" 01","CASCO ANTIGUO"," 41",525,534,1059
" 01","CASCO ANTIGUO"," 42",534,534,1068
" 01","CASCO ANTIGUO"," 43",503,500,1003
" 01","CASCO ANTIGUO"," 44",499,568,1067
" 01","CASCO ANTIGUO"," 45",475,512,987
" 01","CASCO ANTIGUO"," 46",566,513,1079
" 01","CASCO ANTIGUO"," 47",522,483,1005
" 01","CASCO ANTIGUO"," 48",490,520,1010
" 01","CASCO ANTIGUO"," 49",506,497,1003
" 01","CASCO ANTIGUO"," 50",511,526,1037
" 01","CASCO ANTIGUO"," 51",487,500,987
" 01","CASCO ANTIGUO"," 52",505,492,997
" 01","CASCO ANTIGUO"," 53",525,460,985
" 01","CASCO ANTIGUO"," 54",396,442,838
" 01","CASCO ANTIGUO"," 55",390,462,852
" 01","CASCO ANTIGUO"," 56",384,440,824
" 01","CASCO ANTIGUO"," 57",363,389,752
" 01","CASCO ANTIGUO"," 58",404,415,819
" 01","CASCO ANTIGUO"," 59",366,433,799
" 01","CASCO ANTIGUO"," 60",351,440,791
" 01","CASCO ANTIGUO"," 61",325,387,712
" 01","CASCO ANTIGUO"," 62",341,388,729
" 01","CASCO ANTIGUO"," 63",329,364,693
" 01","CASCO ANTIGUO"," 64",311,354,665
" 01","CASCO ANTIGUO"," 65",315,352,667
" 01","CASCO ANTIGUO"," 66",278,376,654
" 01","CASCO ANTIGUO"," 67",285,345,630
" 01","CASCO ANTIGUO"," 68",280,319,599
" 01","CASCO ANTIGUO"," 69",260,325,585
" 01","CASCO ANTIGUO"," 70",254,338,592
" 01","CASCO ANTIGUO"," 71",233,304,537
" 01","CASCO ANTIGUO"," 72",242,306,548
" 01","CASCO ANTIGUO"," 73",245,317,562
" 01","CASCO ANTIGUO"," 74",186,253,439
" 01","CASCO ANTIGUO"," 75",165,238,403
" 01","CASCO ANTIGUO"," 76",203,289,492
" 01","CASCO ANTIGUO"," 77",160,275,435
" 01","CASCO ANTIGUO"," 78",139,267,406
" 01","CASCO ANTIGUO"," 79",120,217,337
" 01","CASCO ANTIGUO"," 80",141,229,370
" 01","CASCO ANTIGUO"," 81",145,247,392
" 01","CASCO ANTIGUO"," 82",112,229,341
" 01","CASCO ANTIGUO"," 83",109,212,321
" 01","CASCO ANTIGUO"," 84",98,214,312
" 01","CASCO ANTIGUO"," 85",83,175,258
" 01","CASCO ANTIGUO"," 86",61,166,227
" 01","CASCO ANTIGUO"," 87",74,173,247
" 01","CASCO ANTIGUO"," 88",51,159,210
" 01","CASCO ANTIGUO"," 89",44,130,174
" 01","CASCO ANTIGUO","90 y más años",162,608,770
" 01","CASCO ANTIGUO","TOTAL POBLACION",27673,31278,58951
" 02","MACARENA"," 00",266,264,530
" 02","MACARENA"," 01",333,293,626
" 02","MACARENA"," 02",302,324,626
" 02","MACARENA"," 03",293,272,565
" 02","MACARENA"," 04",326,307,633
" 02","MACARENA"," 05",340,312,652
" 02","MACARENA"," 06",356,314,670
" 02","MACARENA"," 07",381,355,736
" 02","MACARENA"," 08",367,372,739
" 02","MACARENA"," 09",342,370,712
" 02","MACARENA"," 10",334,290,624
" 02","MACARENA"," 11",335,319,654
" 02","MACARENA"," 12",329,309,638
" 02","MACARENA"," 13",304,285,589
" 02","MACARENA"," 14",270,282,552
" 02","MACARENA"," 15",285,300,585
" 02","MACARENA"," 16",309,296,605
" 02","MACARENA"," 17",297,266,563
" 02","MACARENA"," 18",323,278,601
" 02","MACARENA"," 19",320,308,628
" 02","MACARENA"," 20",325,336,661
" 02","MACARENA"," 21",328,324,652
" 02","MACARENA"," 22",381,370,751
" 02","MACARENA"," 23",382,391,773
" 02","MACARENA"," 24",399,366,765
" 02","MACARENA"," 25",375,412,787
" 02","MACARENA"," 26",411,382,793
" 02","MACARENA"," 27",422,410,832
" 02","MACARENA"," 28",390,432,822
" 02","MACARENA"," 29",426,420,846
" 02","MACARENA"," 30",452,474,926
" 02","MACARENA"," 31",482,496,978
" 02","MACARENA"," 32",542,533,1075
" 02","MACARENA"," 33",516,532,1048
" 02","MACARENA"," 34",503,597,1100
" 02","MACARENA"," 35",540,589,1129
" 02","MACARENA"," 36",617,600,1217
" 02","MACARENA"," 37",607,600,1207
" 02","MACARENA"," 38",618,621,1239
" 02","MACARENA"," 39",615,638,1253
" 02","MACARENA"," 40",638,636,1274
" 02","MACARENA"," 41",588,647,1235
" 02","MACARENA"," 42",598,620,1218
" 02","MACARENA"," 43",614,562,1176
" 02","MACARENA"," 44",585,611,1196
" 02","MACARENA"," 45",579,552,1131
" 02","MACARENA"," 46",514,536,1050
" 02","MACARENA"," 47",538,541,1079
" 02","MACARENA"," 48",534,602,1136
" 02","MACARENA"," 49",498,537,1035
" 02","MACARENA"," 50",554,545,1099
" 02","MACARENA"," 51",527,534,1061
" 02","MACARENA"," 52",526,619,1145
" 02","MACARENA"," 53",484,565,1049
" 02","MACARENA"," 54",458,553,1011
" 02","MACARENA"," 55",449,551,1000
" 02","MACARENA"," 56",492,513,1005
" 02","MACARENA"," 57",461,469,930
" 02","MACARENA"," 58",455,497,952
" 02","MACARENA"," 59",428,508,936
" 02","MACARENA"," 60",384,467,851
" 02","MACARENA"," 61",396,477,873
" 02","MACARENA"," 62",336,446,782
" 02","MACARENA"," 63",327,483,810
" 02","MACARENA"," 64",349,457,806
" 02","MACARENA"," 65",352,453,805
" 02","MACARENA"," 66",332,444,776
" 02","MACARENA"," 67",356,528,884
" 02","MACARENA"," 68",367,594,961
" 02","MACARENA"," 69",382,540,922
" 02","MACARENA"," 70",348,554,902
" 02","MACARENA"," 71",417,589,1006
" 02","MACARENA"," 72",396,560,956
" 02","MACARENA"," 73",421,555,976
" 02","MACARENA"," 74",314,439,753
" 02","MACARENA"," 75",314,377,691
" 02","MACARENA"," 76",330,465,795
" 02","MACARENA"," 77",290,376,666
" 02","MACARENA"," 78",228,397,625
" 02","MACARENA"," 79",230,312,542
" 02","MACARENA"," 80",206,429,635
" 02","MACARENA"," 81",226,397,623
" 02","MACARENA"," 82",182,334,516
" 02","MACARENA"," 83",182,327,509
" 02","MACARENA"," 84",160,316,476
" 02","MACARENA"," 85",127,290,417
" 02","MACARENA"," 86",129,260,389
" 02","MACARENA"," 87",107,240,347
" 02","MACARENA"," 88",62,233,295
" 02","MACARENA"," 89",48,135,183
" 02","MACARENA","90 y más años",190,571,761
" 02","MACARENA","TOTAL POBLACION",34751,39882,74633
" 03","NERVION"," 00",251,198,449
" 03","NERVION"," 01",203,214,417
" 03","NERVION"," 02",253,232,485
" 03","NERVION"," 03",221,234,455
" 03","NERVION"," 04",256,242,498
" 03","NERVION"," 05",244,259,503
" 03","NERVION"," 06",230,213,443
" 03","NERVION"," 07",256,254,510
" 03","NERVION"," 08",245,210,455
" 03","NERVION"," 09",258,211,469
" 03","NERVION"," 10",254,261,515
" 03","NERVION"," 11",264,247,511
" 03","NERVION"," 12",270,231,501
" 03","NERVION"," 13",270,231,501
" 03","NERVION"," 14",245,213,458
" 03","NERVION"," 15",229,259,488
" 03","NERVION"," 16",243,222,465
" 03","NERVION"," 17",228,215,443
" 03","NERVION"," 18",210,245,455
" 03","NERVION"," 19",229,264,493
" 03","NERVION"," 20",272,232,504
" 03","NERVION"," 21",243,224,467
" 03","NERVION"," 22",242,266,508
" 03","NERVION"," 23",213,255,468
" 03","NERVION"," 24",257,241,498
" 03","NERVION"," 25",248,267,515
" 03","NERVION"," 26",255,236,491
" 03","NERVION"," 27",269,237,506
" 03","NERVION"," 28",270,285,555
" 03","NERVION"," 29",279,254,533
" 03","NERVION"," 30",254,306,560
" 03","NERVION"," 31",288,291,579
" 03","NERVION"," 32",271,309,580
" 03","NERVION"," 33",268,332,600
" 03","NERVION"," 34",316,361,677
" 03","NERVION"," 35",345,318,663
" 03","NERVION"," 36",342,376,718
" 03","NERVION"," 37",356,354,710
" 03","NERVION"," 38",395,383,778
" 03","NERVION"," 39",371,400,771
" 03","NERVION"," 40",377,473,850
" 03","NERVION"," 41",380,362,742
" 03","NERVION"," 42",353,403,756
" 03","NERVION"," 43",364,387,751
" 03","NERVION"," 44",365,401,766
" 03","NERVION"," 45",343,368,711
" 03","NERVION"," 46",347,374,721
" 03","NERVION"," 47",333,415,748
" 03","NERVION"," 48",350,404,754
" 03","NERVION"," 49",325,425,750
" 03","NERVION"," 50",389,411,800
" 03","NERVION"," 51",349,426,775
" 03","NERVION"," 52",338,403,741
" 03","NERVION"," 53",351,399,750
" 03","NERVION"," 54",356,370,726
" 03","NERVION"," 55",305,380,685
" 03","NERVION"," 56",296,379,675
" 03","NERVION"," 57",291,396,687
" 03","NERVION"," 58",279,365,644
" 03","NERVION"," 59",281,387,668
" 03","NERVION"," 60",279,350,629
" 03","NERVION"," 61",258,395,653
" 03","NERVION"," 62",274,315,589
" 03","NERVION"," 63",291,381,672
" 03","NERVION"," 64",270,375,645
" 03","NERVION"," 65",282,340,622
" 03","NERVION"," 66",249,376,625
" 03","NERVION"," 67",279,420,699
" 03","NERVION"," 68",330,406,736
" 03","NERVION"," 69",275,381,656
" 03","NERVION"," 70",282,345,627
" 03","NERVION"," 71",286,360,646
" 03","NERVION"," 72",297,389,686
" 03","NERVION"," 73",256,369,625
" 03","NERVION"," 74",232,326,558
" 03","NERVION"," 75",212,279,491
" 03","NERVION"," 76",191,274,465
" 03","NERVION"," 77",165,235,400
" 03","NERVION"," 78",141,245,386
" 03","NERVION"," 79",161,236,397
" 03","NERVION"," 80",154,282,436
" 03","NERVION"," 81",152,253,405
" 03","NERVION"," 82",137,210,347
" 03","NERVION"," 83",109,217,326
" 03","NERVION"," 84",123,216,339
" 03","NERVION"," 85",87,181,268
" 03","NERVION"," 86",79,193,272
" 03","NERVION"," 87",70,165,235
" 03","NERVION"," 88",66,148,214
" 03","NERVION"," 89",38,116,154
" 03","NERVION","90 y más años",135,460,595
" 03","NERVION","TOTAL POBLACION",23545,27748,51293
" 04","CERRO-AMATE"," 00",413,383,796
" 04","CERRO-AMATE"," 01",387,393,780
" 04","CERRO-AMATE"," 02",439,382,821
" 04","CERRO-AMATE"," 03",432,428,860
" 04","CERRO-AMATE"," 04",466,430,896
" 04","CERRO-AMATE"," 05",471,439,910
" 04","CERRO-AMATE"," 06",520,505,1025
" 04","CERRO-AMATE"," 07",493,533,1026
" 04","CERRO-AMATE"," 08",603,569,1172
" 04","CERRO-AMATE"," 09",594,539,1133
" 04","CERRO-AMATE"," 10",495,520,1015
" 04","CERRO-AMATE"," 11",480,482,962
" 04","CERRO-AMATE"," 12",458,402,860
" 04","CERRO-AMATE"," 13",377,386,763
" 04","CERRO-AMATE"," 14",399,377,776
" 04","CERRO-AMATE"," 15",419,426,845
" 04","CERRO-AMATE"," 16",399,398,797
" 04","CERRO-AMATE"," 17",406,395,801
" 04","CERRO-AMATE"," 18",417,364,781
" 04","CERRO-AMATE"," 19",418,397,815
" 04","CERRO-AMATE"," 20",412,434,846
" 04","CERRO-AMATE"," 21",472,444,916
" 04","CERRO-AMATE"," 22",504,488,992
" 04","CERRO-AMATE"," 23",538,503,1041
" 04","CERRO-AMATE"," 24",533,537,1070
" 04","CERRO-AMATE"," 25",572,513,1085
" 04","CERRO-AMATE"," 26",536,566,1102
" 04","CERRO-AMATE"," 27",576,532,1108
" 04","CERRO-AMATE"," 28",636,567,1203
" 04","CERRO-AMATE"," 29",588,575,1163
" 04","CERRO-AMATE"," 30",599,577,1176
" 04","CERRO-AMATE"," 31",565,588,1153
" 04","CERRO-AMATE"," 32",559,535,1094
" 04","CERRO-AMATE"," 33",610,605,1215
" 04","CERRO-AMATE"," 34",671,660,1331
" 04","CERRO-AMATE"," 35",665,690,1355
" 04","CERRO-AMATE"," 36",786,704,1490
" 04","CERRO-AMATE"," 37",779,720,1499
" 04","CERRO-AMATE"," 38",841,835,1676
" 04","CERRO-AMATE"," 39",858,805,1663
" 04","CERRO-AMATE"," 40",857,810,1667
" 04","CERRO-AMATE"," 41",836,711,1547
" 04","CERRO-AMATE"," 42",755,740,1495
" 04","CERRO-AMATE"," 43",742,682,1424
" 04","CERRO-AMATE"," 44",719,643,1362
" 04","CERRO-AMATE"," 45",701,639,1340
" 04","CERRO-AMATE"," 46",634,656,1290
" 04","CERRO-AMATE"," 47",656,632,1288
" 04","CERRO-AMATE"," 48",599,659,1258
" 04","CERRO-AMATE"," 49",560,592,1152
" 04","CERRO-AMATE"," 50",626,715,1341
" 04","CERRO-AMATE"," 51",626,649,1275
" 04","CERRO-AMATE"," 52",630,671,1301
" 04","CERRO-AMATE"," 53",643,678,1321
" 04","CERRO-AMATE"," 54",588,619,1207
" 04","CERRO-AMATE"," 55",576,612,1188
" 04","CERRO-AMATE"," 56",554,588,1142
" 04","CERRO-AMATE"," 57",532,575,1107
" 04","CERRO-AMATE"," 58",530,619,1149
" 04","CERRO-AMATE"," 59",572,623,1195
" 04","CERRO-AMATE"," 60",453,566,1019
" 04","CERRO-AMATE"," 61",487,549,1036
" 04","CERRO-AMATE"," 62",467,511,978
" 04","CERRO-AMATE"," 63",461,505,966
" 04","CERRO-AMATE"," 64",437,481,918
" 04","CERRO-AMATE"," 65",421,495,916
" 04","CERRO-AMATE"," 66",356,432,788
" 04","CERRO-AMATE"," 67",444,493,937
" 04","CERRO-AMATE"," 68",432,512,944
" 04","CERRO-AMATE"," 69",379,472,851
" 04","CERRO-AMATE"," 70",302,404,706
" 04","CERRO-AMATE"," 71",381,495,876
" 04","CERRO-AMATE"," 72",360,439,799
" 04","CERRO-AMATE"," 73",365,442,807
" 04","CERRO-AMATE"," 74",236,363,599
" 04","CERRO-AMATE"," 75",256,306,562
" 04","CERRO-AMATE"," 76",255,397,652
" 04","CERRO-AMATE"," 77",230,287,517
" 04","CERRO-AMATE"," 78",221,294,515
" 04","CERRO-AMATE"," 79",202,306,508
" 04","CERRO-AMATE"," 80",226,348,574
" 04","CERRO-AMATE"," 81",175,356,531
" 04","CERRO-AMATE"," 82",167,279,446
" 04","CERRO-AMATE"," 83",179,311,490
" 04","CERRO-AMATE"," 84",155,303,458
" 04","CERRO-AMATE"," 85",108,224,332
" 04","CERRO-AMATE"," 86",112,232,344
" 04","CERRO-AMATE"," 87",91,203,294
" 04","CERRO-AMATE"," 88",68,177,245
" 04","CERRO-AMATE"," 89",54,112,166
" 04","CERRO-AMATE","90 y más años",180,464,644
" 04","CERRO-AMATE","TOTAL POBLACION",42982,45497,88479
" 05","SUR"," 00",361,293,654
" 05","SUR"," 01",344,326,670
" 05","SUR"," 02",308,316,624
" 05","SUR"," 03",332,328,660
" 05","SUR"," 04",360,349,709
" 05","SUR"," 05",341,346,687
" 05","SUR"," 06",375,369,744
" 05","SUR"," 07",458,364,822
" 05","SUR"," 08",441,375,816
" 05","SUR"," 09",398,380,778
" 05","SUR"," 10",409,368,777
" 05","SUR"," 11",387,408,795
" 05","SUR"," 12",394,382,776
" 05","SUR"," 13",398,419,817
" 05","SUR"," 14",388,401,789
" 05","SUR"," 15",397,369,766
" 05","SUR"," 16",424,399,823
" 05","SUR"," 17",361,360,721
" 05","SUR"," 18",400,378,778
" 05","SUR"," 19",400,393,793
" 05","SUR"," 20",398,372,770
" 05","SUR"," 21",369,396,765
" 05","SUR"," 22",384,393,777
" 05","SUR"," 23",392,438,830
" 05","SUR"," 24",395,410,805
" 05","SUR"," 25",473,417,890
" 05","SUR"," 26",432,433,865
" 05","SUR"," 27",454,415,869
" 05","SUR"," 28",402,410,812
" 05","SUR"," 29",422,429,851
" 05","SUR"," 30",406,412,818
" 05","SUR"," 31",463,441,904
" 05","SUR"," 32",444,458,902
" 05","SUR"," 33",477,430,907
" 05","SUR"," 34",506,448,954
" 05","SUR"," 35",468,487,955
" 05","SUR"," 36",528,496,1024
" 05","SUR"," 37",506,509,1015
" 05","SUR"," 38",510,544,1054
" 05","SUR"," 39",563,555,1118
" 05","SUR"," 40",537,499,1036
" 05","SUR"," 41",496,537,1033
" 05","SUR"," 42",530,523,1053
" 05","SUR"," 43",499,525,1024
" 05","SUR"," 44",524,490,1014
" 05","SUR"," 45",425,519,944
" 05","SUR"," 46",510,519,1029
" 05","SUR"," 47",494,519,1013
" 05","SUR"," 48",485,591,1076
" 05","SUR"," 49",506,561,1067
" 05","SUR"," 50",553,559,1112
" 05","SUR"," 51",499,560,1059
" 05","SUR"," 52",494,560,1054
" 05","SUR"," 53",523,562,1085
" 05","SUR"," 54",479,546,1025
" 05","SUR"," 55",452,468,920
" 05","SUR"," 56",436,522,958
" 05","SUR"," 57",404,483,887
" 05","SUR"," 58",408,485,893
" 05","SUR"," 59",409,466,875
" 05","SUR"," 60",369,462,831
" 05","SUR"," 61",345,469,814
" 05","SUR"," 62",323,431,754
" 05","SUR"," 63",349,425,774
" 05","SUR"," 64",342,409,751
" 05","SUR"," 65",327,404,731
" 05","SUR"," 66",294,363,657
" 05","SUR"," 67",342,429,771
" 05","SUR"," 68",317,422,739
" 05","SUR"," 69",309,425,734
" 05","SUR"," 70",273,367,640
" 05","SUR"," 71",312,417,729
" 05","SUR"," 72",321,447,768
" 05","SUR"," 73",315,438,753
" 05","SUR"," 74",235,356,591
" 05","SUR"," 75",240,300,540
" 05","SUR"," 76",284,381,665
" 05","SUR"," 77",235,299,534
" 05","SUR"," 78",229,330,559
" 05","SUR"," 79",200,293,493
" 05","SUR"," 80",186,336,522
" 05","SUR"," 81",189,304,493
" 05","SUR"," 82",161,275,436
" 05","SUR"," 83",177,272,449
" 05","SUR"," 84",121,278,399
" 05","SUR"," 85",88,223,311
" 05","SUR"," 86",89,202,291
" 05","SUR"," 87",74,188,262
" 05","SUR"," 88",67,146,213
" 05","SUR"," 89",67,103,170
" 05","SUR","90 y más años",161,437,598
" 05","SUR","TOTAL POBLACION",33672,37341,71013
" 06","TRIANA"," 00",194,179,373
" 06","TRIANA"," 01",186,181,367
" 06","TRIANA"," 02",181,186,367
" 06","TRIANA"," 03",199,178,377
" 06","TRIANA"," 04",198,215,413
" 06","TRIANA"," 05",191,193,384
" 06","TRIANA"," 06",198,216,414
" 06","TRIANA"," 07",219,239,458
" 06","TRIANA"," 08",208,223,431
" 06","TRIANA"," 09",227,211,438
" 06","TRIANA"," 10",215,202,417
" 06","TRIANA"," 11",223,249,472
" 06","TRIANA"," 12",207,205,412
" 06","TRIANA"," 13",212,215,427
" 06","TRIANA"," 14",220,216,436
" 06","TRIANA"," 15",188,191,379
" 06","TRIANA"," 16",223,200,423
" 06","TRIANA"," 17",222,179,401
" 06","TRIANA"," 18",182,188,370
" 06","TRIANA"," 19",211,199,410
" 06","TRIANA"," 20",204,193,397
" 06","TRIANA"," 21",208,211,419
" 06","TRIANA"," 22",192,230,422
" 06","TRIANA"," 23",217,220,437
" 06","TRIANA"," 24",240,225,465
" 06","TRIANA"," 25",262,242,504
" 06","TRIANA"," 26",226,238,464
" 06","TRIANA"," 27",202,257,459
" 06","TRIANA"," 28",252,258,510
" 06","TRIANA"," 29",269,253,522
" 06","TRIANA"," 30",236,273,509
" 06","TRIANA"," 31",226,301,527
" 06","TRIANA"," 32",264,276,540
" 06","TRIANA"," 33",301,319,620
" 06","TRIANA"," 34",281,336,617
" 06","TRIANA"," 35",323,344,667
" 06","TRIANA"," 36",344,344,688
" 06","TRIANA"," 37",357,327,684
" 06","TRIANA"," 38",371,393,764
" 06","TRIANA"," 39",386,403,789
" 06","TRIANA"," 40",343,417,760
" 06","TRIANA"," 41",353,359,712
" 06","TRIANA"," 42",373,433,806
" 06","TRIANA"," 43",359,424,783
" 06","TRIANA"," 44",368,364,732
" 06","TRIANA"," 45",343,380,723
" 06","TRIANA"," 46",356,377,733
" 06","TRIANA"," 47",363,398,761
" 06","TRIANA"," 48",355,371,726
" 06","TRIANA"," 49",396,394,790
" 06","TRIANA"," 50",334,423,757
" 06","TRIANA"," 51",357,407,764
" 06","TRIANA"," 52",367,445,812
" 06","TRIANA"," 53",316,408,724
" 06","TRIANA"," 54",313,348,661
" 06","TRIANA"," 55",319,386,705
" 06","TRIANA"," 56",304,382,686
" 06","TRIANA"," 57",292,387,679
" 06","TRIANA"," 58",281,350,631
" 06","TRIANA"," 59",291,358,649
" 06","TRIANA"," 60",245,305,550
" 06","TRIANA"," 61",259,318,577
" 06","TRIANA"," 62",215,284,499
" 06","TRIANA"," 63",217,321,538
" 06","TRIANA"," 64",233,351,584
" 06","TRIANA"," 65",239,342,581
" 06","TRIANA"," 66",204,358,562
" 06","TRIANA"," 67",232,314,546
" 06","TRIANA"," 68",277,357,634
" 06","TRIANA"," 69",278,350,628
" 06","TRIANA"," 70",239,341,580
" 06","TRIANA"," 71",276,390,666
" 06","TRIANA"," 72",250,383,633
" 06","TRIANA"," 73",270,404,674
" 06","TRIANA"," 74",211,327,538
" 06","TRIANA"," 75",192,265,457
" 06","TRIANA"," 76",231,320,551
" 06","TRIANA"," 77",160,260,420
" 06","TRIANA"," 78",159,253,412
" 06","TRIANA"," 79",144,213,357
" 06","TRIANA"," 80",165,255,420
" 06","TRIANA"," 81",162,274,436
" 06","TRIANA"," 82",119,224,343
" 06","TRIANA"," 83",99,254,353
" 06","TRIANA"," 84",100,256,356
" 06","TRIANA"," 85",109,212,321
" 06","TRIANA"," 86",86,175,261
" 06","TRIANA"," 87",78,177,255
" 06","TRIANA"," 88",53,145,198
" 06","TRIANA"," 89",55,145,200
" 06","TRIANA","90 y más años",153,504,657
" 06","TRIANA","TOTAL POBLACION",21958,26596,48554
" 07","NORTE"," 00",371,313,684
" 07","NORTE"," 01",369,312,681
" 07","NORTE"," 02",353,346,699
" 07","NORTE"," 03",355,335,690
" 07","NORTE"," 04",362,322,684
" 07","NORTE"," 05",351,366,717
" 07","NORTE"," 06",399,365,764
" 07","NORTE"," 07",424,373,797
" 07","NORTE"," 08",410,444,854
" 07","NORTE"," 09",390,381,771
" 07","NORTE"," 10",397,361,758
" 07","NORTE"," 11",404,371,775
" 07","NORTE"," 12",399,358,757
" 07","NORTE"," 13",430,392,822
" 07","NORTE"," 14",352,365,717
" 07","NORTE"," 15",390,360,750
" 07","NORTE"," 16",426,388,814
" 07","NORTE"," 17",380,377,757
" 07","NORTE"," 18",376,369,745
" 07","NORTE"," 19",386,359,745
" 07","NORTE"," 20",408,355,763
" 07","NORTE"," 21",396,374,770
" 07","NORTE"," 22",420,376,796
" 07","NORTE"," 23",451,395,846
" 07","NORTE"," 24",479,405,884
" 07","NORTE"," 25",499,413,912
" 07","NORTE"," 26",433,433,866
" 07","NORTE"," 27",446,456,902
" 07","NORTE"," 28",467,438,905
" 07","NORTE"," 29",465,485,950
" 07","NORTE"," 30",470,496,966
" 07","NORTE"," 31",549,553,1102
" 07","NORTE"," 32",550,523,1073
" 07","NORTE"," 33",622,544,1166
" 07","NORTE"," 34",627,574,1201
" 07","NORTE"," 35",586,596,1182
" 07","NORTE"," 36",596,597,1193
" 07","NORTE"," 37",638,579,1217
" 07","NORTE"," 38",651,638,1289
" 07","NORTE"," 39",651,646,1297
" 07","NORTE"," 40",632,600,1232
" 07","NORTE"," 41",606,604,1210
" 07","NORTE"," 42",564,522,1086
" 07","NORTE"," 43",532,593,1125
" 07","NORTE"," 44",540,621,1161
" 07","NORTE"," 45",520,580,1100
" 07","NORTE"," 46",585,608,1193
" 07","NORTE"," 47",575,643,1218
" 07","NORTE"," 48",594,595,1189
" 07","NORTE"," 49",594,636,1230
" 07","NORTE"," 50",609,643,1252
" 07","NORTE"," 51",562,695,1257
" 07","NORTE"," 52",585,639,1224
" 07","NORTE"," 53",562,662,1224
" 07","NORTE"," 54",513,586,1099
" 07","NORTE"," 55",506,598,1104
" 07","NORTE"," 56",532,668,1200
" 07","NORTE"," 57",523,626,1149
" 07","NORTE"," 58",559,671,1230
" 07","NORTE"," 59",607,668,1275
" 07","NORTE"," 60",520,595,1115
" 07","NORTE"," 61",476,543,1019
" 07","NORTE"," 62",477,476,953
" 07","NORTE"," 63",423,436,859
" 07","NORTE"," 64",433,401,834
" 07","NORTE"," 65",373,366,739
" 07","NORTE"," 66",312,333,645
" 07","NORTE"," 67",365,377,742
" 07","NORTE"," 68",295,349,644
" 07","NORTE"," 69",296,346,642
" 07","NORTE"," 70",232,272,504
" 07","NORTE"," 71",270,309,579
" 07","NORTE"," 72",247,293,540
" 07","NORTE"," 73",230,310,540
" 07","NORTE"," 74",164,195,359
" 07","NORTE"," 75",155,162,317
" 07","NORTE"," 76",177,232,409
" 07","NORTE"," 77",136,202,338
" 07","NORTE"," 78",105,170,275
" 07","NORTE"," 79",102,160,262
" 07","NORTE"," 80",109,211,320
" 07","NORTE"," 81",97,161,258
" 07","NORTE"," 82",83,161,244
" 07","NORTE"," 83",85,173,258
" 07","NORTE"," 84",79,147,226
" 07","NORTE"," 85",73,133,206
" 07","NORTE"," 86",61,127,188
" 07","NORTE"," 87",36,112,148
" 07","NORTE"," 88",40,81,121
" 07","NORTE"," 89",26,56,82
" 07","NORTE","90 y más años",84,273,357
" 07","NORTE","TOTAL POBLACION",35989,37753,73742
" 08","S. PABLO-STA. JUSTA"," 00",233,225,458
" 08","S. PABLO-STA. JUSTA"," 01",232,223,455
" 08","S. PABLO-STA. JUSTA"," 02",249,221,470
" 08","S. PABLO-STA. JUSTA"," 03",274,223,497
" 08","S. PABLO-STA. JUSTA"," 04",294,252,546
" 08","S. PABLO-STA. JUSTA"," 05",268,254,522
" 08","S. PABLO-STA. JUSTA"," 06",259,271,530
" 08","S. PABLO-STA. JUSTA"," 07",305,284,589
" 08","S. PABLO-STA. JUSTA"," 08",286,262,548
" 08","S. PABLO-STA. JUSTA"," 09",301,260,561
" 08","S. PABLO-STA. JUSTA"," 10",289,305,594
" 08","S. PABLO-STA. JUSTA"," 11",263,277,540
" 08","S. PABLO-STA. JUSTA"," 12",271,253,524
" 08","S. PABLO-STA. JUSTA"," 13",278,278,556
" 08","S. PABLO-STA. JUSTA"," 14",267,256,523
" 08","S. PABLO-STA. JUSTA"," 15",280,244,524
" 08","S. PABLO-STA. JUSTA"," 16",278,245,523
" 08","S. PABLO-STA. JUSTA"," 17",291,228,519
" 08","S. PABLO-STA. JUSTA"," 18",273,243,516
" 08","S. PABLO-STA. JUSTA"," 19",300,292,592
" 08","S. PABLO-STA. JUSTA"," 20",300,272,572
" 08","S. PABLO-STA. JUSTA"," 21",297,287,584
" 08","S. PABLO-STA. JUSTA"," 22",315,299,614
" 08","S. PABLO-STA. JUSTA"," 23",336,302,638
" 08","S. PABLO-STA. JUSTA"," 24",356,340,696
" 08","S. PABLO-STA. JUSTA"," 25",370,315,685
" 08","S. PABLO-STA. JUSTA"," 26",314,319,633
" 08","S. PABLO-STA. JUSTA"," 27",330,335,665
" 08","S. PABLO-STA. JUSTA"," 28",312,328,640
" 08","S. PABLO-STA. JUSTA"," 29",335,370,705
" 08","S. PABLO-STA. JUSTA"," 30",332,346,678
" 08","S. PABLO-STA. JUSTA"," 31",333,350,683
" 08","S. PABLO-STA. JUSTA"," 32",352,377,729
" 08","S. PABLO-STA. JUSTA"," 33",382,350,732
" 08","S. PABLO-STA. JUSTA"," 34",406,381,787
" 08","S. PABLO-STA. JUSTA"," 35",393,408,801
" 08","S. PABLO-STA. JUSTA"," 36",391,408,799
" 08","S. PABLO-STA. JUSTA"," 37",440,400,840
" 08","S. PABLO-STA. JUSTA"," 38",472,462,934
" 08","S. PABLO-STA. JUSTA"," 39",468,455,923
" 08","S. PABLO-STA. JUSTA"," 40",481,471,952
" 08","S. PABLO-STA. JUSTA"," 41",452,454,906
" 08","S. PABLO-STA. JUSTA"," 42",453,464,917
" 08","S. PABLO-STA. JUSTA"," 43",436,450,886
" 08","S. PABLO-STA. JUSTA"," 44",472,399,871
" 08","S. PABLO-STA. JUSTA"," 45",453,441,894
" 08","S. PABLO-STA. JUSTA"," 46",458,478,936
" 08","S. PABLO-STA. JUSTA"," 47",415,460,875
" 08","S. PABLO-STA. JUSTA"," 48",403,472,875
" 08","S. PABLO-STA. JUSTA"," 49",458,473,931
" 08","S. PABLO-STA. JUSTA"," 50",416,479,895
" 08","S. PABLO-STA. JUSTA"," 51",444,541,985
" 08","S. PABLO-STA. JUSTA"," 52",478,481,959
" 08","S. PABLO-STA. JUSTA"," 53",482,552,1034
" 08","S. PABLO-STA. JUSTA"," 54",453,470,923
" 08","S. PABLO-STA. JUSTA"," 55",400,460,860
" 08","S. PABLO-STA. JUSTA"," 56",421,429,850
" 08","S. PABLO-STA. JUSTA"," 57",390,462,852
" 08","S. PABLO-STA. JUSTA"," 58",364,457,821
" 08","S. PABLO-STA. JUSTA"," 59",358,416,774
" 08","S. PABLO-STA. JUSTA"," 60",356,401,757
" 08","S. PABLO-STA. JUSTA"," 61",323,404,727
" 08","S. PABLO-STA. JUSTA"," 62",303,435,738
" 08","S. PABLO-STA. JUSTA"," 63",338,418,756
" 08","S. PABLO-STA. JUSTA"," 64",313,491,804
" 08","S. PABLO-STA. JUSTA"," 65",341,440,781
" 08","S. PABLO-STA. JUSTA"," 66",283,425,708
" 08","S. PABLO-STA. JUSTA"," 67",337,445,782
" 08","S. PABLO-STA. JUSTA"," 68",381,440,821
" 08","S. PABLO-STA. JUSTA"," 69",344,437,781
" 08","S. PABLO-STA. JUSTA"," 70",306,384,690
" 08","S. PABLO-STA. JUSTA"," 71",311,426,737
" 08","S. PABLO-STA. JUSTA"," 72",309,420,729
" 08","S. PABLO-STA. JUSTA"," 73",321,400,721
" 08","S. PABLO-STA. JUSTA"," 74",275,364,639
" 08","S. PABLO-STA. JUSTA"," 75",222,319,541
" 08","S. PABLO-STA. JUSTA"," 76",295,421,716
" 08","S. PABLO-STA. JUSTA"," 77",191,295,486
" 08","S. PABLO-STA. JUSTA"," 78",202,307,509
" 08","S. PABLO-STA. JUSTA"," 79",182,279,461
" 08","S. PABLO-STA. JUSTA"," 80",177,306,483
" 08","S. PABLO-STA. JUSTA"," 81",164,284,448
" 08","S. PABLO-STA. JUSTA"," 82",121,251,372
" 08","S. PABLO-STA. JUSTA"," 83",126,263,389
" 08","S. PABLO-STA. JUSTA"," 84",116,232,348
" 08","S. PABLO-STA. JUSTA"," 85",118,213,331
" 08","S. PABLO-STA. JUSTA"," 86",92,195,287
" 08","S. PABLO-STA. JUSTA"," 87",73,170,243
" 08","S. PABLO-STA. JUSTA"," 88",72,151,223
" 08","S. PABLO-STA. JUSTA"," 89",56,134,190
" 08","S. PABLO-STA. JUSTA","90 y más años",155,460,615
" 08","S. PABLO-STA. JUSTA","TOTAL POBLACION",28615,32119,60734
" 09","ESTE"," 00",550,506,1056
" 09","ESTE"," 01",565,521,1086
" 09","ESTE"," 02",592,533,1125
" 09","ESTE"," 03",549,472,1021
" 09","ESTE"," 04",535,524,1059
" 09","ESTE"," 05",577,597,1174
" 09","ESTE"," 06",620,591,1211
" 09","ESTE"," 07",671,622,1293
" 09","ESTE"," 08",688,660,1348
" 09","ESTE"," 09",702,668,1370
" 09","ESTE"," 10",732,712,1444
" 09","ESTE"," 11",754,714,1468
" 09","ESTE"," 12",820,707,1527
" 09","ESTE"," 13",771,690,1461
" 09","ESTE"," 14",745,697,1442
" 09","ESTE"," 15",739,662,1401
" 09","ESTE"," 16",722,633,1355
" 09","ESTE"," 17",687,634,1321
" 09","ESTE"," 18",591,632,1223
" 09","ESTE"," 19",615,531,1146
" 09","ESTE"," 20",584,560,1144
" 09","ESTE"," 21",597,527,1124
" 09","ESTE"," 22",583,575,1158
" 09","ESTE"," 23",621,603,1224
" 09","ESTE"," 24",585,550,1135
" 09","ESTE"," 25",611,563,1174
" 09","ESTE"," 26",574,559,1133
" 09","ESTE"," 27",583,552,1135
" 09","ESTE"," 28",579,583,1162
" 09","ESTE"," 29",598,607,1205
" 09","ESTE"," 30",598,662,1260
" 09","ESTE"," 31",667,663,1330
" 09","ESTE"," 32",722,749,1471
" 09","ESTE"," 33",722,702,1424
" 09","ESTE"," 34",768,777,1545
" 09","ESTE"," 35",786,856,1642
" 09","ESTE"," 36",831,807,1638
" 09","ESTE"," 37",751,880,1631
" 09","ESTE"," 38",866,915,1781
" 09","ESTE"," 39",858,864,1722
" 09","ESTE"," 40",881,985,1866
" 09","ESTE"," 41",880,995,1875
" 09","ESTE"," 42",888,993,1881
" 09","ESTE"," 43",921,988,1909
" 09","ESTE"," 44",991,1021,2012
" 09","ESTE"," 45",969,1042,2011
" 09","ESTE"," 46",991,1017,2008
" 09","ESTE"," 47",944,975,1919
" 09","ESTE"," 48",873,931,1804
" 09","ESTE"," 49",888,968,1856
" 09","ESTE"," 50",875,939,1814
" 09","ESTE"," 51",898,868,1766
" 09","ESTE"," 52",858,949,1807
" 09","ESTE"," 53",782,853,1635
" 09","ESTE"," 54",765,783,1548
" 09","ESTE"," 55",695,725,1420
" 09","ESTE"," 56",657,765,1422
" 09","ESTE"," 57",664,665,1329
" 09","ESTE"," 58",632,646,1278
" 09","ESTE"," 59",644,662,1306
" 09","ESTE"," 60",502,596,1098
" 09","ESTE"," 61",504,559,1063
" 09","ESTE"," 62",465,514,979
" 09","ESTE"," 63",467,480,947
" 09","ESTE"," 64",472,513,985
" 09","ESTE"," 65",436,482,918
" 09","ESTE"," 66",372,442,814
" 09","ESTE"," 67",429,435,864
" 09","ESTE"," 68",419,482,901
" 09","ESTE"," 69",387,410,797
" 09","ESTE"," 70",346,329,675
" 09","ESTE"," 71",353,394,747
" 09","ESTE"," 72",378,351,729
" 09","ESTE"," 73",297,368,665
" 09","ESTE"," 74",232,262,494
" 09","ESTE"," 75",176,226,402
" 09","ESTE"," 76",200,261,461
" 09","ESTE"," 77",154,189,343
" 09","ESTE"," 78",140,191,331
" 09","ESTE"," 79",149,220,369
" 09","ESTE"," 80",143,203,346
" 09","ESTE"," 81",124,194,318
" 09","ESTE"," 82",128,181,309
" 09","ESTE"," 83",101,164,265
" 09","ESTE"," 84",86,148,234
" 09","ESTE"," 85",70,131,201
" 09","ESTE"," 86",62,136,198
" 09","ESTE"," 87",55,97,152
" 09","ESTE"," 88",41,90,131
" 09","ESTE"," 89",38,69,107
" 09","ESTE","90 y más años",94,236,330
" 09","ESTE","TOTAL POBLACION",51225,52983,104208
" 10","BELLAVISTA-LA PALMERA"," 00",275,227,502
" 10","BELLAVISTA-LA PALMERA"," 01",295,251,546
" 10","BELLAVISTA-LA PALMERA"," 02",311,278,589
" 10","BELLAVISTA-LA PALMERA"," 03",302,265,567
" 10","BELLAVISTA-LA PALMERA"," 04",334,289,623
" 10","BELLAVISTA-LA PALMERA"," 05",316,283,599
" 10","BELLAVISTA-LA PALMERA"," 06",303,288,591
" 10","BELLAVISTA-LA PALMERA"," 07",311,284,595
" 10","BELLAVISTA-LA PALMERA"," 08",295,280,575
" 10","BELLAVISTA-LA PALMERA"," 09",280,231,511
" 10","BELLAVISTA-LA PALMERA"," 10",268,232,500
" 10","BELLAVISTA-LA PALMERA"," 11",219,240,459
" 10","BELLAVISTA-LA PALMERA"," 12",224,234,458
" 10","BELLAVISTA-LA PALMERA"," 13",250,246,496
" 10","BELLAVISTA-LA PALMERA"," 14",243,206,449
" 10","BELLAVISTA-LA PALMERA"," 15",228,188,416
" 10","BELLAVISTA-LA PALMERA"," 16",208,206,414
" 10","BELLAVISTA-LA PALMERA"," 17",207,191,398
" 10","BELLAVISTA-LA PALMERA"," 18",215,216,431
" 10","BELLAVISTA-LA PALMERA"," 19",232,232,464
" 10","BELLAVISTA-LA PALMERA"," 20",214,204,418
" 10","BELLAVISTA-LA PALMERA"," 21",218,215,433
" 10","BELLAVISTA-LA PALMERA"," 22",226,201,427
" 10","BELLAVISTA-LA PALMERA"," 23",208,197,405
" 10","BELLAVISTA-LA PALMERA"," 24",203,217,420
" 10","BELLAVISTA-LA PALMERA"," 25",207,206,413
" 10","BELLAVISTA-LA PALMERA"," 26",210,186,396
" 10","BELLAVISTA-LA PALMERA"," 27",190,213,403
" 10","BELLAVISTA-LA PALMERA"," 28",186,195,381
" 10","BELLAVISTA-LA PALMERA"," 29",185,201,386
" 10","BELLAVISTA-LA PALMERA"," 30",217,204,421
" 10","BELLAVISTA-LA PALMERA"," 31",233,250,483
" 10","BELLAVISTA-LA PALMERA"," 32",208,252,460
" 10","BELLAVISTA-LA PALMERA"," 33",275,318,593
" 10","BELLAVISTA-LA PALMERA"," 34",301,296,597
" 10","BELLAVISTA-LA PALMERA"," 35",330,350,680
" 10","BELLAVISTA-LA PALMERA"," 36",359,376,735
" 10","BELLAVISTA-LA PALMERA"," 37",410,445,855
" 10","BELLAVISTA-LA PALMERA"," 38",395,453,848
" 10","BELLAVISTA-LA PALMERA"," 39",421,459,880
" 10","BELLAVISTA-LA PALMERA"," 40",437,451,888
" 10","BELLAVISTA-LA PALMERA"," 41",410,399,809
" 10","BELLAVISTA-LA PALMERA"," 42",377,358,735
" 10","BELLAVISTA-LA PALMERA"," 43",362,341,703
" 10","BELLAVISTA-LA PALMERA"," 44",338,348,686
" 10","BELLAVISTA-LA PALMERA"," 45",317,343,660
" 10","BELLAVISTA-LA PALMERA"," 46",321,355,676
" 10","BELLAVISTA-LA PALMERA"," 47",341,330,671
" 10","BELLAVISTA-LA PALMERA"," 48",306,351,657
" 10","BELLAVISTA-LA PALMERA"," 49",315,353,668
" 10","BELLAVISTA-LA PALMERA"," 50",322,350,672
" 10","BELLAVISTA-LA PALMERA"," 51",345,370,715
" 10","BELLAVISTA-LA PALMERA"," 52",322,360,682
" 10","BELLAVISTA-LA PALMERA"," 53",290,291,581
" 10","BELLAVISTA-LA PALMERA"," 54",272,277,549
" 10","BELLAVISTA-LA PALMERA"," 55",258,277,535
" 10","BELLAVISTA-LA PALMERA"," 56",264,251,515
" 10","BELLAVISTA-LA PALMERA"," 57",210,258,468
" 10","BELLAVISTA-LA PALMERA"," 58",221,239,460
" 10","BELLAVISTA-LA PALMERA"," 59",193,254,447
" 10","BELLAVISTA-LA PALMERA"," 60",194,233,427
" 10","BELLAVISTA-LA PALMERA"," 61",177,195,372
" 10","BELLAVISTA-LA PALMERA"," 62",151,195,346
" 10","BELLAVISTA-LA PALMERA"," 63",172,176,348
" 10","BELLAVISTA-LA PALMERA"," 64",179,163,342
" 10","BELLAVISTA-LA PALMERA"," 65",150,188,338
" 10","BELLAVISTA-LA PALMERA"," 66",135,177,312
" 10","BELLAVISTA-LA PALMERA"," 67",145,173,318
" 10","BELLAVISTA-LA PALMERA"," 68",141,179,320
" 10","BELLAVISTA-LA PALMERA"," 69",107,158,265
" 10","BELLAVISTA-LA PALMERA"," 70",128,166,294
" 10","BELLAVISTA-LA PALMERA"," 71",136,201,337
" 10","BELLAVISTA-LA PALMERA"," 72",119,182,301
" 10","BELLAVISTA-LA PALMERA"," 73",127,159,286
" 10","BELLAVISTA-LA PALMERA"," 74",103,133,236
" 10","BELLAVISTA-LA PALMERA"," 75",94,140,234
" 10","BELLAVISTA-LA PALMERA"," 76",120,165,285
" 10","BELLAVISTA-LA PALMERA"," 77",83,139,222
" 10","BELLAVISTA-LA PALMERA"," 78",91,109,200
" 10","BELLAVISTA-LA PALMERA"," 79",98,99,197
" 10","BELLAVISTA-LA PALMERA"," 80",87,140,227
" 10","BELLAVISTA-LA PALMERA"," 81",84,151,235
" 10","BELLAVISTA-LA PALMERA"," 82",77,146,223
" 10","BELLAVISTA-LA PALMERA"," 83",96,131,227
" 10","BELLAVISTA-LA PALMERA"," 84",72,120,192
" 10","BELLAVISTA-LA PALMERA"," 85",53,111,164
" 10","BELLAVISTA-LA PALMERA"," 86",44,108,152
" 10","BELLAVISTA-LA PALMERA"," 87",38,92,130
" 10","BELLAVISTA-LA PALMERA"," 88",37,68,105
" 10","BELLAVISTA-LA PALMERA"," 89",24,55,79
" 10","BELLAVISTA-LA PALMERA","90 y más años",76,258,334
" 10","BELLAVISTA-LA PALMERA","TOTAL POBLACION",20071,21571,41642
" 11","LOS REMEDIOS"," 00",128,107,235
" 11","LOS REMEDIOS"," 01",107,115,222
" 11","LOS REMEDIOS"," 02",138,126,264
" 11","LOS REMEDIOS"," 03",136,121,257
" 11","LOS REMEDIOS"," 04",126,99,225
" 11","LOS REMEDIOS"," 05",125,123,248
" 11","LOS REMEDIOS"," 06",132,142,274
" 11","LOS REMEDIOS"," 07",135,113,248
" 11","LOS REMEDIOS"," 08",138,142,280
" 11","LOS REMEDIOS"," 09",125,135,260
" 11","LOS REMEDIOS"," 10",141,142,283
" 11","LOS REMEDIOS"," 11",131,124,255
" 11","LOS REMEDIOS"," 12",112,125,237
" 11","LOS REMEDIOS"," 13",111,135,246
" 11","LOS REMEDIOS"," 14",124,124,248
" 11","LOS REMEDIOS"," 15",128,120,248
" 11","LOS REMEDIOS"," 16",122,126,248
" 11","LOS REMEDIOS"," 17",112,118,230
" 11","LOS REMEDIOS"," 18",117,137,254
" 11","LOS REMEDIOS"," 19",120,116,236
" 11","LOS REMEDIOS"," 20",142,109,251
" 11","LOS REMEDIOS"," 21",120,137,257
" 11","LOS REMEDIOS"," 22",124,141,265
" 11","LOS REMEDIOS"," 23",120,118,238
" 11","LOS REMEDIOS"," 24",131,133,264
" 11","LOS REMEDIOS"," 25",130,123,253
" 11","LOS REMEDIOS"," 26",130,128,258
" 11","LOS REMEDIOS"," 27",109,137,246
" 11","LOS REMEDIOS"," 28",117,121,238
" 11","LOS REMEDIOS"," 29",126,140,266
" 11","LOS REMEDIOS"," 30",135,123,258
" 11","LOS REMEDIOS"," 31",132,118,250
" 11","LOS REMEDIOS"," 32",144,150,294
" 11","LOS REMEDIOS"," 33",140,151,291
" 11","LOS REMEDIOS"," 34",125,181,306
" 11","LOS REMEDIOS"," 35",125,182,307
" 11","LOS REMEDIOS"," 36",201,173,374
" 11","LOS REMEDIOS"," 37",186,198,384
" 11","LOS REMEDIOS"," 38",166,171,337
" 11","LOS REMEDIOS"," 39",181,198,379
" 11","LOS REMEDIOS"," 40",182,198,380
" 11","LOS REMEDIOS"," 41",193,211,404
" 11","LOS REMEDIOS"," 42",207,214,421
" 11","LOS REMEDIOS"," 43",164,186,350
" 11","LOS REMEDIOS"," 44",197,178,375
" 11","LOS REMEDIOS"," 45",164,179,343
" 11","LOS REMEDIOS"," 46",135,197,332
" 11","LOS REMEDIOS"," 47",164,202,366
" 11","LOS REMEDIOS"," 48",141,194,335
" 11","LOS REMEDIOS"," 49",185,199,384
" 11","LOS REMEDIOS"," 50",177,201,378
" 11","LOS REMEDIOS"," 51",197,223,420
" 11","LOS REMEDIOS"," 52",160,216,376
" 11","LOS REMEDIOS"," 53",174,223,397
" 11","LOS REMEDIOS"," 54",180,209,389
" 11","LOS REMEDIOS"," 55",156,170,326
" 11","LOS REMEDIOS"," 56",157,167,324
" 11","LOS REMEDIOS"," 57",139,196,335
" 11","LOS REMEDIOS"," 58",151,176,327
" 11","LOS REMEDIOS"," 59",137,166,303
" 11","LOS REMEDIOS"," 60",111,160,271
" 11","LOS REMEDIOS"," 61",122,155,277
" 11","LOS REMEDIOS"," 62",96,165,261
" 11","LOS REMEDIOS"," 63",116,176,292
" 11","LOS REMEDIOS"," 64",111,149,260
" 11","LOS REMEDIOS"," 65",80,153,233
" 11","LOS REMEDIOS"," 66",124,164,288
" 11","LOS REMEDIOS"," 67",105,146,251
" 11","LOS REMEDIOS"," 68",118,163,281
" 11","LOS REMEDIOS"," 69",104,181,285
" 11","LOS REMEDIOS"," 70",105,166,271
" 11","LOS REMEDIOS"," 71",105,180,285
" 11","LOS REMEDIOS"," 72",118,197,315
" 11","LOS REMEDIOS"," 73",122,211,333
" 11","LOS REMEDIOS"," 74",110,156,266
" 11","LOS REMEDIOS"," 75",99,144,243
" 11","LOS REMEDIOS"," 76",104,176,280
" 11","LOS REMEDIOS"," 77",92,165,257
" 11","LOS REMEDIOS"," 78",81,141,222
" 11","LOS REMEDIOS"," 79",84,127,211
" 11","LOS REMEDIOS"," 80",87,141,228
" 11","LOS REMEDIOS"," 81",93,152,245
" 11","LOS REMEDIOS"," 82",80,132,212
" 11","LOS REMEDIOS"," 83",66,112,178
" 11","LOS REMEDIOS"," 84",54,114,168
" 11","LOS REMEDIOS"," 85",55,90,145
" 11","LOS REMEDIOS"," 86",37,123,160
" 11","LOS REMEDIOS"," 87",50,91,141
" 11","LOS REMEDIOS"," 88",41,80,121
" 11","LOS REMEDIOS"," 89",24,70,94
" 11","LOS REMEDIOS","90 y más años",104,284,388
" 11","LOS REMEDIOS","TOTAL POBLACION",11450,13991,25441
