"CD","ND","GRUPO","HOMBRES","MUJERES","TOTAL"
" 00","01 TOTAL DISTRITOS","TOTAL POBLACION",332100,366576,698676
" 01","CASCO ANTIGUO"," 00",208,203,411
" 01","CASCO ANTIGUO"," 01",230,265,495
" 01","CASCO ANTIGUO"," 02",245,215,460
" 01","CASCO ANTIGUO"," 03",211,226,437
" 01","CASCO ANTIGUO"," 04",252,220,472
" 01","CASCO ANTIGUO"," 05",257,233,490
" 01","CASCO ANTIGUO"," 06",258,237,495
" 01","CASCO ANTIGUO"," 07",263,251,514
" 01","CASCO ANTIGUO"," 08",258,245,503
" 01","CASCO ANTIGUO"," 09",269,243,512
" 01","CASCO ANTIGUO"," 10",261,260,521
" 01","CASCO ANTIGUO"," 11",285,246,531
" 01","CASCO ANTIGUO"," 12",242,281,523
" 01","CASCO ANTIGUO"," 13",250,255,505
" 01","CASCO ANTIGUO"," 14",249,245,494
" 01","CASCO ANTIGUO"," 15",241,242,483
" 01","CASCO ANTIGUO"," 16",229,255,484
" 01","CASCO ANTIGUO"," 17",225,229,454
" 01","CASCO ANTIGUO"," 18",209,219,428
" 01","CASCO ANTIGUO"," 19",221,186,407
" 01","CASCO ANTIGUO"," 20",188,217,405
" 01","CASCO ANTIGUO"," 21",234,222,456
" 01","CASCO ANTIGUO"," 22",224,227,451
" 01","CASCO ANTIGUO"," 23",234,263,497
" 01","CASCO ANTIGUO"," 24",243,258,501
" 01","CASCO ANTIGUO"," 25",253,281,534
" 01","CASCO ANTIGUO"," 26",273,319,592
" 01","CASCO ANTIGUO"," 27",297,367,664
" 01","CASCO ANTIGUO"," 28",284,347,631
" 01","CASCO ANTIGUO"," 29",317,365,682
" 01","CASCO ANTIGUO"," 30",310,397,707
" 01","CASCO ANTIGUO"," 31",345,404,749
" 01","CASCO ANTIGUO"," 32",368,423,791
" 01","CASCO ANTIGUO"," 33",414,436,850
" 01","CASCO ANTIGUO"," 34",419,490,909
" 01","CASCO ANTIGUO"," 35",454,475,929
" 01","CASCO ANTIGUO"," 36",501,506,1007
" 01","CASCO ANTIGUO"," 37",512,480,992
" 01","CASCO ANTIGUO"," 38",509,543,1052
" 01","CASCO ANTIGUO"," 39",515,505,1020
" 01","CASCO ANTIGUO"," 40",535,530,1065
" 01","CASCO ANTIGUO"," 41",535,525,1060
" 01","CASCO ANTIGUO"," 42",525,530,1055
" 01","CASCO ANTIGUO"," 43",534,530,1064
" 01","CASCO ANTIGUO"," 44",504,511,1015
" 01","CASCO ANTIGUO"," 45",496,564,1060
" 01","CASCO ANTIGUO"," 46",487,507,994
" 01","CASCO ANTIGUO"," 47",570,506,1076
" 01","CASCO ANTIGUO"," 48",524,479,1003
" 01","CASCO ANTIGUO"," 49",486,509,995
" 01","CASCO ANTIGUO"," 50",505,490,995
" 01","CASCO ANTIGUO"," 51",499,525,1024
" 01","CASCO ANTIGUO"," 52",482,504,986
" 01","CASCO ANTIGUO"," 53",499,495,994
" 01","CASCO ANTIGUO"," 54",516,457,973
" 01","CASCO ANTIGUO"," 55",387,440,827
" 01","CASCO ANTIGUO"," 56",383,451,834
" 01","CASCO ANTIGUO"," 57",386,431,817
" 01","CASCO ANTIGUO"," 58",358,388,746
" 01","CASCO ANTIGUO"," 59",393,405,798
" 01","CASCO ANTIGUO"," 60",363,430,793
" 01","CASCO ANTIGUO"," 61",340,428,768
" 01","CASCO ANTIGUO"," 62",311,377,688
" 01","CASCO ANTIGUO"," 63",341,382,723
" 01","CASCO ANTIGUO"," 64",320,364,684
" 01","CASCO ANTIGUO"," 65",306,352,658
" 01","CASCO ANTIGUO"," 66",311,349,660
" 01","CASCO ANTIGUO"," 67",270,370,640
" 01","CASCO ANTIGUO"," 68",274,338,612
" 01","CASCO ANTIGUO"," 69",277,318,595
" 01","CASCO ANTIGUO"," 70",255,322,577
" 01","CASCO ANTIGUO"," 71",244,337,581
" 01","CASCO ANTIGUO"," 72",228,303,531
" 01","CASCO ANTIGUO"," 73",227,296,523
" 01","CASCO ANTIGUO"," 74",228,312,540
" 01","CASCO ANTIGUO"," 75",183,250,433
" 01","CASCO ANTIGUO"," 76",159,235,394
" 01","CASCO ANTIGUO"," 77",196,288,484
" 01","CASCO ANTIGUO"," 78",153,266,419
" 01","CASCO ANTIGUO"," 79",136,259,395
" 01","CASCO ANTIGUO"," 80",114,206,320
" 01","CASCO ANTIGUO"," 81",133,217,350
" 01","CASCO ANTIGUO"," 82",137,236,373
" 01","CASCO ANTIGUO"," 83",108,220,328
" 01","CASCO ANTIGUO"," 84",102,200,302
" 01","CASCO ANTIGUO"," 85",88,200,288
" 01","CASCO ANTIGUO"," 86",68,163,231
" 01","CASCO ANTIGUO"," 87",53,153,206
" 01","CASCO ANTIGUO"," 88",66,154,220
" 01","CASCO ANTIGUO"," 89",40,139,179
" 01","CASCO ANTIGUO","90 y más años",159,620,779
" 01","CASCO ANTIGUO","TOTAL POBLACION",27551,31142,58693
" 02","MACARENA"," 00",311,291,602
" 02","MACARENA"," 01",259,255,514
" 02","MACARENA"," 02",320,292,612
" 02","MACARENA"," 03",307,331,638
" 02","MACARENA"," 04",291,287,578
" 02","MACARENA"," 05",328,317,645
" 02","MACARENA"," 06",337,309,646
" 02","MACARENA"," 07",358,314,672
" 02","MACARENA"," 08",381,353,734
" 02","MACARENA"," 09",373,374,747
" 02","MACARENA"," 10",352,368,720
" 02","MACARENA"," 11",329,288,617
" 02","MACARENA"," 12",335,324,659
" 02","MACARENA"," 13",331,320,651
" 02","MACARENA"," 14",311,285,596
" 02","MACARENA"," 15",268,286,554
" 02","MACARENA"," 16",280,300,580
" 02","MACARENA"," 17",317,299,616
" 02","MACARENA"," 18",306,272,578
" 02","MACARENA"," 19",327,291,618
" 02","MACARENA"," 20",325,327,652
" 02","MACARENA"," 21",336,350,686
" 02","MACARENA"," 22",343,338,681
" 02","MACARENA"," 23",393,388,781
" 02","MACARENA"," 24",395,407,802
" 02","MACARENA"," 25",405,372,777
" 02","MACARENA"," 26",388,425,813
" 02","MACARENA"," 27",420,407,827
" 02","MACARENA"," 28",419,415,834
" 02","MACARENA"," 29",394,443,837
" 02","MACARENA"," 30",419,442,861
" 02","MACARENA"," 31",445,469,914
" 02","MACARENA"," 32",484,509,993
" 02","MACARENA"," 33",532,554,1086
" 02","MACARENA"," 34",517,529,1046
" 02","MACARENA"," 35",525,589,1114
" 02","MACARENA"," 36",538,595,1133
" 02","MACARENA"," 37",608,620,1228
" 02","MACARENA"," 38",605,592,1197
" 02","MACARENA"," 39",621,611,1232
" 02","MACARENA"," 40",614,657,1271
" 02","MACARENA"," 41",637,647,1284
" 02","MACARENA"," 42",584,640,1224
" 02","MACARENA"," 43",601,627,1228
" 02","MACARENA"," 44",619,577,1196
" 02","MACARENA"," 45",580,599,1179
" 02","MACARENA"," 46",576,556,1132
" 02","MACARENA"," 47",526,541,1067
" 02","MACARENA"," 48",549,554,1103
" 02","MACARENA"," 49",518,607,1125
" 02","MACARENA"," 50",507,532,1039
" 02","MACARENA"," 51",550,566,1116
" 02","MACARENA"," 52",511,533,1044
" 02","MACARENA"," 53",535,621,1156
" 02","MACARENA"," 54",470,568,1038
" 02","MACARENA"," 55",466,546,1012
" 02","MACARENA"," 56",451,550,1001
" 02","MACARENA"," 57",491,513,1004
" 02","MACARENA"," 58",457,467,924
" 02","MACARENA"," 59",448,498,946
" 02","MACARENA"," 60",418,503,921
" 02","MACARENA"," 61",378,462,840
" 02","MACARENA"," 62",381,465,846
" 02","MACARENA"," 63",340,436,776
" 02","MACARENA"," 64",320,470,790
" 02","MACARENA"," 65",344,460,804
" 02","MACARENA"," 66",341,454,795
" 02","MACARENA"," 67",327,440,767
" 02","MACARENA"," 68",351,515,866
" 02","MACARENA"," 69",355,583,938
" 02","MACARENA"," 70",369,530,899
" 02","MACARENA"," 71",340,550,890
" 02","MACARENA"," 72",412,581,993
" 02","MACARENA"," 73",378,550,928
" 02","MACARENA"," 74",407,548,955
" 02","MACARENA"," 75",307,433,740
" 02","MACARENA"," 76",304,365,669
" 02","MACARENA"," 77",318,449,767
" 02","MACARENA"," 78",279,355,634
" 02","MACARENA"," 79",211,389,600
" 02","MACARENA"," 80",212,299,511
" 02","MACARENA"," 81",193,403,596
" 02","MACARENA"," 82",211,375,586
" 02","MACARENA"," 83",168,298,466
" 02","MACARENA"," 84",158,306,464
" 02","MACARENA"," 85",136,286,422
" 02","MACARENA"," 86",114,260,374
" 02","MACARENA"," 87",115,236,351
" 02","MACARENA"," 88",81,205,286
" 02","MACARENA"," 89",51,197,248
" 02","MACARENA","90 y más años",181,572,753
" 02","MACARENA","TOTAL POBLACION",34723,39912,74635
" 03","NERVION"," 00",218,196,414
" 03","NERVION"," 01",262,208,470
" 03","NERVION"," 02",213,224,437
" 03","NERVION"," 03",254,246,500
" 03","NERVION"," 04",219,238,457
" 03","NERVION"," 05",264,240,504
" 03","NERVION"," 06",249,264,513
" 03","NERVION"," 07",236,215,451
" 03","NERVION"," 08",257,249,506
" 03","NERVION"," 09",246,218,464
" 03","NERVION"," 10",255,212,467
" 03","NERVION"," 11",260,274,534
" 03","NERVION"," 12",269,258,527
" 03","NERVION"," 13",279,235,514
" 03","NERVION"," 14",273,243,516
" 03","NERVION"," 15",251,218,469
" 03","NERVION"," 16",231,263,494
" 03","NERVION"," 17",248,228,476
" 03","NERVION"," 18",228,230,458
" 03","NERVION"," 19",207,249,456
" 03","NERVION"," 20",227,266,493
" 03","NERVION"," 21",284,233,517
" 03","NERVION"," 22",244,229,473
" 03","NERVION"," 23",241,272,513
" 03","NERVION"," 24",215,269,484
" 03","NERVION"," 25",257,243,500
" 03","NERVION"," 26",241,255,496
" 03","NERVION"," 27",249,234,483
" 03","NERVION"," 28",260,231,491
" 03","NERVION"," 29",254,284,538
" 03","NERVION"," 30",281,258,539
" 03","NERVION"," 31",256,304,560
" 03","NERVION"," 32",282,289,571
" 03","NERVION"," 33",278,320,598
" 03","NERVION"," 34",279,332,611
" 03","NERVION"," 35",336,371,707
" 03","NERVION"," 36",340,337,677
" 03","NERVION"," 37",349,381,730
" 03","NERVION"," 38",348,340,688
" 03","NERVION"," 39",383,380,763
" 03","NERVION"," 40",368,401,769
" 03","NERVION"," 41",386,465,851
" 03","NERVION"," 42",391,370,761
" 03","NERVION"," 43",352,418,770
" 03","NERVION"," 44",361,404,765
" 03","NERVION"," 45",363,404,767
" 03","NERVION"," 46",355,381,736
" 03","NERVION"," 47",347,374,721
" 03","NERVION"," 48",338,410,748
" 03","NERVION"," 49",342,404,746
" 03","NERVION"," 50",323,429,752
" 03","NERVION"," 51",389,405,794
" 03","NERVION"," 52",350,420,770
" 03","NERVION"," 53",334,410,744
" 03","NERVION"," 54",349,402,751
" 03","NERVION"," 55",347,370,717
" 03","NERVION"," 56",314,376,690
" 03","NERVION"," 57",295,376,671
" 03","NERVION"," 58",291,387,678
" 03","NERVION"," 59",279,359,638
" 03","NERVION"," 60",282,384,666
" 03","NERVION"," 61",275,349,624
" 03","NERVION"," 62",251,395,646
" 03","NERVION"," 63",273,315,588
" 03","NERVION"," 64",291,378,669
" 03","NERVION"," 65",269,372,641
" 03","NERVION"," 66",278,336,614
" 03","NERVION"," 67",251,369,620
" 03","NERVION"," 68",272,421,693
" 03","NERVION"," 69",326,408,734
" 03","NERVION"," 70",273,372,645
" 03","NERVION"," 71",276,343,619
" 03","NERVION"," 72",283,352,635
" 03","NERVION"," 73",290,383,673
" 03","NERVION"," 74",241,364,605
" 03","NERVION"," 75",229,325,554
" 03","NERVION"," 76",212,277,489
" 03","NERVION"," 77",187,269,456
" 03","NERVION"," 78",157,224,381
" 03","NERVION"," 79",136,242,378
" 03","NERVION"," 80",153,229,382
" 03","NERVION"," 81",147,267,414
" 03","NERVION"," 82",143,241,384
" 03","NERVION"," 83",127,202,329
" 03","NERVION"," 84",102,206,308
" 03","NERVION"," 85",112,205,317
" 03","NERVION"," 86",75,163,238
" 03","NERVION"," 87",67,176,243
" 03","NERVION"," 88",58,144,202
" 03","NERVION"," 89",54,130,184
" 03","NERVION","90 y más años",134,487,621
" 03","NERVION","TOTAL POBLACION",23621,27829,51450
" 04","CERRO-AMATE"," 00",404,367,771
" 04","CERRO-AMATE"," 01",420,390,810
" 04","CERRO-AMATE"," 02",380,398,778
" 04","CERRO-AMATE"," 03",444,371,815
" 04","CERRO-AMATE"," 04",435,438,873
" 04","CERRO-AMATE"," 05",471,435,906
" 04","CERRO-AMATE"," 06",482,442,924
" 04","CERRO-AMATE"," 07",511,504,1015
" 04","CERRO-AMATE"," 08",493,531,1024
" 04","CERRO-AMATE"," 09",602,573,1175
" 04","CERRO-AMATE"," 10",601,534,1135
" 04","CERRO-AMATE"," 11",491,510,1001
" 04","CERRO-AMATE"," 12",481,489,970
" 04","CERRO-AMATE"," 13",463,393,856
" 04","CERRO-AMATE"," 14",387,390,777
" 04","CERRO-AMATE"," 15",397,374,771
" 04","CERRO-AMATE"," 16",429,431,860
" 04","CERRO-AMATE"," 17",394,397,791
" 04","CERRO-AMATE"," 18",422,394,816
" 04","CERRO-AMATE"," 19",428,368,796
" 04","CERRO-AMATE"," 20",437,414,851
" 04","CERRO-AMATE"," 21",427,455,882
" 04","CERRO-AMATE"," 22",466,451,917
" 04","CERRO-AMATE"," 23",512,493,1005
" 04","CERRO-AMATE"," 24",546,506,1052
" 04","CERRO-AMATE"," 25",551,562,1113
" 04","CERRO-AMATE"," 26",574,545,1119
" 04","CERRO-AMATE"," 27",535,574,1109
" 04","CERRO-AMATE"," 28",588,544,1132
" 04","CERRO-AMATE"," 29",634,574,1208
" 04","CERRO-AMATE"," 30",588,586,1174
" 04","CERRO-AMATE"," 31",610,580,1190
" 04","CERRO-AMATE"," 32",580,588,1168
" 04","CERRO-AMATE"," 33",552,541,1093
" 04","CERRO-AMATE"," 34",622,617,1239
" 04","CERRO-AMATE"," 35",665,654,1319
" 04","CERRO-AMATE"," 36",679,678,1357
" 04","CERRO-AMATE"," 37",774,689,1463
" 04","CERRO-AMATE"," 38",776,710,1486
" 04","CERRO-AMATE"," 39",847,839,1686
" 04","CERRO-AMATE"," 40",850,796,1646
" 04","CERRO-AMATE"," 41",839,805,1644
" 04","CERRO-AMATE"," 42",837,713,1550
" 04","CERRO-AMATE"," 43",754,739,1493
" 04","CERRO-AMATE"," 44",733,673,1406
" 04","CERRO-AMATE"," 45",713,652,1365
" 04","CERRO-AMATE"," 46",682,631,1313
" 04","CERRO-AMATE"," 47",628,659,1287
" 04","CERRO-AMATE"," 48",657,635,1292
" 04","CERRO-AMATE"," 49",606,656,1262
" 04","CERRO-AMATE"," 50",563,599,1162
" 04","CERRO-AMATE"," 51",616,720,1336
" 04","CERRO-AMATE"," 52",618,655,1273
" 04","CERRO-AMATE"," 53",629,670,1299
" 04","CERRO-AMATE"," 54",637,675,1312
" 04","CERRO-AMATE"," 55",583,624,1207
" 04","CERRO-AMATE"," 56",578,604,1182
" 04","CERRO-AMATE"," 57",551,584,1135
" 04","CERRO-AMATE"," 58",531,575,1106
" 04","CERRO-AMATE"," 59",530,620,1150
" 04","CERRO-AMATE"," 60",566,623,1189
" 04","CERRO-AMATE"," 61",459,565,1024
" 04","CERRO-AMATE"," 62",479,546,1025
" 04","CERRO-AMATE"," 63",458,509,967
" 04","CERRO-AMATE"," 64",457,491,948
" 04","CERRO-AMATE"," 65",438,479,917
" 04","CERRO-AMATE"," 66",415,488,903
" 04","CERRO-AMATE"," 67",349,429,778
" 04","CERRO-AMATE"," 68",430,486,916
" 04","CERRO-AMATE"," 69",423,508,931
" 04","CERRO-AMATE"," 70",369,468,837
" 04","CERRO-AMATE"," 71",300,395,695
" 04","CERRO-AMATE"," 72",366,494,860
" 04","CERRO-AMATE"," 73",350,433,783
" 04","CERRO-AMATE"," 74",356,429,785
" 04","CERRO-AMATE"," 75",233,358,591
" 04","CERRO-AMATE"," 76",250,307,557
" 04","CERRO-AMATE"," 77",246,388,634
" 04","CERRO-AMATE"," 78",213,274,487
" 04","CERRO-AMATE"," 79",208,286,494
" 04","CERRO-AMATE"," 80",183,301,484
" 04","CERRO-AMATE"," 81",207,329,536
" 04","CERRO-AMATE"," 82",155,334,489
" 04","CERRO-AMATE"," 83",153,262,415
" 04","CERRO-AMATE"," 84",160,288,448
" 04","CERRO-AMATE"," 85",130,273,403
" 04","CERRO-AMATE"," 86",92,199,291
" 04","CERRO-AMATE"," 87",92,195,287
" 04","CERRO-AMATE"," 88",81,187,268
" 04","CERRO-AMATE"," 89",52,150,202
" 04","CERRO-AMATE","90 y más años",184,468,652
" 04","CERRO-AMATE","TOTAL POBLACION",43087,45556,88643
" 05","SUR"," 00",332,312,644
" 05","SUR"," 01",349,297,646
" 05","SUR"," 02",330,330,660
" 05","SUR"," 03",306,317,623
" 05","SUR"," 04",316,328,644
" 05","SUR"," 05",361,340,701
" 05","SUR"," 06",345,344,689
" 05","SUR"," 07",380,370,750
" 05","SUR"," 08",461,365,826
" 05","SUR"," 09",437,376,813
" 05","SUR"," 10",403,384,787
" 05","SUR"," 11",401,366,767
" 05","SUR"," 12",380,400,780
" 05","SUR"," 13",393,380,773
" 05","SUR"," 14",398,417,815
" 05","SUR"," 15",378,399,777
" 05","SUR"," 16",392,371,763
" 05","SUR"," 17",415,400,815
" 05","SUR"," 18",361,360,721
" 05","SUR"," 19",410,392,802
" 05","SUR"," 20",395,389,784
" 05","SUR"," 21",399,384,783
" 05","SUR"," 22",371,405,776
" 05","SUR"," 23",381,395,776
" 05","SUR"," 24",405,427,832
" 05","SUR"," 25",401,418,819
" 05","SUR"," 26",474,393,867
" 05","SUR"," 27",433,421,854
" 05","SUR"," 28",443,406,849
" 05","SUR"," 29",401,406,807
" 05","SUR"," 30",420,424,844
" 05","SUR"," 31",388,412,800
" 05","SUR"," 32",475,433,908
" 05","SUR"," 33",430,462,892
" 05","SUR"," 34",452,422,874
" 05","SUR"," 35",493,437,930
" 05","SUR"," 36",473,479,952
" 05","SUR"," 37",517,503,1020
" 05","SUR"," 38",502,501,1003
" 05","SUR"," 39",497,539,1036
" 05","SUR"," 40",563,557,1120
" 05","SUR"," 41",537,503,1040
" 05","SUR"," 42",498,530,1028
" 05","SUR"," 43",543,512,1055
" 05","SUR"," 44",497,510,1007
" 05","SUR"," 45",525,492,1017
" 05","SUR"," 46",432,518,950
" 05","SUR"," 47",493,509,1002
" 05","SUR"," 48",503,526,1029
" 05","SUR"," 49",482,584,1066
" 05","SUR"," 50",502,552,1054
" 05","SUR"," 51",546,563,1109
" 05","SUR"," 52",507,553,1060
" 05","SUR"," 53",480,562,1042
" 05","SUR"," 54",523,564,1087
" 05","SUR"," 55",473,546,1019
" 05","SUR"," 56",445,469,914
" 05","SUR"," 57",431,511,942
" 05","SUR"," 58",387,483,870
" 05","SUR"," 59",400,476,876
" 05","SUR"," 60",411,469,880
" 05","SUR"," 61",368,458,826
" 05","SUR"," 62",337,458,795
" 05","SUR"," 63",319,425,744
" 05","SUR"," 64",339,422,761
" 05","SUR"," 65",334,402,736
" 05","SUR"," 66",322,403,725
" 05","SUR"," 67",295,359,654
" 05","SUR"," 68",338,423,761
" 05","SUR"," 69",317,413,730
" 05","SUR"," 70",300,414,714
" 05","SUR"," 71",265,363,628
" 05","SUR"," 72",301,414,715
" 05","SUR"," 73",310,442,752
" 05","SUR"," 74",304,433,737
" 05","SUR"," 75",228,350,578
" 05","SUR"," 76",230,292,522
" 05","SUR"," 77",270,370,640
" 05","SUR"," 78",226,287,513
" 05","SUR"," 79",217,311,528
" 05","SUR"," 80",190,289,479
" 05","SUR"," 81",176,326,502
" 05","SUR"," 82",174,288,462
" 05","SUR"," 83",132,262,394
" 05","SUR"," 84",169,244,413
" 05","SUR"," 85",111,257,368
" 05","SUR"," 86",81,203,284
" 05","SUR"," 87",79,186,265
" 05","SUR"," 88",67,164,231
" 05","SUR"," 89",53,125,178
" 05","SUR","90 y más años",185,446,631
" 05","SUR","TOTAL POBLACION",33513,37122,70635
" 06","TRIANA"," 00",169,148,317
" 06","TRIANA"," 01",200,180,380
" 06","TRIANA"," 02",183,187,370
" 06","TRIANA"," 03",170,187,357
" 06","TRIANA"," 04",195,176,371
" 06","TRIANA"," 05",197,216,413
" 06","TRIANA"," 06",194,196,390
" 06","TRIANA"," 07",201,216,417
" 06","TRIANA"," 08",217,246,463
" 06","TRIANA"," 09",214,229,443
" 06","TRIANA"," 10",226,220,446
" 06","TRIANA"," 11",221,210,431
" 06","TRIANA"," 12",226,250,476
" 06","TRIANA"," 13",207,213,420
" 06","TRIANA"," 14",219,218,437
" 06","TRIANA"," 15",223,217,440
" 06","TRIANA"," 16",191,191,382
" 06","TRIANA"," 17",226,206,432
" 06","TRIANA"," 18",221,181,402
" 06","TRIANA"," 19",188,198,386
" 06","TRIANA"," 20",211,199,410
" 06","TRIANA"," 21",203,198,401
" 06","TRIANA"," 22",208,217,425
" 06","TRIANA"," 23",196,232,428
" 06","TRIANA"," 24",221,215,436
" 06","TRIANA"," 25",235,236,471
" 06","TRIANA"," 26",261,251,512
" 06","TRIANA"," 27",223,244,467
" 06","TRIANA"," 28",202,255,457
" 06","TRIANA"," 29",246,254,500
" 06","TRIANA"," 30",272,271,543
" 06","TRIANA"," 31",240,280,520
" 06","TRIANA"," 32",236,295,531
" 06","TRIANA"," 33",261,283,544
" 06","TRIANA"," 34",301,313,614
" 06","TRIANA"," 35",283,331,614
" 06","TRIANA"," 36",310,342,652
" 06","TRIANA"," 37",348,337,685
" 06","TRIANA"," 38",347,326,673
" 06","TRIANA"," 39",361,392,753
" 06","TRIANA"," 40",383,403,786
" 06","TRIANA"," 41",350,429,779
" 06","TRIANA"," 42",357,361,718
" 06","TRIANA"," 43",376,437,813
" 06","TRIANA"," 44",358,413,771
" 06","TRIANA"," 45",361,367,728
" 06","TRIANA"," 46",345,380,725
" 06","TRIANA"," 47",356,378,734
" 06","TRIANA"," 48",363,393,756
" 06","TRIANA"," 49",345,371,716
" 06","TRIANA"," 50",398,398,796
" 06","TRIANA"," 51",340,423,763
" 06","TRIANA"," 52",360,403,763
" 06","TRIANA"," 53",359,439,798
" 06","TRIANA"," 54",313,406,719
" 06","TRIANA"," 55",310,350,660
" 06","TRIANA"," 56",323,391,714
" 06","TRIANA"," 57",306,381,687
" 06","TRIANA"," 58",296,385,681
" 06","TRIANA"," 59",277,348,625
" 06","TRIANA"," 60",288,351,639
" 06","TRIANA"," 61",242,305,547
" 06","TRIANA"," 62",256,319,575
" 06","TRIANA"," 63",211,285,496
" 06","TRIANA"," 64",210,315,525
" 06","TRIANA"," 65",227,346,573
" 06","TRIANA"," 66",236,337,573
" 06","TRIANA"," 67",202,350,552
" 06","TRIANA"," 68",229,316,545
" 06","TRIANA"," 69",270,356,626
" 06","TRIANA"," 70",272,350,622
" 06","TRIANA"," 71",232,332,564
" 06","TRIANA"," 72",270,392,662
" 06","TRIANA"," 73",239,380,619
" 06","TRIANA"," 74",264,396,660
" 06","TRIANA"," 75",206,325,531
" 06","TRIANA"," 76",184,263,447
" 06","TRIANA"," 77",218,315,533
" 06","TRIANA"," 78",157,258,415
" 06","TRIANA"," 79",155,248,403
" 06","TRIANA"," 80",135,204,339
" 06","TRIANA"," 81",147,243,390
" 06","TRIANA"," 82",148,261,409
" 06","TRIANA"," 83",110,217,327
" 06","TRIANA"," 84",95,243,338
" 06","TRIANA"," 85",95,236,331
" 06","TRIANA"," 86",97,193,290
" 06","TRIANA"," 87",75,160,235
" 06","TRIANA"," 88",66,163,229
" 06","TRIANA"," 89",47,125,172
" 06","TRIANA","90 y más años",171,533,704
" 06","TRIANA","TOTAL POBLACION",21883,26529,48412
" 07","NORTE"," 00",317,313,630
" 07","NORTE"," 01",368,316,684
" 07","NORTE"," 02",369,322,691
" 07","NORTE"," 03",356,337,693
" 07","NORTE"," 04",348,328,676
" 07","NORTE"," 05",359,315,674
" 07","NORTE"," 06",351,361,712
" 07","NORTE"," 07",404,364,768
" 07","NORTE"," 08",425,362,787
" 07","NORTE"," 09",414,442,856
" 07","NORTE"," 10",390,375,765
" 07","NORTE"," 11",401,366,767
" 07","NORTE"," 12",404,370,774
" 07","NORTE"," 13",398,361,759
" 07","NORTE"," 14",430,391,821
" 07","NORTE"," 15",352,371,723
" 07","NORTE"," 16",398,363,761
" 07","NORTE"," 17",424,389,813
" 07","NORTE"," 18",383,381,764
" 07","NORTE"," 19",380,371,751
" 07","NORTE"," 20",391,359,750
" 07","NORTE"," 21",403,356,759
" 07","NORTE"," 22",393,361,754
" 07","NORTE"," 23",416,377,793
" 07","NORTE"," 24",446,389,835
" 07","NORTE"," 25",471,393,864
" 07","NORTE"," 26",483,402,885
" 07","NORTE"," 27",451,432,883
" 07","NORTE"," 28",438,439,877
" 07","NORTE"," 29",458,433,891
" 07","NORTE"," 30",452,488,940
" 07","NORTE"," 31",462,502,964
" 07","NORTE"," 32",537,545,1082
" 07","NORTE"," 33",540,523,1063
" 07","NORTE"," 34",612,547,1159
" 07","NORTE"," 35",633,577,1210
" 07","NORTE"," 36",573,588,1161
" 07","NORTE"," 37",590,588,1178
" 07","NORTE"," 38",652,582,1234
" 07","NORTE"," 39",648,644,1292
" 07","NORTE"," 40",651,635,1286
" 07","NORTE"," 41",627,588,1215
" 07","NORTE"," 42",603,595,1198
" 07","NORTE"," 43",551,521,1072
" 07","NORTE"," 44",531,588,1119
" 07","NORTE"," 45",538,615,1153
" 07","NORTE"," 46",514,575,1089
" 07","NORTE"," 47",577,606,1183
" 07","NORTE"," 48",563,642,1205
" 07","NORTE"," 49",589,593,1182
" 07","NORTE"," 50",588,635,1223
" 07","NORTE"," 51",602,640,1242
" 07","NORTE"," 52",556,686,1242
" 07","NORTE"," 53",583,633,1216
" 07","NORTE"," 54",556,658,1214
" 07","NORTE"," 55",510,589,1099
" 07","NORTE"," 56",505,600,1105
" 07","NORTE"," 57",523,662,1185
" 07","NORTE"," 58",516,616,1132
" 07","NORTE"," 59",546,668,1214
" 07","NORTE"," 60",589,669,1258
" 07","NORTE"," 61",504,579,1083
" 07","NORTE"," 62",472,539,1011
" 07","NORTE"," 63",457,477,934
" 07","NORTE"," 64",416,436,852
" 07","NORTE"," 65",436,402,838
" 07","NORTE"," 66",374,361,735
" 07","NORTE"," 67",303,331,634
" 07","NORTE"," 68",357,373,730
" 07","NORTE"," 69",290,348,638
" 07","NORTE"," 70",295,333,628
" 07","NORTE"," 71",224,271,495
" 07","NORTE"," 72",260,297,557
" 07","NORTE"," 73",243,292,535
" 07","NORTE"," 74",223,304,527
" 07","NORTE"," 75",156,190,346
" 07","NORTE"," 76",150,162,312
" 07","NORTE"," 77",170,226,396
" 07","NORTE"," 78",131,197,328
" 07","NORTE"," 79",97,167,264
" 07","NORTE"," 80",98,152,250
" 07","NORTE"," 81",93,204,297
" 07","NORTE"," 82",86,152,238
" 07","NORTE"," 83",76,154,230
" 07","NORTE"," 84",76,160,236
" 07","NORTE"," 85",69,143,212
" 07","NORTE"," 86",62,120,182
" 07","NORTE"," 87",50,112,162
" 07","NORTE"," 88",34,92,126
" 07","NORTE"," 89",32,72,104
" 07","NORTE","90 y más años",90,256,346
" 07","NORTE","TOTAL POBLACION",35862,37639,73501
" 08","S. PABLO-STA. JUSTA"," 00",226,201,427
" 08","S. PABLO-STA. JUSTA"," 01",239,222,461
" 08","S. PABLO-STA. JUSTA"," 02",249,218,467
" 08","S. PABLO-STA. JUSTA"," 03",254,221,475
" 08","S. PABLO-STA. JUSTA"," 04",270,214,484
" 08","S. PABLO-STA. JUSTA"," 05",298,254,552
" 08","S. PABLO-STA. JUSTA"," 06",270,247,517
" 08","S. PABLO-STA. JUSTA"," 07",266,271,537
" 08","S. PABLO-STA. JUSTA"," 08",303,282,585
" 08","S. PABLO-STA. JUSTA"," 09",289,257,546
" 08","S. PABLO-STA. JUSTA"," 10",295,263,558
" 08","S. PABLO-STA. JUSTA"," 11",293,303,596
" 08","S. PABLO-STA. JUSTA"," 12",259,280,539
" 08","S. PABLO-STA. JUSTA"," 13",271,260,531
" 08","S. PABLO-STA. JUSTA"," 14",282,275,557
" 08","S. PABLO-STA. JUSTA"," 15",269,258,527
" 08","S. PABLO-STA. JUSTA"," 16",287,242,529
" 08","S. PABLO-STA. JUSTA"," 17",277,245,522
" 08","S. PABLO-STA. JUSTA"," 18",299,227,526
" 08","S. PABLO-STA. JUSTA"," 19",283,238,521
" 08","S. PABLO-STA. JUSTA"," 20",309,291,600
" 08","S. PABLO-STA. JUSTA"," 21",302,280,582
" 08","S. PABLO-STA. JUSTA"," 22",299,288,587
" 08","S. PABLO-STA. JUSTA"," 23",322,309,631
" 08","S. PABLO-STA. JUSTA"," 24",335,296,631
" 08","S. PABLO-STA. JUSTA"," 25",362,353,715
" 08","S. PABLO-STA. JUSTA"," 26",376,322,698
" 08","S. PABLO-STA. JUSTA"," 27",313,327,640
" 08","S. PABLO-STA. JUSTA"," 28",325,337,662
" 08","S. PABLO-STA. JUSTA"," 29",324,334,658
" 08","S. PABLO-STA. JUSTA"," 30",333,358,691
" 08","S. PABLO-STA. JUSTA"," 31",334,344,678
" 08","S. PABLO-STA. JUSTA"," 32",324,345,669
" 08","S. PABLO-STA. JUSTA"," 33",357,372,729
" 08","S. PABLO-STA. JUSTA"," 34",377,347,724
" 08","S. PABLO-STA. JUSTA"," 35",400,385,785
" 08","S. PABLO-STA. JUSTA"," 36",380,397,777
" 08","S. PABLO-STA. JUSTA"," 37",390,424,814
" 08","S. PABLO-STA. JUSTA"," 38",445,407,852
" 08","S. PABLO-STA. JUSTA"," 39",480,462,942
" 08","S. PABLO-STA. JUSTA"," 40",468,447,915
" 08","S. PABLO-STA. JUSTA"," 41",485,464,949
" 08","S. PABLO-STA. JUSTA"," 42",458,454,912
" 08","S. PABLO-STA. JUSTA"," 43",457,464,921
" 08","S. PABLO-STA. JUSTA"," 44",446,443,889
" 08","S. PABLO-STA. JUSTA"," 45",470,407,877
" 08","S. PABLO-STA. JUSTA"," 46",463,440,903
" 08","S. PABLO-STA. JUSTA"," 47",452,478,930
" 08","S. PABLO-STA. JUSTA"," 48",415,451,866
" 08","S. PABLO-STA. JUSTA"," 49",402,467,869
" 08","S. PABLO-STA. JUSTA"," 50",459,470,929
" 08","S. PABLO-STA. JUSTA"," 51",414,471,885
" 08","S. PABLO-STA. JUSTA"," 52",443,540,983
" 08","S. PABLO-STA. JUSTA"," 53",479,486,965
" 08","S. PABLO-STA. JUSTA"," 54",477,543,1020
" 08","S. PABLO-STA. JUSTA"," 55",455,473,928
" 08","S. PABLO-STA. JUSTA"," 56",389,458,847
" 08","S. PABLO-STA. JUSTA"," 57",419,431,850
" 08","S. PABLO-STA. JUSTA"," 58",387,462,849
" 08","S. PABLO-STA. JUSTA"," 59",363,458,821
" 08","S. PABLO-STA. JUSTA"," 60",360,415,775
" 08","S. PABLO-STA. JUSTA"," 61",347,408,755
" 08","S. PABLO-STA. JUSTA"," 62",321,406,727
" 08","S. PABLO-STA. JUSTA"," 63",297,427,724
" 08","S. PABLO-STA. JUSTA"," 64",333,418,751
" 08","S. PABLO-STA. JUSTA"," 65",315,486,801
" 08","S. PABLO-STA. JUSTA"," 66",346,434,780
" 08","S. PABLO-STA. JUSTA"," 67",274,420,694
" 08","S. PABLO-STA. JUSTA"," 68",334,444,778
" 08","S. PABLO-STA. JUSTA"," 69",371,432,803
" 08","S. PABLO-STA. JUSTA"," 70",338,426,764
" 08","S. PABLO-STA. JUSTA"," 71",290,385,675
" 08","S. PABLO-STA. JUSTA"," 72",307,428,735
" 08","S. PABLO-STA. JUSTA"," 73",301,411,712
" 08","S. PABLO-STA. JUSTA"," 74",317,397,714
" 08","S. PABLO-STA. JUSTA"," 75",270,354,624
" 08","S. PABLO-STA. JUSTA"," 76",217,310,527
" 08","S. PABLO-STA. JUSTA"," 77",280,408,688
" 08","S. PABLO-STA. JUSTA"," 78",188,294,482
" 08","S. PABLO-STA. JUSTA"," 79",189,293,482
" 08","S. PABLO-STA. JUSTA"," 80",165,271,436
" 08","S. PABLO-STA. JUSTA"," 81",157,287,444
" 08","S. PABLO-STA. JUSTA"," 82",157,267,424
" 08","S. PABLO-STA. JUSTA"," 83",115,240,355
" 08","S. PABLO-STA. JUSTA"," 84",116,258,374
" 08","S. PABLO-STA. JUSTA"," 85",105,217,322
" 08","S. PABLO-STA. JUSTA"," 86",103,194,297
" 08","S. PABLO-STA. JUSTA"," 87",74,175,249
" 08","S. PABLO-STA. JUSTA"," 88",63,149,212
" 08","S. PABLO-STA. JUSTA"," 89",57,134,191
" 08","S. PABLO-STA. JUSTA","90 y más años",173,463,636
" 08","S. PABLO-STA. JUSTA","TOTAL POBLACION",28647,31914,60561
" 09","ESTE"," 00",525,463,988
" 09","ESTE"," 01",567,522,1089
" 09","ESTE"," 02",582,529,1111
" 09","ESTE"," 03",603,555,1158
" 09","ESTE"," 04",564,469,1033
" 09","ESTE"," 05",541,519,1060
" 09","ESTE"," 06",579,598,1177
" 09","ESTE"," 07",625,594,1219
" 09","ESTE"," 08",660,622,1282
" 09","ESTE"," 09",690,661,1351
" 09","ESTE"," 10",708,665,1373
" 09","ESTE"," 11",733,714,1447
" 09","ESTE"," 12",754,719,1473
" 09","ESTE"," 13",819,690,1509
" 09","ESTE"," 14",760,697,1457
" 09","ESTE"," 15",755,704,1459
" 09","ESTE"," 16",729,661,1390
" 09","ESTE"," 17",725,629,1354
" 09","ESTE"," 18",675,636,1311
" 09","ESTE"," 19",594,631,1225
" 09","ESTE"," 20",613,532,1145
" 09","ESTE"," 21",580,561,1141
" 09","ESTE"," 22",599,531,1130
" 09","ESTE"," 23",583,570,1153
" 09","ESTE"," 24",606,600,1206
" 09","ESTE"," 25",585,528,1113
" 09","ESTE"," 26",605,548,1153
" 09","ESTE"," 27",587,564,1151
" 09","ESTE"," 28",584,579,1163
" 09","ESTE"," 29",592,591,1183
" 09","ESTE"," 30",602,595,1197
" 09","ESTE"," 31",621,683,1304
" 09","ESTE"," 32",669,658,1327
" 09","ESTE"," 33",727,754,1481
" 09","ESTE"," 34",740,703,1443
" 09","ESTE"," 35",782,775,1557
" 09","ESTE"," 36",798,864,1662
" 09","ESTE"," 37",851,829,1680
" 09","ESTE"," 38",763,888,1651
" 09","ESTE"," 39",884,928,1812
" 09","ESTE"," 40",880,866,1746
" 09","ESTE"," 41",882,1008,1890
" 09","ESTE"," 42",891,997,1888
" 09","ESTE"," 43",896,989,1885
" 09","ESTE"," 44",911,982,1893
" 09","ESTE"," 45",976,1013,1989
" 09","ESTE"," 46",957,1042,1999
" 09","ESTE"," 47",981,1018,1999
" 09","ESTE"," 48",929,965,1894
" 09","ESTE"," 49",874,937,1811
" 09","ESTE"," 50",887,961,1848
" 09","ESTE"," 51",869,934,1803
" 09","ESTE"," 52",889,875,1764
" 09","ESTE"," 53",851,938,1789
" 09","ESTE"," 54",777,856,1633
" 09","ESTE"," 55",758,780,1538
" 09","ESTE"," 56",697,721,1418
" 09","ESTE"," 57",651,760,1411
" 09","ESTE"," 58",650,654,1304
" 09","ESTE"," 59",620,648,1268
" 09","ESTE"," 60",635,662,1297
" 09","ESTE"," 61",492,592,1084
" 09","ESTE"," 62",498,559,1057
" 09","ESTE"," 63",462,510,972
" 09","ESTE"," 64",465,473,938
" 09","ESTE"," 65",461,512,973
" 09","ESTE"," 66",431,488,919
" 09","ESTE"," 67",359,444,803
" 09","ESTE"," 68",418,431,849
" 09","ESTE"," 69",412,485,897
" 09","ESTE"," 70",381,409,790
" 09","ESTE"," 71",334,330,664
" 09","ESTE"," 72",346,391,737
" 09","ESTE"," 73",367,344,711
" 09","ESTE"," 74",295,352,647
" 09","ESTE"," 75",221,259,480
" 09","ESTE"," 76",170,225,395
" 09","ESTE"," 77",190,255,445
" 09","ESTE"," 78",146,189,335
" 09","ESTE"," 79",135,181,316
" 09","ESTE"," 80",144,207,351
" 09","ESTE"," 81",129,193,322
" 09","ESTE"," 82",114,182,296
" 09","ESTE"," 83",116,178,294
" 09","ESTE"," 84",95,157,252
" 09","ESTE"," 85",79,138,217
" 09","ESTE"," 86",61,118,179
" 09","ESTE"," 87",54,116,170
" 09","ESTE"," 88",55,87,142
" 09","ESTE"," 89",37,80,117
" 09","ESTE","90 y más años",107,251,358
" 09","ESTE","TOTAL POBLACION",51594,53301,104895
" 10","BELLAVISTA-LA PALMERA"," 00",226,203,429
" 10","BELLAVISTA-LA PALMERA"," 01",279,230,509
" 10","BELLAVISTA-LA PALMERA"," 02",315,254,569
" 10","BELLAVISTA-LA PALMERA"," 03",313,279,592
" 10","BELLAVISTA-LA PALMERA"," 04",305,257,562
" 10","BELLAVISTA-LA PALMERA"," 05",329,291,620
" 10","BELLAVISTA-LA PALMERA"," 06",319,280,599
" 10","BELLAVISTA-LA PALMERA"," 07",296,290,586
" 10","BELLAVISTA-LA PALMERA"," 08",308,286,594
" 10","BELLAVISTA-LA PALMERA"," 09",286,277,563
" 10","BELLAVISTA-LA PALMERA"," 10",283,230,513
" 10","BELLAVISTA-LA PALMERA"," 11",267,236,503
" 10","BELLAVISTA-LA PALMERA"," 12",216,241,457
" 10","BELLAVISTA-LA PALMERA"," 13",224,236,460
" 10","BELLAVISTA-LA PALMERA"," 14",250,243,493
" 10","BELLAVISTA-LA PALMERA"," 15",246,208,454
" 10","BELLAVISTA-LA PALMERA"," 16",228,193,421
" 10","BELLAVISTA-LA PALMERA"," 17",208,208,416
" 10","BELLAVISTA-LA PALMERA"," 18",210,190,400
" 10","BELLAVISTA-LA PALMERA"," 19",212,219,431
" 10","BELLAVISTA-LA PALMERA"," 20",226,229,455
" 10","BELLAVISTA-LA PALMERA"," 21",219,202,421
" 10","BELLAVISTA-LA PALMERA"," 22",211,209,420
" 10","BELLAVISTA-LA PALMERA"," 23",225,206,431
" 10","BELLAVISTA-LA PALMERA"," 24",215,204,419
" 10","BELLAVISTA-LA PALMERA"," 25",205,217,422
" 10","BELLAVISTA-LA PALMERA"," 26",211,203,414
" 10","BELLAVISTA-LA PALMERA"," 27",209,193,402
" 10","BELLAVISTA-LA PALMERA"," 28",183,209,392
" 10","BELLAVISTA-LA PALMERA"," 29",185,202,387
" 10","BELLAVISTA-LA PALMERA"," 30",184,198,382
" 10","BELLAVISTA-LA PALMERA"," 31",224,226,450
" 10","BELLAVISTA-LA PALMERA"," 32",228,253,481
" 10","BELLAVISTA-LA PALMERA"," 33",205,265,470
" 10","BELLAVISTA-LA PALMERA"," 34",273,310,583
" 10","BELLAVISTA-LA PALMERA"," 35",300,299,599
" 10","BELLAVISTA-LA PALMERA"," 36",330,351,681
" 10","BELLAVISTA-LA PALMERA"," 37",362,379,741
" 10","BELLAVISTA-LA PALMERA"," 38",400,440,840
" 10","BELLAVISTA-LA PALMERA"," 39",386,441,827
" 10","BELLAVISTA-LA PALMERA"," 40",413,458,871
" 10","BELLAVISTA-LA PALMERA"," 41",442,454,896
" 10","BELLAVISTA-LA PALMERA"," 42",405,393,798
" 10","BELLAVISTA-LA PALMERA"," 43",378,364,742
" 10","BELLAVISTA-LA PALMERA"," 44",353,345,698
" 10","BELLAVISTA-LA PALMERA"," 45",344,344,688
" 10","BELLAVISTA-LA PALMERA"," 46",321,342,663
" 10","BELLAVISTA-LA PALMERA"," 47",317,355,672
" 10","BELLAVISTA-LA PALMERA"," 48",329,325,654
" 10","BELLAVISTA-LA PALMERA"," 49",305,356,661
" 10","BELLAVISTA-LA PALMERA"," 50",310,351,661
" 10","BELLAVISTA-LA PALMERA"," 51",322,351,673
" 10","BELLAVISTA-LA PALMERA"," 52",342,368,710
" 10","BELLAVISTA-LA PALMERA"," 53",322,363,685
" 10","BELLAVISTA-LA PALMERA"," 54",288,289,577
" 10","BELLAVISTA-LA PALMERA"," 55",277,272,549
" 10","BELLAVISTA-LA PALMERA"," 56",257,278,535
" 10","BELLAVISTA-LA PALMERA"," 57",262,253,515
" 10","BELLAVISTA-LA PALMERA"," 58",208,255,463
" 10","BELLAVISTA-LA PALMERA"," 59",223,238,461
" 10","BELLAVISTA-LA PALMERA"," 60",186,255,441
" 10","BELLAVISTA-LA PALMERA"," 61",200,234,434
" 10","BELLAVISTA-LA PALMERA"," 62",175,196,371
" 10","BELLAVISTA-LA PALMERA"," 63",148,189,337
" 10","BELLAVISTA-LA PALMERA"," 64",172,177,349
" 10","BELLAVISTA-LA PALMERA"," 65",176,164,340
" 10","BELLAVISTA-LA PALMERA"," 66",150,187,337
" 10","BELLAVISTA-LA PALMERA"," 67",132,175,307
" 10","BELLAVISTA-LA PALMERA"," 68",141,171,312
" 10","BELLAVISTA-LA PALMERA"," 69",135,180,315
" 10","BELLAVISTA-LA PALMERA"," 70",108,161,269
" 10","BELLAVISTA-LA PALMERA"," 71",127,164,291
" 10","BELLAVISTA-LA PALMERA"," 72",131,199,330
" 10","BELLAVISTA-LA PALMERA"," 73",118,182,300
" 10","BELLAVISTA-LA PALMERA"," 74",127,160,287
" 10","BELLAVISTA-LA PALMERA"," 75",99,130,229
" 10","BELLAVISTA-LA PALMERA"," 76",92,132,224
" 10","BELLAVISTA-LA PALMERA"," 77",114,166,280
" 10","BELLAVISTA-LA PALMERA"," 78",80,137,217
" 10","BELLAVISTA-LA PALMERA"," 79",91,107,198
" 10","BELLAVISTA-LA PALMERA"," 80",95,98,193
" 10","BELLAVISTA-LA PALMERA"," 81",83,134,217
" 10","BELLAVISTA-LA PALMERA"," 82",83,145,228
" 10","BELLAVISTA-LA PALMERA"," 83",72,137,209
" 10","BELLAVISTA-LA PALMERA"," 84",88,123,211
" 10","BELLAVISTA-LA PALMERA"," 85",66,119,185
" 10","BELLAVISTA-LA PALMERA"," 86",49,107,156
" 10","BELLAVISTA-LA PALMERA"," 87",40,97,137
" 10","BELLAVISTA-LA PALMERA"," 88",35,77,112
" 10","BELLAVISTA-LA PALMERA"," 89",32,61,93
" 10","BELLAVISTA-LA PALMERA","90 y más años",72,263,335
" 10","BELLAVISTA-LA PALMERA","TOTAL POBLACION",20136,21668,41804
" 11","LOS REMEDIOS"," 00",124,94,218
" 11","LOS REMEDIOS"," 01",127,116,243
" 11","LOS REMEDIOS"," 02",110,123,233
" 11","LOS REMEDIOS"," 03",142,124,266
" 11","LOS REMEDIOS"," 04",141,117,258
" 11","LOS REMEDIOS"," 05",128,100,228
" 11","LOS REMEDIOS"," 06",124,123,247
" 11","LOS REMEDIOS"," 07",133,145,278
" 11","LOS REMEDIOS"," 08",135,120,255
" 11","LOS REMEDIOS"," 09",143,143,286
" 11","LOS REMEDIOS"," 10",131,136,267
" 11","LOS REMEDIOS"," 11",150,144,294
" 11","LOS REMEDIOS"," 12",130,137,267
" 11","LOS REMEDIOS"," 13",116,128,244
" 11","LOS REMEDIOS"," 14",111,137,248
" 11","LOS REMEDIOS"," 15",125,130,255
" 11","LOS REMEDIOS"," 16",129,118,247
" 11","LOS REMEDIOS"," 17",123,130,253
" 11","LOS REMEDIOS"," 18",119,120,239
" 11","LOS REMEDIOS"," 19",115,140,255
" 11","LOS REMEDIOS"," 20",117,121,238
" 11","LOS REMEDIOS"," 21",142,111,253
" 11","LOS REMEDIOS"," 22",119,141,260
" 11","LOS REMEDIOS"," 23",125,139,264
" 11","LOS REMEDIOS"," 24",120,124,244
" 11","LOS REMEDIOS"," 25",125,118,243
" 11","LOS REMEDIOS"," 26",122,129,251
" 11","LOS REMEDIOS"," 27",125,130,255
" 11","LOS REMEDIOS"," 28",112,136,248
" 11","LOS REMEDIOS"," 29",118,122,240
" 11","LOS REMEDIOS"," 30",122,138,260
" 11","LOS REMEDIOS"," 31",121,120,241
" 11","LOS REMEDIOS"," 32",132,115,247
" 11","LOS REMEDIOS"," 33",147,139,286
" 11","LOS REMEDIOS"," 34",139,154,293
" 11","LOS REMEDIOS"," 35",124,181,305
" 11","LOS REMEDIOS"," 36",130,175,305
" 11","LOS REMEDIOS"," 37",198,171,369
" 11","LOS REMEDIOS"," 38",180,193,373
" 11","LOS REMEDIOS"," 39",173,177,350
" 11","LOS REMEDIOS"," 40",179,204,383
" 11","LOS REMEDIOS"," 41",175,194,369
" 11","LOS REMEDIOS"," 42",200,217,417
" 11","LOS REMEDIOS"," 43",210,217,427
" 11","LOS REMEDIOS"," 44",163,180,343
" 11","LOS REMEDIOS"," 45",197,182,379
" 11","LOS REMEDIOS"," 46",169,183,352
" 11","LOS REMEDIOS"," 47",134,201,335
" 11","LOS REMEDIOS"," 48",168,204,372
" 11","LOS REMEDIOS"," 49",139,201,340
" 11","LOS REMEDIOS"," 50",186,201,387
" 11","LOS REMEDIOS"," 51",177,196,373
" 11","LOS REMEDIOS"," 52",196,231,427
" 11","LOS REMEDIOS"," 53",165,217,382
" 11","LOS REMEDIOS"," 54",177,222,399
" 11","LOS REMEDIOS"," 55",176,206,382
" 11","LOS REMEDIOS"," 56",157,169,326
" 11","LOS REMEDIOS"," 57",159,167,326
" 11","LOS REMEDIOS"," 58",136,202,338
" 11","LOS REMEDIOS"," 59",153,173,326
" 11","LOS REMEDIOS"," 60",137,160,297
" 11","LOS REMEDIOS"," 61",109,159,268
" 11","LOS REMEDIOS"," 62",118,153,271
" 11","LOS REMEDIOS"," 63",98,162,260
" 11","LOS REMEDIOS"," 64",116,180,296
" 11","LOS REMEDIOS"," 65",113,149,262
" 11","LOS REMEDIOS"," 66",78,149,227
" 11","LOS REMEDIOS"," 67",123,164,287
" 11","LOS REMEDIOS"," 68",106,147,253
" 11","LOS REMEDIOS"," 69",118,162,280
" 11","LOS REMEDIOS"," 70",102,179,281
" 11","LOS REMEDIOS"," 71",104,168,272
" 11","LOS REMEDIOS"," 72",102,177,279
" 11","LOS REMEDIOS"," 73",114,195,309
" 11","LOS REMEDIOS"," 74",118,209,327
" 11","LOS REMEDIOS"," 75",109,152,261
" 11","LOS REMEDIOS"," 76",94,139,233
" 11","LOS REMEDIOS"," 77",98,168,266
" 11","LOS REMEDIOS"," 78",87,158,245
" 11","LOS REMEDIOS"," 79",80,141,221
" 11","LOS REMEDIOS"," 80",79,123,202
" 11","LOS REMEDIOS"," 81",83,132,215
" 11","LOS REMEDIOS"," 82",86,144,230
" 11","LOS REMEDIOS"," 83",77,122,199
" 11","LOS REMEDIOS"," 84",61,104,165
" 11","LOS REMEDIOS"," 85",46,103,149
" 11","LOS REMEDIOS"," 86",47,85,132
" 11","LOS REMEDIOS"," 87",30,114,144
" 11","LOS REMEDIOS"," 88",46,78,124
" 11","LOS REMEDIOS"," 89",37,72,109
" 11","LOS REMEDIOS","90 y más años",104,290,394
" 11","LOS REMEDIOS","TOTAL POBLACION",11483,13964,25447
