"CD","DISTRITO","PROCEDENCIA","NACIONALIDAD","HOMBRES","MUJERES","TOTAL"
" 01","CASCO ANTIGUO","- TODOS -","ESPA�OLES",632,653,1285
" 01","CASCO ANTIGUO","- TODOS -","EXTRANJEROS",325,422,747
" 01","CASCO ANTIGUO","- TODOS -","TOTAL POBLACION",957,1075,2032
" 01","CASCO ANTIGUO","ALBANIA","EXTRANJEROS",3,0,3
" 01","CASCO ANTIGUO","ALBANIA","TOTAL POBLACION",3,0,3
" 01","CASCO ANTIGUO","ALEMANIA","ESPA�OLES",1,0,1
" 01","CASCO ANTIGUO","ALEMANIA","EXTRANJEROS",10,7,17
" 01","CASCO ANTIGUO","ALEMANIA","TOTAL POBLACION",11,7,18
" 01","CASCO ANTIGUO","ARGELIA","ESPA�OLES",1,0,1
" 01","CASCO ANTIGUO","ARGELIA","EXTRANJEROS",3,2,5
" 01","CASCO ANTIGUO","ARGELIA","TOTAL POBLACION",4,2,6
" 01","CASCO ANTIGUO","ARGENTINA","ESPA�OLES",2,1,3
" 01","CASCO ANTIGUO","ARGENTINA","EXTRANJEROS",9,11,20
" 01","CASCO ANTIGUO","ARGENTINA","TOTAL POBLACION",11,12,23
" 01","CASCO ANTIGUO","AUSTRALIA","EXTRANJEROS",1,1,2
" 01","CASCO ANTIGUO","AUSTRALIA","TOTAL POBLACION",1,1,2
" 01","CASCO ANTIGUO","AZERBAIYAN","EXTRANJEROS",0,2,2
" 01","CASCO ANTIGUO","AZERBAIYAN","TOTAL POBLACION",0,2,2
" 01","CASCO ANTIGUO","BAHAMAS","ESPA�OLES",0,1,1
" 01","CASCO ANTIGUO","BAHAMAS","TOTAL POBLACION",0,1,1
" 01","CASCO ANTIGUO","BELGICA","ESPA�OLES",1,0,1
" 01","CASCO ANTIGUO","BELGICA","EXTRANJEROS",1,2,3
" 01","CASCO ANTIGUO","BELGICA","TOTAL POBLACION",2,2,4
" 01","CASCO ANTIGUO","BIELORUSIA","EXTRANJEROS",0,1,1
" 01","CASCO ANTIGUO","BIELORUSIA","TOTAL POBLACION",0,1,1
" 01","CASCO ANTIGUO","BOLIVIA","EXTRANJEROS",1,1,2
" 01","CASCO ANTIGUO","BOLIVIA","TOTAL POBLACION",1,1,2
" 01","CASCO ANTIGUO","BRASIL","ESPA�OLES",2,4,6
" 01","CASCO ANTIGUO","BRASIL","EXTRANJEROS",2,4,6
" 01","CASCO ANTIGUO","BRASIL","TOTAL POBLACION",4,8,12
" 01","CASCO ANTIGUO","BULGARIA","EXTRANJEROS",1,2,3
" 01","CASCO ANTIGUO","BULGARIA","TOTAL POBLACION",1,2,3
" 01","CASCO ANTIGUO","CANADA","EXTRANJEROS",1,1,2
" 01","CASCO ANTIGUO","CANADA","TOTAL POBLACION",1,1,2
" 01","CASCO ANTIGUO","CHILE","ESPA�OLES",1,0,1
" 01","CASCO ANTIGUO","CHILE","EXTRANJEROS",2,2,4
" 01","CASCO ANTIGUO","CHILE","TOTAL POBLACION",3,2,5
" 01","CASCO ANTIGUO","CHINA","ESPA�OLES",1,2,3
" 01","CASCO ANTIGUO","CHINA","EXTRANJEROS",17,11,28
" 01","CASCO ANTIGUO","CHINA","TOTAL POBLACION",18,13,31
" 01","CASCO ANTIGUO","COLOMBIA","ESPA�OLES",1,1,2
" 01","CASCO ANTIGUO","COLOMBIA","EXTRANJEROS",3,3,6
" 01","CASCO ANTIGUO","COLOMBIA","TOTAL POBLACION",4,4,8
" 01","CASCO ANTIGUO","COSTA RICA","ESPA�OLES",1,2,3
" 01","CASCO ANTIGUO","COSTA RICA","TOTAL POBLACION",1,2,3
" 01","CASCO ANTIGUO","CUBA","EXTRANJEROS",3,0,3
" 01","CASCO ANTIGUO","CUBA","TOTAL POBLACION",3,0,3
" 01","CASCO ANTIGUO","ECUADOR","EXTRANJEROS",2,4,6
" 01","CASCO ANTIGUO","ECUADOR","TOTAL POBLACION",2,4,6
" 01","CASCO ANTIGUO","EL SALVADOR","EXTRANJEROS",1,0,1
" 01","CASCO ANTIGUO","EL SALVADOR","TOTAL POBLACION",1,0,1
" 01","CASCO ANTIGUO","ESPA�A","ESPA�OLES",606,614,1220
" 01","CASCO ANTIGUO","ESPA�A","EXTRANJEROS",103,128,231
" 01","CASCO ANTIGUO","ESPA�A","TOTAL POBLACION",709,742,1451
" 01","CASCO ANTIGUO","ESTADOS UNIDOS DE AMERICA","ESPA�OLES",2,7,9
" 01","CASCO ANTIGUO","ESTADOS UNIDOS DE AMERICA","EXTRANJEROS",17,33,50
" 01","CASCO ANTIGUO","ESTADOS UNIDOS DE AMERICA","TOTAL POBLACION",19,40,59
" 01","CASCO ANTIGUO","FILIPINAS","EXTRANJEROS",1,5,6
" 01","CASCO ANTIGUO","FILIPINAS","TOTAL POBLACION",1,5,6
" 01","CASCO ANTIGUO","FINLANDIA","EXTRANJEROS",1,1,2
" 01","CASCO ANTIGUO","FINLANDIA","TOTAL POBLACION",1,1,2
" 01","CASCO ANTIGUO","FRANCIA","ESPA�OLES",2,3,5
" 01","CASCO ANTIGUO","FRANCIA","EXTRANJEROS",26,44,70
" 01","CASCO ANTIGUO","FRANCIA","TOTAL POBLACION",28,47,75
" 01","CASCO ANTIGUO","GEORGIA","EXTRANJEROS",1,2,3
" 01","CASCO ANTIGUO","GEORGIA","TOTAL POBLACION",1,2,3
" 01","CASCO ANTIGUO","GRECIA","EXTRANJEROS",4,1,5
" 01","CASCO ANTIGUO","GRECIA","TOTAL POBLACION",4,1,5
" 01","CASCO ANTIGUO","GUATEMALA","ESPA�OLES",0,1,1
" 01","CASCO ANTIGUO","GUATEMALA","EXTRANJEROS",1,0,1
" 01","CASCO ANTIGUO","GUATEMALA","TOTAL POBLACION",1,1,2
" 01","CASCO ANTIGUO","HONDURAS","EXTRANJEROS",0,1,1
" 01","CASCO ANTIGUO","HONDURAS","TOTAL POBLACION",0,1,1
" 01","CASCO ANTIGUO","HUNGRIA","ESPA�OLES",1,0,1
" 01","CASCO ANTIGUO","HUNGRIA","EXTRANJEROS",0,1,1
" 01","CASCO ANTIGUO","HUNGRIA","TOTAL POBLACION",1,1,2
" 01","CASCO ANTIGUO","IRLANDA","EXTRANJEROS",3,1,4
" 01","CASCO ANTIGUO","IRLANDA","TOTAL POBLACION",3,1,4
" 01","CASCO ANTIGUO","ISLANDIA","EXTRANJEROS",1,1,2
" 01","CASCO ANTIGUO","ISLANDIA","TOTAL POBLACION",1,1,2
" 01","CASCO ANTIGUO","ISRAEL","EXTRANJEROS",0,1,1
" 01","CASCO ANTIGUO","ISRAEL","TOTAL POBLACION",0,1,1
" 01","CASCO ANTIGUO","ITALIA","ESPA�OLES",0,3,3
" 01","CASCO ANTIGUO","ITALIA","EXTRANJEROS",32,36,68
" 01","CASCO ANTIGUO","ITALIA","TOTAL POBLACION",32,39,71
" 01","CASCO ANTIGUO","JAPON","EXTRANJEROS",1,7,8
" 01","CASCO ANTIGUO","JAPON","TOTAL POBLACION",1,7,8
" 01","CASCO ANTIGUO","JORDANIA","ESPA�OLES",0,1,1
" 01","CASCO ANTIGUO","JORDANIA","TOTAL POBLACION",0,1,1
" 01","CASCO ANTIGUO","KENIA","EXTRANJEROS",0,2,2
" 01","CASCO ANTIGUO","KENIA","TOTAL POBLACION",0,2,2
" 01","CASCO ANTIGUO","LETONIA","EXTRANJEROS",0,1,1
" 01","CASCO ANTIGUO","LETONIA","TOTAL POBLACION",0,1,1
" 01","CASCO ANTIGUO","LITUANIA","EXTRANJEROS",0,1,1
" 01","CASCO ANTIGUO","LITUANIA","TOTAL POBLACION",0,1,1
" 01","CASCO ANTIGUO","MARRUECOS","EXTRANJEROS",7,6,13
" 01","CASCO ANTIGUO","MARRUECOS","TOTAL POBLACION",7,6,13
" 01","CASCO ANTIGUO","MEXICO","ESPA�OLES",2,1,3
" 01","CASCO ANTIGUO","MEXICO","EXTRANJEROS",7,6,13
" 01","CASCO ANTIGUO","MEXICO","TOTAL POBLACION",9,7,16
" 01","CASCO ANTIGUO","NICARAGUA","EXTRANJEROS",0,3,3
" 01","CASCO ANTIGUO","NICARAGUA","TOTAL POBLACION",0,3,3
" 01","CASCO ANTIGUO","NIGERIA","EXTRANJEROS",1,2,3
" 01","CASCO ANTIGUO","NIGERIA","TOTAL POBLACION",1,2,3
" 01","CASCO ANTIGUO","PAISES BAJOS","ESPA�OLES",1,0,1
" 01","CASCO ANTIGUO","PAISES BAJOS","EXTRANJEROS",2,2,4
" 01","CASCO ANTIGUO","PAISES BAJOS","TOTAL POBLACION",3,2,5
" 01","CASCO ANTIGUO","PAKISTAN","EXTRANJEROS",3,0,3
" 01","CASCO ANTIGUO","PAKISTAN","TOTAL POBLACION",3,0,3
" 01","CASCO ANTIGUO","PANAMA","EXTRANJEROS",1,0,1
" 01","CASCO ANTIGUO","PANAMA","TOTAL POBLACION",1,0,1
" 01","CASCO ANTIGUO","PARAGUAY","ESPA�OLES",1,0,1
" 01","CASCO ANTIGUO","PARAGUAY","EXTRANJEROS",2,2,4
" 01","CASCO ANTIGUO","PARAGUAY","TOTAL POBLACION",3,2,5
" 01","CASCO ANTIGUO","PERU","EXTRANJEROS",2,10,12
" 01","CASCO ANTIGUO","PERU","TOTAL POBLACION",2,10,12
" 01","CASCO ANTIGUO","POLONIA","EXTRANJEROS",4,7,11
" 01","CASCO ANTIGUO","POLONIA","TOTAL POBLACION",4,7,11
" 01","CASCO ANTIGUO","PORTUGAL","ESPA�OLES",1,2,3
" 01","CASCO ANTIGUO","PORTUGAL","EXTRANJEROS",4,1,5
" 01","CASCO ANTIGUO","PORTUGAL","TOTAL POBLACION",5,3,8
" 01","CASCO ANTIGUO","REINO UNIDO","ESPA�OLES",3,4,7
" 01","CASCO ANTIGUO","REINO UNIDO","EXTRANJEROS",19,14,33
" 01","CASCO ANTIGUO","REINO UNIDO","TOTAL POBLACION",22,18,40
" 01","CASCO ANTIGUO","REPUBLICA CHECA","EXTRANJEROS",0,2,2
" 01","CASCO ANTIGUO","REPUBLICA CHECA","TOTAL POBLACION",0,2,2
" 01","CASCO ANTIGUO","REPUBLICA DE COREA","EXTRANJEROS",3,6,9
" 01","CASCO ANTIGUO","REPUBLICA DE COREA","TOTAL POBLACION",3,6,9
" 01","CASCO ANTIGUO","REPUBLICA DOMINICANA","ESPA�OLES",1,0,1
" 01","CASCO ANTIGUO","REPUBLICA DOMINICANA","EXTRANJEROS",0,5,5
" 01","CASCO ANTIGUO","REPUBLICA DOMINICANA","TOTAL POBLACION",1,5,6
" 01","CASCO ANTIGUO","RUMANIA","EXTRANJEROS",6,8,14
" 01","CASCO ANTIGUO","RUMANIA","TOTAL POBLACION",6,8,14
" 01","CASCO ANTIGUO","RUSIA","ESPA�OLES",0,1,1
" 01","CASCO ANTIGUO","RUSIA","EXTRANJEROS",0,10,10
" 01","CASCO ANTIGUO","RUSIA","TOTAL POBLACION",0,11,11
" 01","CASCO ANTIGUO","SENEGAL","EXTRANJEROS",2,0,2
" 01","CASCO ANTIGUO","SENEGAL","TOTAL POBLACION",2,0,2
" 01","CASCO ANTIGUO","SIRIA","ESPA�OLES",1,1,2
" 01","CASCO ANTIGUO","SIRIA","EXTRANJEROS",1,0,1
" 01","CASCO ANTIGUO","SIRIA","TOTAL POBLACION",2,1,3
" 01","CASCO ANTIGUO","SUECIA","EXTRANJEROS",1,2,3
" 01","CASCO ANTIGUO","SUECIA","TOTAL POBLACION",1,2,3
" 01","CASCO ANTIGUO","SUIZA","EXTRANJEROS",2,2,4
" 01","CASCO ANTIGUO","SUIZA","TOTAL POBLACION",2,2,4
" 01","CASCO ANTIGUO","TAIWAN","EXTRANJEROS",2,1,3
" 01","CASCO ANTIGUO","TAIWAN","TOTAL POBLACION",2,1,3
" 01","CASCO ANTIGUO","TANZANIA","EXTRANJEROS",0,6,6
" 01","CASCO ANTIGUO","TANZANIA","TOTAL POBLACION",0,6,6
" 01","CASCO ANTIGUO","TUNEZ","ESPA�OLES",0,1,1
" 01","CASCO ANTIGUO","TUNEZ","TOTAL POBLACION",0,1,1
" 01","CASCO ANTIGUO","TURQUIA","EXTRANJEROS",0,2,2
" 01","CASCO ANTIGUO","TURQUIA","TOTAL POBLACION",0,2,2
" 01","CASCO ANTIGUO","UCRANIA","EXTRANJEROS",1,2,3
" 01","CASCO ANTIGUO","UCRANIA","TOTAL POBLACION",1,2,3
" 01","CASCO ANTIGUO","URUGUAY","EXTRANJEROS",0,1,1
" 01","CASCO ANTIGUO","URUGUAY","TOTAL POBLACION",0,1,1
" 01","CASCO ANTIGUO","VENEZUELA","ESPA�OLES",0,2,2
" 01","CASCO ANTIGUO","VENEZUELA","EXTRANJEROS",4,2,6
" 01","CASCO ANTIGUO","VENEZUELA","TOTAL POBLACION",4,4,8
" 01","CASCO ANTIGUO","VIET-NAM","ESPA�OLES",0,1,1
" 01","CASCO ANTIGUO","VIET-NAM","TOTAL POBLACION",0,1,1
" 02","MACARENA","- TODOS -","ESPA�OLES",666,628,1294
" 02","MACARENA","- TODOS -","EXTRANJEROS",524,559,1083
" 02","MACARENA","- TODOS -","TOTAL POBLACION",1190,1187,2377
" 02","MACARENA","ALEMANIA","EXTRANJEROS",3,2,5
" 02","MACARENA","ALEMANIA","TOTAL POBLACION",3,2,5
" 02","MACARENA","ARGELIA","EXTRANJEROS",3,1,4
" 02","MACARENA","ARGELIA","TOTAL POBLACION",3,1,4
" 02","MACARENA","ARGENTINA","ESPA�OLES",0,1,1
" 02","MACARENA","ARGENTINA","EXTRANJEROS",3,0,3
" 02","MACARENA","ARGENTINA","TOTAL POBLACION",3,1,4
" 02","MACARENA","ARMENIA","EXTRANJEROS",0,2,2
" 02","MACARENA","ARMENIA","TOTAL POBLACION",0,2,2
" 02","MACARENA","AZERBAIYAN","EXTRANJEROS",0,1,1
" 02","MACARENA","AZERBAIYAN","TOTAL POBLACION",0,1,1
" 02","MACARENA","BELGICA","EXTRANJEROS",1,0,1
" 02","MACARENA","BELGICA","TOTAL POBLACION",1,0,1
" 02","MACARENA","BOLIVIA","ESPA�OLES",1,0,1
" 02","MACARENA","BOLIVIA","EXTRANJEROS",21,29,50
" 02","MACARENA","BOLIVIA","TOTAL POBLACION",22,29,51
" 02","MACARENA","BRASIL","EXTRANJEROS",3,7,10
" 02","MACARENA","BRASIL","TOTAL POBLACION",3,7,10
" 02","MACARENA","BULGARIA","EXTRANJEROS",4,2,6
" 02","MACARENA","BULGARIA","TOTAL POBLACION",4,2,6
" 02","MACARENA","CAMERUN","EXTRANJEROS",1,0,1
" 02","MACARENA","CAMERUN","TOTAL POBLACION",1,0,1
" 02","MACARENA","CANADA","EXTRANJEROS",2,2,4
" 02","MACARENA","CANADA","TOTAL POBLACION",2,2,4
" 02","MACARENA","CHILE","EXTRANJEROS",1,0,1
" 02","MACARENA","CHILE","TOTAL POBLACION",1,0,1
" 02","MACARENA","CHINA","EXTRANJEROS",10,9,19
" 02","MACARENA","CHINA","TOTAL POBLACION",10,9,19
" 02","MACARENA","COLOMBIA","ESPA�OLES",0,1,1
" 02","MACARENA","COLOMBIA","EXTRANJEROS",7,7,14
" 02","MACARENA","COLOMBIA","TOTAL POBLACION",7,8,15
" 02","MACARENA","COSTA RICA","EXTRANJEROS",2,0,2
" 02","MACARENA","COSTA RICA","TOTAL POBLACION",2,0,2
" 02","MACARENA","CUBA","ESPA�OLES",0,1,1
" 02","MACARENA","CUBA","EXTRANJEROS",2,6,8
" 02","MACARENA","CUBA","TOTAL POBLACION",2,7,9
" 02","MACARENA","DINAMARCA","ESPA�OLES",0,1,1
" 02","MACARENA","DINAMARCA","TOTAL POBLACION",0,1,1
" 02","MACARENA","ECUADOR","ESPA�OLES",0,2,2
" 02","MACARENA","ECUADOR","EXTRANJEROS",8,8,16
" 02","MACARENA","ECUADOR","TOTAL POBLACION",8,10,18
" 02","MACARENA","EL SALVADOR","EXTRANJEROS",2,1,3
" 02","MACARENA","EL SALVADOR","TOTAL POBLACION",2,1,3
" 02","MACARENA","ESLOVAQUIA","EXTRANJEROS",0,2,2
" 02","MACARENA","ESLOVAQUIA","TOTAL POBLACION",0,2,2
" 02","MACARENA","ESPA�A","ESPA�OLES",657,615,1272
" 02","MACARENA","ESPA�A","EXTRANJEROS",234,217,451
" 02","MACARENA","ESPA�A","TOTAL POBLACION",891,832,1723
" 02","MACARENA","ESTADOS UNIDOS DE AMERICA","ESPA�OLES",0,2,2
" 02","MACARENA","ESTADOS UNIDOS DE AMERICA","EXTRANJEROS",3,8,11
" 02","MACARENA","ESTADOS UNIDOS DE AMERICA","TOTAL POBLACION",3,10,13
" 02","MACARENA","FILIPINAS","ESPA�OLES",0,1,1
" 02","MACARENA","FILIPINAS","EXTRANJEROS",1,3,4
" 02","MACARENA","FILIPINAS","TOTAL POBLACION",1,4,5
" 02","MACARENA","FRANCIA","EXTRANJEROS",6,4,10
" 02","MACARENA","FRANCIA","TOTAL POBLACION",6,4,10
" 02","MACARENA","GABON","EXTRANJEROS",1,1,2
" 02","MACARENA","GABON","TOTAL POBLACION",1,1,2
" 02","MACARENA","GEORGIA","EXTRANJEROS",0,1,1
" 02","MACARENA","GEORGIA","TOTAL POBLACION",0,1,1
" 02","MACARENA","GHANA","EXTRANJEROS",2,1,3
" 02","MACARENA","GHANA","TOTAL POBLACION",2,1,3
" 02","MACARENA","GRECIA","EXTRANJEROS",0,2,2
" 02","MACARENA","GRECIA","TOTAL POBLACION",0,2,2
" 02","MACARENA","GUINEA","EXTRANJEROS",3,0,3
" 02","MACARENA","GUINEA","TOTAL POBLACION",3,0,3
" 02","MACARENA","GUINEA ECUATORIAL","EXTRANJEROS",1,0,1
" 02","MACARENA","GUINEA ECUATORIAL","TOTAL POBLACION",1,0,1
" 02","MACARENA","HONDURAS","EXTRANJEROS",4,10,14
" 02","MACARENA","HONDURAS","TOTAL POBLACION",4,10,14
" 02","MACARENA","HUNGRIA","EXTRANJEROS",2,0,2
" 02","MACARENA","HUNGRIA","TOTAL POBLACION",2,0,2
" 02","MACARENA","INDIA","EXTRANJEROS",3,0,3
" 02","MACARENA","INDIA","TOTAL POBLACION",3,0,3
" 02","MACARENA","IRAN","EXTRANJEROS",1,0,1
" 02","MACARENA","IRAN","TOTAL POBLACION",1,0,1
" 02","MACARENA","IRLANDA","EXTRANJEROS",0,1,1
" 02","MACARENA","IRLANDA","TOTAL POBLACION",0,1,1
" 02","MACARENA","ITALIA","ESPA�OLES",0,1,1
" 02","MACARENA","ITALIA","EXTRANJEROS",13,12,25
" 02","MACARENA","ITALIA","TOTAL POBLACION",13,13,26
" 02","MACARENA","JAPON","EXTRANJEROS",0,1,1
" 02","MACARENA","JAPON","TOTAL POBLACION",0,1,1
" 02","MACARENA","JORDANIA","EXTRANJEROS",3,0,3
" 02","MACARENA","JORDANIA","TOTAL POBLACION",3,0,3
" 02","MACARENA","KIRGVISTAN","EXTRANJEROS",1,0,1
" 02","MACARENA","KIRGVISTAN","TOTAL POBLACION",1,0,1
" 02","MACARENA","LITUANIA","EXTRANJEROS",0,1,1
" 02","MACARENA","LITUANIA","TOTAL POBLACION",0,1,1
" 02","MACARENA","MARRUECOS","ESPA�OLES",3,0,3
" 02","MACARENA","MARRUECOS","EXTRANJEROS",36,21,57
" 02","MACARENA","MARRUECOS","TOTAL POBLACION",39,21,60
" 02","MACARENA","MAURITANIA","EXTRANJEROS",1,0,1
" 02","MACARENA","MAURITANIA","TOTAL POBLACION",1,0,1
" 02","MACARENA","MEXICO","EXTRANJEROS",1,0,1
" 02","MACARENA","MEXICO","TOTAL POBLACION",1,0,1
" 02","MACARENA","NICARAGUA","EXTRANJEROS",12,58,70
" 02","MACARENA","NICARAGUA","TOTAL POBLACION",12,58,70
" 02","MACARENA","NIGERIA","EXTRANJEROS",13,7,20
" 02","MACARENA","NIGERIA","TOTAL POBLACION",13,7,20
" 02","MACARENA","NORUEGA","EXTRANJEROS",1,0,1
" 02","MACARENA","NORUEGA","TOTAL POBLACION",1,0,1
" 02","MACARENA","OTROS PAISES SIN RELACION DIPLOMATICA","ESPA�OLES",1,0,1
" 02","MACARENA","OTROS PAISES SIN RELACION DIPLOMATICA","TOTAL POBLACION",1,0,1
" 02","MACARENA","PAISES BAJOS","ESPA�OLES",0,2,2
" 02","MACARENA","PAISES BAJOS","EXTRANJEROS",1,0,1
" 02","MACARENA","PAISES BAJOS","TOTAL POBLACION",1,2,3
" 02","MACARENA","PAKISTAN","EXTRANJEROS",3,3,6
" 02","MACARENA","PAKISTAN","TOTAL POBLACION",3,3,6
" 02","MACARENA","PARAGUAY","ESPA�OLES",1,0,1
" 02","MACARENA","PARAGUAY","EXTRANJEROS",12,16,28
" 02","MACARENA","PARAGUAY","TOTAL POBLACION",13,16,29
" 02","MACARENA","PERU","EXTRANJEROS",15,18,33
" 02","MACARENA","PERU","TOTAL POBLACION",15,18,33
" 02","MACARENA","POLONIA","EXTRANJEROS",2,2,4
" 02","MACARENA","POLONIA","TOTAL POBLACION",2,2,4
" 02","MACARENA","PORTUGAL","ESPA�OLES",1,0,1
" 02","MACARENA","PORTUGAL","EXTRANJEROS",7,2,9
" 02","MACARENA","PORTUGAL","TOTAL POBLACION",8,2,10
" 02","MACARENA","REINO UNIDO","ESPA�OLES",2,0,2
" 02","MACARENA","REINO UNIDO","EXTRANJEROS",9,6,15
" 02","MACARENA","REINO UNIDO","TOTAL POBLACION",11,6,17
" 02","MACARENA","REPUBLICA CHECA","EXTRANJEROS",1,0,1
" 02","MACARENA","REPUBLICA CHECA","TOTAL POBLACION",1,0,1
" 02","MACARENA","REPUBLICA DOMINICANA","EXTRANJEROS",4,8,12
" 02","MACARENA","REPUBLICA DOMINICANA","TOTAL POBLACION",4,8,12
" 02","MACARENA","RUMANIA","EXTRANJEROS",17,23,40
" 02","MACARENA","RUMANIA","TOTAL POBLACION",17,23,40
" 02","MACARENA","RUSIA","EXTRANJEROS",7,33,40
" 02","MACARENA","RUSIA","TOTAL POBLACION",7,33,40
" 02","MACARENA","SENEGAL","EXTRANJEROS",17,0,17
" 02","MACARENA","SENEGAL","TOTAL POBLACION",17,0,17
" 02","MACARENA","SERBIA","EXTRANJEROS",0,1,1
" 02","MACARENA","SERBIA","TOTAL POBLACION",0,1,1
" 02","MACARENA","SUECIA","EXTRANJEROS",1,0,1
" 02","MACARENA","SUECIA","TOTAL POBLACION",1,0,1
" 02","MACARENA","SUIZA","EXTRANJEROS",0,2,2
" 02","MACARENA","SUIZA","TOTAL POBLACION",0,2,2
" 02","MACARENA","TAIWAN","EXTRANJEROS",1,0,1
" 02","MACARENA","TAIWAN","TOTAL POBLACION",1,0,1
" 02","MACARENA","TURQUIA","EXTRANJEROS",1,0,1
" 02","MACARENA","TURQUIA","TOTAL POBLACION",1,0,1
" 02","MACARENA","UCRANIA","EXTRANJEROS",6,12,18
" 02","MACARENA","UCRANIA","TOTAL POBLACION",6,12,18
" 02","MACARENA","URUGUAY","EXTRANJEROS",0,1,1
" 02","MACARENA","URUGUAY","TOTAL POBLACION",0,1,1
" 02","MACARENA","VENEZUELA","ESPA�OLES",0,1,1
" 02","MACARENA","VENEZUELA","EXTRANJEROS",5,5,10
" 02","MACARENA","VENEZUELA","TOTAL POBLACION",5,6,11
" 03","NERVION","- TODOS -","ESPA�OLES",420,429,849
" 03","NERVION","- TODOS -","EXTRANJEROS",132,185,317
" 03","NERVION","- TODOS -","TOTAL POBLACION",552,614,1166
" 03","NERVION","ALEMANIA","ESPA�OLES",3,2,5
" 03","NERVION","ALEMANIA","EXTRANJEROS",5,0,5
" 03","NERVION","ALEMANIA","TOTAL POBLACION",8,2,10
" 03","NERVION","ARGENTINA","ESPA�OLES",1,0,1
" 03","NERVION","ARGENTINA","TOTAL POBLACION",1,0,1
" 03","NERVION","BANGLA-DESH","EXTRANJEROS",1,0,1
" 03","NERVION","BANGLA-DESH","TOTAL POBLACION",1,0,1
" 03","NERVION","BELGICA","ESPA�OLES",0,1,1
" 03","NERVION","BELGICA","EXTRANJEROS",1,1,2
" 03","NERVION","BELGICA","TOTAL POBLACION",1,2,3
" 03","NERVION","BOLIVIA","EXTRANJEROS",0,1,1
" 03","NERVION","BOLIVIA","TOTAL POBLACION",0,1,1
" 03","NERVION","BRASIL","ESPA�OLES",0,1,1
" 03","NERVION","BRASIL","EXTRANJEROS",4,7,11
" 03","NERVION","BRASIL","TOTAL POBLACION",4,8,12
" 03","NERVION","CANADA","ESPA�OLES",1,0,1
" 03","NERVION","CANADA","EXTRANJEROS",3,3,6
" 03","NERVION","CANADA","TOTAL POBLACION",4,3,7
" 03","NERVION","CHILE","ESPA�OLES",2,0,2
" 03","NERVION","CHILE","EXTRANJEROS",0,4,4
" 03","NERVION","CHILE","TOTAL POBLACION",2,4,6
" 03","NERVION","CHINA","ESPA�OLES",1,0,1
" 03","NERVION","CHINA","EXTRANJEROS",9,9,18
" 03","NERVION","CHINA","TOTAL POBLACION",10,9,19
" 03","NERVION","COLOMBIA","ESPA�OLES",1,0,1
" 03","NERVION","COLOMBIA","EXTRANJEROS",4,2,6
" 03","NERVION","COLOMBIA","TOTAL POBLACION",5,2,7
" 03","NERVION","CUBA","ESPA�OLES",2,0,2
" 03","NERVION","CUBA","EXTRANJEROS",4,4,8
" 03","NERVION","CUBA","TOTAL POBLACION",6,4,10
" 03","NERVION","ECUADOR","ESPA�OLES",1,0,1
" 03","NERVION","ECUADOR","EXTRANJEROS",0,2,2
" 03","NERVION","ECUADOR","TOTAL POBLACION",1,2,3
" 03","NERVION","EMIRATOS ARABES UNIDOS","ESPA�OLES",0,1,1
" 03","NERVION","EMIRATOS ARABES UNIDOS","TOTAL POBLACION",0,1,1
" 03","NERVION","ESLOVENIA","EXTRANJEROS",0,1,1
" 03","NERVION","ESLOVENIA","TOTAL POBLACION",0,1,1
" 03","NERVION","ESPA�A","ESPA�OLES",403,415,818
" 03","NERVION","ESPA�A","EXTRANJEROS",59,66,125
" 03","NERVION","ESPA�A","TOTAL POBLACION",462,481,943
" 03","NERVION","ESTADOS UNIDOS DE AMERICA","ESPA�OLES",1,0,1
" 03","NERVION","ESTADOS UNIDOS DE AMERICA","EXTRANJEROS",4,6,10
" 03","NERVION","ESTADOS UNIDOS DE AMERICA","TOTAL POBLACION",5,6,11
" 03","NERVION","FINLANDIA","EXTRANJEROS",1,1,2
" 03","NERVION","FINLANDIA","TOTAL POBLACION",1,1,2
" 03","NERVION","FRANCIA","EXTRANJEROS",5,12,17
" 03","NERVION","FRANCIA","TOTAL POBLACION",5,12,17
" 03","NERVION","GUATEMALA","ESPA�OLES",0,1,1
" 03","NERVION","GUATEMALA","EXTRANJEROS",0,1,1
" 03","NERVION","GUATEMALA","TOTAL POBLACION",0,2,2
" 03","NERVION","HAITI","EXTRANJEROS",1,0,1
" 03","NERVION","HAITI","TOTAL POBLACION",1,0,1
" 03","NERVION","HONDURAS","EXTRANJEROS",1,2,3
" 03","NERVION","HONDURAS","TOTAL POBLACION",1,2,3
" 03","NERVION","HUNGRIA","EXTRANJEROS",0,1,1
" 03","NERVION","HUNGRIA","TOTAL POBLACION",0,1,1
" 03","NERVION","INDIA","ESPA�OLES",0,1,1
" 03","NERVION","INDIA","EXTRANJEROS",0,1,1
" 03","NERVION","INDIA","TOTAL POBLACION",0,2,2
" 03","NERVION","IRAN","EXTRANJEROS",0,1,1
" 03","NERVION","IRAN","TOTAL POBLACION",0,1,1
" 03","NERVION","ISRAEL","EXTRANJEROS",1,0,1
" 03","NERVION","ISRAEL","TOTAL POBLACION",1,0,1
" 03","NERVION","ITALIA","EXTRANJEROS",2,6,8
" 03","NERVION","ITALIA","TOTAL POBLACION",2,6,8
" 03","NERVION","JAPON","ESPA�OLES",0,1,1
" 03","NERVION","JAPON","TOTAL POBLACION",0,1,1
" 03","NERVION","MARRUECOS","ESPA�OLES",1,0,1
" 03","NERVION","MARRUECOS","EXTRANJEROS",2,0,2
" 03","NERVION","MARRUECOS","TOTAL POBLACION",3,0,3
" 03","NERVION","MEXICO","ESPA�OLES",0,2,2
" 03","NERVION","MEXICO","EXTRANJEROS",1,3,4
" 03","NERVION","MEXICO","TOTAL POBLACION",1,5,6
" 03","NERVION","NICARAGUA","EXTRANJEROS",3,9,12
" 03","NERVION","NICARAGUA","TOTAL POBLACION",3,9,12
" 03","NERVION","NUEVA ZELANDA","EXTRANJEROS",0,1,1
" 03","NERVION","NUEVA ZELANDA","TOTAL POBLACION",0,1,1
" 03","NERVION","PAKISTAN","EXTRANJEROS",2,0,2
" 03","NERVION","PAKISTAN","TOTAL POBLACION",2,0,2
" 03","NERVION","PARAGUAY","EXTRANJEROS",6,15,21
" 03","NERVION","PARAGUAY","TOTAL POBLACION",6,15,21
" 03","NERVION","PERU","EXTRANJEROS",0,2,2
" 03","NERVION","PERU","TOTAL POBLACION",0,2,2
" 03","NERVION","POLONIA","EXTRANJEROS",0,2,2
" 03","NERVION","POLONIA","TOTAL POBLACION",0,2,2
" 03","NERVION","PORTUGAL","ESPA�OLES",1,1,2
" 03","NERVION","PORTUGAL","EXTRANJEROS",1,1,2
" 03","NERVION","PORTUGAL","TOTAL POBLACION",2,2,4
" 03","NERVION","REINO UNIDO","ESPA�OLES",1,1,2
" 03","NERVION","REINO UNIDO","EXTRANJEROS",5,1,6
" 03","NERVION","REINO UNIDO","TOTAL POBLACION",6,2,8
" 03","NERVION","REPUBLICA DE COREA","EXTRANJEROS",0,1,1
" 03","NERVION","REPUBLICA DE COREA","TOTAL POBLACION",0,1,1
" 03","NERVION","REPUBLICA DOMINICANA","EXTRANJEROS",3,5,8
" 03","NERVION","REPUBLICA DOMINICANA","TOTAL POBLACION",3,5,8
" 03","NERVION","REPUBLICA SUDAFRICANA","ESPA�OLES",1,1,2
" 03","NERVION","REPUBLICA SUDAFRICANA","TOTAL POBLACION",1,1,2
" 03","NERVION","RUMANIA","EXTRANJEROS",1,3,4
" 03","NERVION","RUMANIA","TOTAL POBLACION",1,3,4
" 03","NERVION","RUSIA","EXTRANJEROS",0,2,2
" 03","NERVION","RUSIA","TOTAL POBLACION",0,2,2
" 03","NERVION","SUIZA","ESPA�OLES",0,1,1
" 03","NERVION","SUIZA","TOTAL POBLACION",0,1,1
" 03","NERVION","UCRANIA","EXTRANJEROS",1,5,6
" 03","NERVION","UCRANIA","TOTAL POBLACION",1,5,6
" 03","NERVION","URUGUAY","EXTRANJEROS",1,1,2
" 03","NERVION","URUGUAY","TOTAL POBLACION",1,1,2
" 03","NERVION","VENEZUELA","EXTRANJEROS",1,3,4
" 03","NERVION","VENEZUELA","TOTAL POBLACION",1,3,4
" 04","CERRO-AMATE","- TODOS -","ESPA�OLES",609,634,1243
" 04","CERRO-AMATE","- TODOS -","EXTRANJEROS",441,441,882
" 04","CERRO-AMATE","- TODOS -","TOTAL POBLACION",1050,1075,2125
" 04","CERRO-AMATE","ALEMANIA","ESPA�OLES",1,0,1
" 04","CERRO-AMATE","ALEMANIA","EXTRANJEROS",1,2,3
" 04","CERRO-AMATE","ALEMANIA","TOTAL POBLACION",2,2,4
" 04","CERRO-AMATE","ARGELIA","EXTRANJEROS",1,1,2
" 04","CERRO-AMATE","ARGELIA","TOTAL POBLACION",1,1,2
" 04","CERRO-AMATE","ARGENTINA","EXTRANJEROS",0,1,1
" 04","CERRO-AMATE","ARGENTINA","TOTAL POBLACION",0,1,1
" 04","CERRO-AMATE","AUSTRALIA","ESPA�OLES",1,1,2
" 04","CERRO-AMATE","AUSTRALIA","TOTAL POBLACION",1,1,2
" 04","CERRO-AMATE","BELGICA","ESPA�OLES",1,1,2
" 04","CERRO-AMATE","BELGICA","EXTRANJEROS",1,0,1
" 04","CERRO-AMATE","BELGICA","TOTAL POBLACION",2,1,3
" 04","CERRO-AMATE","BOLIVIA","ESPA�OLES",0,2,2
" 04","CERRO-AMATE","BOLIVIA","EXTRANJEROS",5,6,11
" 04","CERRO-AMATE","BOLIVIA","TOTAL POBLACION",5,8,13
" 04","CERRO-AMATE","BRASIL","EXTRANJEROS",1,3,4
" 04","CERRO-AMATE","BRASIL","TOTAL POBLACION",1,3,4
" 04","CERRO-AMATE","BULGARIA","EXTRANJEROS",2,2,4
" 04","CERRO-AMATE","BULGARIA","TOTAL POBLACION",2,2,4
" 04","CERRO-AMATE","CAMERUN","EXTRANJEROS",3,3,6
" 04","CERRO-AMATE","CAMERUN","TOTAL POBLACION",3,3,6
" 04","CERRO-AMATE","CHINA","ESPA�OLES",0,1,1
" 04","CERRO-AMATE","CHINA","EXTRANJEROS",19,21,40
" 04","CERRO-AMATE","CHINA","TOTAL POBLACION",19,22,41
" 04","CERRO-AMATE","CHIPRE","EXTRANJEROS",1,0,1
" 04","CERRO-AMATE","CHIPRE","TOTAL POBLACION",1,0,1
" 04","CERRO-AMATE","COLOMBIA","ESPA�OLES",0,1,1
" 04","CERRO-AMATE","COLOMBIA","EXTRANJEROS",5,2,7
" 04","CERRO-AMATE","COLOMBIA","TOTAL POBLACION",5,3,8
" 04","CERRO-AMATE","COSTA DE MARFIL","EXTRANJEROS",1,0,1
" 04","CERRO-AMATE","COSTA DE MARFIL","TOTAL POBLACION",1,0,1
" 04","CERRO-AMATE","CUBA","ESPA�OLES",1,0,1
" 04","CERRO-AMATE","CUBA","EXTRANJEROS",5,8,13
" 04","CERRO-AMATE","CUBA","TOTAL POBLACION",6,8,14
" 04","CERRO-AMATE","DINAMARCA","EXTRANJEROS",0,1,1
" 04","CERRO-AMATE","DINAMARCA","TOTAL POBLACION",0,1,1
" 04","CERRO-AMATE","ECUADOR","ESPA�OLES",2,0,2
" 04","CERRO-AMATE","ECUADOR","EXTRANJEROS",3,0,3
" 04","CERRO-AMATE","ECUADOR","TOTAL POBLACION",5,0,5
" 04","CERRO-AMATE","EL SALVADOR","EXTRANJEROS",1,3,4
" 04","CERRO-AMATE","EL SALVADOR","TOTAL POBLACION",1,3,4
" 04","CERRO-AMATE","ESPA�A","ESPA�OLES",600,624,1224
" 04","CERRO-AMATE","ESPA�A","EXTRANJEROS",228,204,432
" 04","CERRO-AMATE","ESPA�A","TOTAL POBLACION",828,828,1656
" 04","CERRO-AMATE","ESTADOS UNIDOS DE AMERICA","EXTRANJEROS",1,0,1
" 04","CERRO-AMATE","ESTADOS UNIDOS DE AMERICA","TOTAL POBLACION",1,0,1
" 04","CERRO-AMATE","FILIPINAS","ESPA�OLES",0,1,1
" 04","CERRO-AMATE","FILIPINAS","EXTRANJEROS",1,0,1
" 04","CERRO-AMATE","FILIPINAS","TOTAL POBLACION",1,1,2
" 04","CERRO-AMATE","FRANCIA","ESPA�OLES",1,2,3
" 04","CERRO-AMATE","FRANCIA","EXTRANJEROS",1,3,4
" 04","CERRO-AMATE","FRANCIA","TOTAL POBLACION",2,5,7
" 04","CERRO-AMATE","GAMBIA","EXTRANJEROS",1,0,1
" 04","CERRO-AMATE","GAMBIA","TOTAL POBLACION",1,0,1
" 04","CERRO-AMATE","GRANADA","EXTRANJEROS",1,0,1
" 04","CERRO-AMATE","GRANADA","TOTAL POBLACION",1,0,1
" 04","CERRO-AMATE","GUATEMALA","EXTRANJEROS",1,0,1
" 04","CERRO-AMATE","GUATEMALA","TOTAL POBLACION",1,0,1
" 04","CERRO-AMATE","GUINEA","EXTRANJEROS",2,0,2
" 04","CERRO-AMATE","GUINEA","TOTAL POBLACION",2,0,2
" 04","CERRO-AMATE","HONDURAS","EXTRANJEROS",5,11,16
" 04","CERRO-AMATE","HONDURAS","TOTAL POBLACION",5,11,16
" 04","CERRO-AMATE","HUNGRIA","EXTRANJEROS",0,1,1
" 04","CERRO-AMATE","HUNGRIA","TOTAL POBLACION",0,1,1
" 04","CERRO-AMATE","INDIA","EXTRANJEROS",0,1,1
" 04","CERRO-AMATE","INDIA","TOTAL POBLACION",0,1,1
" 04","CERRO-AMATE","IRLANDA","EXTRANJEROS",0,1,1
" 04","CERRO-AMATE","IRLANDA","TOTAL POBLACION",0,1,1
" 04","CERRO-AMATE","ITALIA","EXTRANJEROS",4,8,12
" 04","CERRO-AMATE","ITALIA","TOTAL POBLACION",4,8,12
" 04","CERRO-AMATE","JAPON","EXTRANJEROS",0,1,1
" 04","CERRO-AMATE","JAPON","TOTAL POBLACION",0,1,1
" 04","CERRO-AMATE","MALI","EXTRANJEROS",2,1,3
" 04","CERRO-AMATE","MALI","TOTAL POBLACION",2,1,3
" 04","CERRO-AMATE","MARRUECOS","EXTRANJEROS",46,31,77
" 04","CERRO-AMATE","MARRUECOS","TOTAL POBLACION",46,31,77
" 04","CERRO-AMATE","MEXICO","EXTRANJEROS",0,1,1
" 04","CERRO-AMATE","MEXICO","TOTAL POBLACION",0,1,1
" 04","CERRO-AMATE","NICARAGUA","EXTRANJEROS",3,17,20
" 04","CERRO-AMATE","NICARAGUA","TOTAL POBLACION",3,17,20
" 04","CERRO-AMATE","NIGERIA","EXTRANJEROS",13,5,18
" 04","CERRO-AMATE","NIGERIA","TOTAL POBLACION",13,5,18
" 04","CERRO-AMATE","PAISES BAJOS","ESPA�OLES",0,1,1
" 04","CERRO-AMATE","PAISES BAJOS","EXTRANJEROS",1,2,3
" 04","CERRO-AMATE","PAISES BAJOS","TOTAL POBLACION",1,3,4
" 04","CERRO-AMATE","PAKISTAN","EXTRANJEROS",3,0,3
" 04","CERRO-AMATE","PAKISTAN","TOTAL POBLACION",3,0,3
" 04","CERRO-AMATE","PANAMA","EXTRANJEROS",1,1,2
" 04","CERRO-AMATE","PANAMA","TOTAL POBLACION",1,1,2
" 04","CERRO-AMATE","PARAGUAY","EXTRANJEROS",6,14,20
" 04","CERRO-AMATE","PARAGUAY","TOTAL POBLACION",6,14,20
" 04","CERRO-AMATE","PERU","EXTRANJEROS",8,4,12
" 04","CERRO-AMATE","PERU","TOTAL POBLACION",8,4,12
" 04","CERRO-AMATE","POLONIA","EXTRANJEROS",1,1,2
" 04","CERRO-AMATE","POLONIA","TOTAL POBLACION",1,1,2
" 04","CERRO-AMATE","PORTUGAL","ESPA�OLES",1,0,1
" 04","CERRO-AMATE","PORTUGAL","EXTRANJEROS",2,1,3
" 04","CERRO-AMATE","PORTUGAL","TOTAL POBLACION",3,1,4
" 04","CERRO-AMATE","REINO UNIDO","ESPA�OLES",1,0,1
" 04","CERRO-AMATE","REINO UNIDO","EXTRANJEROS",0,2,2
" 04","CERRO-AMATE","REINO UNIDO","TOTAL POBLACION",1,2,3
" 04","CERRO-AMATE","REPUBLICA CHECA","EXTRANJEROS",0,1,1
" 04","CERRO-AMATE","REPUBLICA CHECA","TOTAL POBLACION",0,1,1
" 04","CERRO-AMATE","REPUBLICA DOMINICANA","EXTRANJEROS",3,4,7
" 04","CERRO-AMATE","REPUBLICA DOMINICANA","TOTAL POBLACION",3,4,7
" 04","CERRO-AMATE","RUANDA","EXTRANJEROS",1,0,1
" 04","CERRO-AMATE","RUANDA","TOTAL POBLACION",1,0,1
" 04","CERRO-AMATE","RUMANIA","EXTRANJEROS",43,48,91
" 04","CERRO-AMATE","RUMANIA","TOTAL POBLACION",43,48,91
" 04","CERRO-AMATE","RUSIA","EXTRANJEROS",3,13,16
" 04","CERRO-AMATE","RUSIA","TOTAL POBLACION",3,13,16
" 04","CERRO-AMATE","SENEGAL","EXTRANJEROS",8,1,9
" 04","CERRO-AMATE","SENEGAL","TOTAL POBLACION",8,1,9
" 04","CERRO-AMATE","TUNEZ","EXTRANJEROS",0,1,1
" 04","CERRO-AMATE","TUNEZ","TOTAL POBLACION",0,1,1
" 04","CERRO-AMATE","UCRANIA","EXTRANJEROS",2,5,7
" 04","CERRO-AMATE","UCRANIA","TOTAL POBLACION",2,5,7
" 04","CERRO-AMATE","VENEZUELA","EXTRANJEROS",1,5,6
" 04","CERRO-AMATE","VENEZUELA","TOTAL POBLACION",1,5,6
" 05","SUR","- TODOS -","ESPA�OLES",608,662,1270
" 05","SUR","- TODOS -","EXTRANJEROS",250,290,540
" 05","SUR","- TODOS -","TOTAL POBLACION",858,952,1810
" 05","SUR","ALEMANIA","ESPA�OLES",0,1,1
" 05","SUR","ALEMANIA","EXTRANJEROS",2,1,3
" 05","SUR","ALEMANIA","TOTAL POBLACION",2,2,4
" 05","SUR","ARGELIA","EXTRANJEROS",0,1,1
" 05","SUR","ARGELIA","TOTAL POBLACION",0,1,1
" 05","SUR","ARGENTINA","ESPA�OLES",1,2,3
" 05","SUR","ARGENTINA","EXTRANJEROS",3,2,5
" 05","SUR","ARGENTINA","TOTAL POBLACION",4,4,8
" 05","SUR","ARMENIA","EXTRANJEROS",1,0,1
" 05","SUR","ARMENIA","TOTAL POBLACION",1,0,1
" 05","SUR","BOLIVIA","EXTRANJEROS",2,5,7
" 05","SUR","BOLIVIA","TOTAL POBLACION",2,5,7
" 05","SUR","BRASIL","EXTRANJEROS",5,3,8
" 05","SUR","BRASIL","TOTAL POBLACION",5,3,8
" 05","SUR","BULGARIA","EXTRANJEROS",1,1,2
" 05","SUR","BULGARIA","TOTAL POBLACION",1,1,2
" 05","SUR","BURKINA FASSO","EXTRANJEROS",1,0,1
" 05","SUR","BURKINA FASSO","TOTAL POBLACION",1,0,1
" 05","SUR","CAMERUN","EXTRANJEROS",1,0,1
" 05","SUR","CAMERUN","TOTAL POBLACION",1,0,1
" 05","SUR","CHINA","EXTRANJEROS",14,28,42
" 05","SUR","CHINA","TOTAL POBLACION",14,28,42
" 05","SUR","COLOMBIA","EXTRANJEROS",5,7,12
" 05","SUR","COLOMBIA","TOTAL POBLACION",5,7,12
" 05","SUR","COSTA RICA","EXTRANJEROS",0,1,1
" 05","SUR","COSTA RICA","TOTAL POBLACION",0,1,1
" 05","SUR","CUBA","ESPA�OLES",2,0,2
" 05","SUR","CUBA","EXTRANJEROS",0,2,2
" 05","SUR","CUBA","TOTAL POBLACION",2,2,4
" 05","SUR","DINAMARCA","EXTRANJEROS",0,1,1
" 05","SUR","DINAMARCA","TOTAL POBLACION",0,1,1
" 05","SUR","ECUADOR","ESPA�OLES",1,1,2
" 05","SUR","ECUADOR","EXTRANJEROS",1,2,3
" 05","SUR","ECUADOR","TOTAL POBLACION",2,3,5
" 05","SUR","EL SALVADOR","EXTRANJEROS",0,4,4
" 05","SUR","EL SALVADOR","TOTAL POBLACION",0,4,4
" 05","SUR","ESPA�A","ESPA�OLES",591,645,1236
" 05","SUR","ESPA�A","EXTRANJEROS",111,117,228
" 05","SUR","ESPA�A","TOTAL POBLACION",702,762,1464
" 05","SUR","ESTADOS UNIDOS DE AMERICA","ESPA�OLES",1,0,1
" 05","SUR","ESTADOS UNIDOS DE AMERICA","EXTRANJEROS",3,3,6
" 05","SUR","ESTADOS UNIDOS DE AMERICA","TOTAL POBLACION",4,3,7
" 05","SUR","FILIPINAS","EXTRANJEROS",0,3,3
" 05","SUR","FILIPINAS","TOTAL POBLACION",0,3,3
" 05","SUR","FINLANDIA","EXTRANJEROS",0,1,1
" 05","SUR","FINLANDIA","TOTAL POBLACION",0,1,1
" 05","SUR","FRANCIA","EXTRANJEROS",3,1,4
" 05","SUR","FRANCIA","TOTAL POBLACION",3,1,4
" 05","SUR","GABON","EXTRANJEROS",2,1,3
" 05","SUR","GABON","TOTAL POBLACION",2,1,3
" 05","SUR","GRANADA","ESPA�OLES",1,0,1
" 05","SUR","GRANADA","TOTAL POBLACION",1,0,1
" 05","SUR","GUATEMALA","EXTRANJEROS",1,0,1
" 05","SUR","GUATEMALA","TOTAL POBLACION",1,0,1
" 05","SUR","GUINEA ECUATORIAL","ESPA�OLES",1,0,1
" 05","SUR","GUINEA ECUATORIAL","EXTRANJEROS",3,0,3
" 05","SUR","GUINEA ECUATORIAL","TOTAL POBLACION",4,0,4
" 05","SUR","HONDURAS","ESPA�OLES",0,2,2
" 05","SUR","HONDURAS","EXTRANJEROS",2,7,9
" 05","SUR","HONDURAS","TOTAL POBLACION",2,9,11
" 05","SUR","INDIA","EXTRANJEROS",0,1,1
" 05","SUR","INDIA","TOTAL POBLACION",0,1,1
" 05","SUR","ITALIA","EXTRANJEROS",7,4,11
" 05","SUR","ITALIA","TOTAL POBLACION",7,4,11
" 05","SUR","JAPON","ESPA�OLES",0,1,1
" 05","SUR","JAPON","TOTAL POBLACION",0,1,1
" 05","SUR","MARRUECOS","EXTRANJEROS",13,14,27
" 05","SUR","MARRUECOS","TOTAL POBLACION",13,14,27
" 05","SUR","MEXICO","ESPA�OLES",2,0,2
" 05","SUR","MEXICO","EXTRANJEROS",5,5,10
" 05","SUR","MEXICO","TOTAL POBLACION",7,5,12
" 05","SUR","NICARAGUA","ESPA�OLES",0,1,1
" 05","SUR","NICARAGUA","EXTRANJEROS",4,16,20
" 05","SUR","NICARAGUA","TOTAL POBLACION",4,17,21
" 05","SUR","NIGERIA","EXTRANJEROS",17,8,25
" 05","SUR","NIGERIA","TOTAL POBLACION",17,8,25
" 05","SUR","PAISES BAJOS","ESPA�OLES",2,3,5
" 05","SUR","PAISES BAJOS","EXTRANJEROS",1,0,1
" 05","SUR","PAISES BAJOS","TOTAL POBLACION",3,3,6
" 05","SUR","PAKISTAN","EXTRANJEROS",4,0,4
" 05","SUR","PAKISTAN","TOTAL POBLACION",4,0,4
" 05","SUR","PANAMA","ESPA�OLES",1,0,1
" 05","SUR","PANAMA","EXTRANJEROS",1,0,1
" 05","SUR","PANAMA","TOTAL POBLACION",2,0,2
" 05","SUR","PARAGUAY","ESPA�OLES",1,1,2
" 05","SUR","PARAGUAY","EXTRANJEROS",9,8,17
" 05","SUR","PARAGUAY","TOTAL POBLACION",10,9,19
" 05","SUR","PERU","ESPA�OLES",2,1,3
" 05","SUR","PERU","EXTRANJEROS",2,4,6
" 05","SUR","PERU","TOTAL POBLACION",4,5,9
" 05","SUR","REINO UNIDO","ESPA�OLES",1,0,1
" 05","SUR","REINO UNIDO","EXTRANJEROS",4,3,7
" 05","SUR","REINO UNIDO","TOTAL POBLACION",5,3,8
" 05","SUR","REPUBLICA DOMINICANA","ESPA�OLES",0,1,1
" 05","SUR","REPUBLICA DOMINICANA","EXTRANJEROS",0,1,1
" 05","SUR","REPUBLICA DOMINICANA","TOTAL POBLACION",0,2,2
" 05","SUR","RUMANIA","EXTRANJEROS",7,8,15
" 05","SUR","RUMANIA","TOTAL POBLACION",7,8,15
" 05","SUR","RUSIA","ESPA�OLES",1,0,1
" 05","SUR","RUSIA","EXTRANJEROS",1,8,9
" 05","SUR","RUSIA","TOTAL POBLACION",2,8,10
" 05","SUR","SENEGAL","ESPA�OLES",0,1,1
" 05","SUR","SENEGAL","EXTRANJEROS",2,3,5
" 05","SUR","SENEGAL","TOTAL POBLACION",2,4,6
" 05","SUR","SERBIA","EXTRANJEROS",1,0,1
" 05","SUR","SERBIA","TOTAL POBLACION",1,0,1
" 05","SUR","SIERRA LEONA","EXTRANJEROS",1,0,1
" 05","SUR","SIERRA LEONA","TOTAL POBLACION",1,0,1
" 05","SUR","TUNEZ","ESPA�OLES",0,1,1
" 05","SUR","TUNEZ","TOTAL POBLACION",0,1,1
" 05","SUR","TURQUIA","EXTRANJEROS",2,0,2
" 05","SUR","TURQUIA","TOTAL POBLACION",2,0,2
" 05","SUR","UCRANIA","ESPA�OLES",0,1,1
" 05","SUR","UCRANIA","EXTRANJEROS",3,12,15
" 05","SUR","UCRANIA","TOTAL POBLACION",3,13,16
" 05","SUR","UZBEKISTAN","EXTRANJEROS",0,1,1
" 05","SUR","UZBEKISTAN","TOTAL POBLACION",0,1,1
" 05","SUR","VENEZUELA","EXTRANJEROS",5,3,8
" 05","SUR","VENEZUELA","TOTAL POBLACION",5,3,8
" 06","TRIANA","- TODOS -","ESPA�OLES",460,433,893
" 06","TRIANA","- TODOS -","EXTRANJEROS",162,261,423
" 06","TRIANA","- TODOS -","TOTAL POBLACION",622,694,1316
" 06","TRIANA","ALEMANIA","ESPA�OLES",1,2,3
" 06","TRIANA","ALEMANIA","EXTRANJEROS",8,8,16
" 06","TRIANA","ALEMANIA","TOTAL POBLACION",9,10,19
" 06","TRIANA","ARGENTINA","EXTRANJEROS",2,6,8
" 06","TRIANA","ARGENTINA","TOTAL POBLACION",2,6,8
" 06","TRIANA","AUSTRALIA","ESPA�OLES",2,4,6
" 06","TRIANA","AUSTRALIA","EXTRANJEROS",2,1,3
" 06","TRIANA","AUSTRALIA","TOTAL POBLACION",4,5,9
" 06","TRIANA","BELGICA","EXTRANJEROS",3,0,3
" 06","TRIANA","BELGICA","TOTAL POBLACION",3,0,3
" 06","TRIANA","BIELORUSIA","EXTRANJEROS",1,1,2
" 06","TRIANA","BIELORUSIA","TOTAL POBLACION",1,1,2
" 06","TRIANA","BOLIVIA","EXTRANJEROS",7,6,13
" 06","TRIANA","BOLIVIA","TOTAL POBLACION",7,6,13
" 06","TRIANA","BRASIL","ESPA�OLES",0,1,1
" 06","TRIANA","BRASIL","EXTRANJEROS",6,8,14
" 06","TRIANA","BRASIL","TOTAL POBLACION",6,9,15
" 06","TRIANA","BULGARIA","EXTRANJEROS",0,2,2
" 06","TRIANA","BULGARIA","TOTAL POBLACION",0,2,2
" 06","TRIANA","CANADA","EXTRANJEROS",2,3,5
" 06","TRIANA","CANADA","TOTAL POBLACION",2,3,5
" 06","TRIANA","CHILE","EXTRANJEROS",0,1,1
" 06","TRIANA","CHILE","TOTAL POBLACION",0,1,1
" 06","TRIANA","CHINA","EXTRANJEROS",6,6,12
" 06","TRIANA","CHINA","TOTAL POBLACION",6,6,12
" 06","TRIANA","COLOMBIA","EXTRANJEROS",5,2,7
" 06","TRIANA","COLOMBIA","TOTAL POBLACION",5,2,7
" 06","TRIANA","CROACIA","EXTRANJEROS",0,1,1
" 06","TRIANA","CROACIA","TOTAL POBLACION",0,1,1
" 06","TRIANA","CUBA","ESPA�OLES",0,1,1
" 06","TRIANA","CUBA","EXTRANJEROS",3,1,4
" 06","TRIANA","CUBA","TOTAL POBLACION",3,2,5
" 06","TRIANA","DINAMARCA","EXTRANJEROS",1,1,2
" 06","TRIANA","DINAMARCA","TOTAL POBLACION",1,1,2
" 06","TRIANA","ECUADOR","EXTRANJEROS",1,3,4
" 06","TRIANA","ECUADOR","TOTAL POBLACION",1,3,4
" 06","TRIANA","EGIPTO","EXTRANJEROS",1,0,1
" 06","TRIANA","EGIPTO","TOTAL POBLACION",1,0,1
" 06","TRIANA","EL SALVADOR","ESPA�OLES",0,1,1
" 06","TRIANA","EL SALVADOR","EXTRANJEROS",1,3,4
" 06","TRIANA","EL SALVADOR","TOTAL POBLACION",1,4,5
" 06","TRIANA","ESPA�A","ESPA�OLES",447,409,856
" 06","TRIANA","ESPA�A","EXTRANJEROS",48,99,147
" 06","TRIANA","ESPA�A","TOTAL POBLACION",495,508,1003
" 06","TRIANA","ESTADOS UNIDOS DE AMERICA","EXTRANJEROS",3,7,10
" 06","TRIANA","ESTADOS UNIDOS DE AMERICA","TOTAL POBLACION",3,7,10
" 06","TRIANA","FRANCIA","ESPA�OLES",2,0,2
" 06","TRIANA","FRANCIA","EXTRANJEROS",2,5,7
" 06","TRIANA","FRANCIA","TOTAL POBLACION",4,5,9
" 06","TRIANA","GRANADA","ESPA�OLES",1,0,1
" 06","TRIANA","GRANADA","TOTAL POBLACION",1,0,1
" 06","TRIANA","GRECIA","ESPA�OLES",0,1,1
" 06","TRIANA","GRECIA","EXTRANJEROS",2,0,2
" 06","TRIANA","GRECIA","TOTAL POBLACION",2,1,3
" 06","TRIANA","GUATEMALA","EXTRANJEROS",1,3,4
" 06","TRIANA","GUATEMALA","TOTAL POBLACION",1,3,4
" 06","TRIANA","HONDURAS","EXTRANJEROS",0,3,3
" 06","TRIANA","HONDURAS","TOTAL POBLACION",0,3,3
" 06","TRIANA","INDIA","EXTRANJEROS",1,1,2
" 06","TRIANA","INDIA","TOTAL POBLACION",1,1,2
" 06","TRIANA","INDONESIA","ESPA�OLES",0,1,1
" 06","TRIANA","INDONESIA","TOTAL POBLACION",0,1,1
" 06","TRIANA","ISRAEL","EXTRANJEROS",3,1,4
" 06","TRIANA","ISRAEL","TOTAL POBLACION",3,1,4
" 06","TRIANA","ITALIA","ESPA�OLES",0,1,1
" 06","TRIANA","ITALIA","EXTRANJEROS",6,13,19
" 06","TRIANA","ITALIA","TOTAL POBLACION",6,14,20
" 06","TRIANA","JAPON","EXTRANJEROS",0,2,2
" 06","TRIANA","JAPON","TOTAL POBLACION",0,2,2
" 06","TRIANA","MALI","ESPA�OLES",0,1,1
" 06","TRIANA","MALI","EXTRANJEROS",1,0,1
" 06","TRIANA","MALI","TOTAL POBLACION",1,1,2
" 06","TRIANA","MARRUECOS","ESPA�OLES",0,2,2
" 06","TRIANA","MARRUECOS","EXTRANJEROS",7,6,13
" 06","TRIANA","MARRUECOS","TOTAL POBLACION",7,8,15
" 06","TRIANA","MEXICO","EXTRANJEROS",1,1,2
" 06","TRIANA","MEXICO","TOTAL POBLACION",1,1,2
" 06","TRIANA","MOLDAVIA","EXTRANJEROS",1,2,3
" 06","TRIANA","MOLDAVIA","TOTAL POBLACION",1,2,3
" 06","TRIANA","NICARAGUA","EXTRANJEROS",1,11,12
" 06","TRIANA","NICARAGUA","TOTAL POBLACION",1,11,12
" 06","TRIANA","NORUEGA","EXTRANJEROS",0,1,1
" 06","TRIANA","NORUEGA","TOTAL POBLACION",0,1,1
" 06","TRIANA","PAKISTAN","EXTRANJEROS",2,0,2
" 06","TRIANA","PAKISTAN","TOTAL POBLACION",2,0,2
" 06","TRIANA","PARAGUAY","ESPA�OLES",2,1,3
" 06","TRIANA","PARAGUAY","EXTRANJEROS",3,7,10
" 06","TRIANA","PARAGUAY","TOTAL POBLACION",5,8,13
" 06","TRIANA","PERU","ESPA�OLES",1,0,1
" 06","TRIANA","PERU","EXTRANJEROS",5,3,8
" 06","TRIANA","PERU","TOTAL POBLACION",6,3,9
" 06","TRIANA","POLONIA","EXTRANJEROS",0,3,3
" 06","TRIANA","POLONIA","TOTAL POBLACION",0,3,3
" 06","TRIANA","PORTUGAL","ESPA�OLES",0,1,1
" 06","TRIANA","PORTUGAL","EXTRANJEROS",3,4,7
" 06","TRIANA","PORTUGAL","TOTAL POBLACION",3,5,8
" 06","TRIANA","REINO UNIDO","ESPA�OLES",0,1,1
" 06","TRIANA","REINO UNIDO","EXTRANJEROS",10,3,13
" 06","TRIANA","REINO UNIDO","TOTAL POBLACION",10,4,14
" 06","TRIANA","REPUBLICA DE COREA","ESPA�OLES",0,1,1
" 06","TRIANA","REPUBLICA DE COREA","TOTAL POBLACION",0,1,1
" 06","TRIANA","REPUBLICA DOMINICANA","ESPA�OLES",0,1,1
" 06","TRIANA","REPUBLICA DOMINICANA","EXTRANJEROS",4,3,7
" 06","TRIANA","REPUBLICA DOMINICANA","TOTAL POBLACION",4,4,8
" 06","TRIANA","RUMANIA","EXTRANJEROS",4,11,15
" 06","TRIANA","RUMANIA","TOTAL POBLACION",4,11,15
" 06","TRIANA","RUSIA","EXTRANJEROS",1,5,6
" 06","TRIANA","RUSIA","TOTAL POBLACION",1,5,6
" 06","TRIANA","SENEGAL","EXTRANJEROS",0,1,1
" 06","TRIANA","SENEGAL","TOTAL POBLACION",0,1,1
" 06","TRIANA","SERBIA","EXTRANJEROS",0,2,2
" 06","TRIANA","SERBIA","TOTAL POBLACION",0,2,2
" 06","TRIANA","SIRIA","EXTRANJEROS",0,1,1
" 06","TRIANA","SIRIA","TOTAL POBLACION",0,1,1
" 06","TRIANA","SUIZA","ESPA�OLES",1,2,3
" 06","TRIANA","SUIZA","EXTRANJEROS",1,1,2
" 06","TRIANA","SUIZA","TOTAL POBLACION",2,3,5
" 06","TRIANA","TCHAD","EXTRANJEROS",1,0,1
" 06","TRIANA","TCHAD","TOTAL POBLACION",1,0,1
" 06","TRIANA","UCRANIA","EXTRANJEROS",0,7,7
" 06","TRIANA","UCRANIA","TOTAL POBLACION",0,7,7
" 06","TRIANA","VENEZUELA","ESPA�OLES",3,2,5
" 06","TRIANA","VENEZUELA","EXTRANJEROS",2,2,4
" 06","TRIANA","VENEZUELA","TOTAL POBLACION",5,4,9
" 07","NORTE","- TODOS -","ESPA�OLES",464,463,927
" 07","NORTE","- TODOS -","EXTRANJEROS",197,161,358
" 07","NORTE","- TODOS -","TOTAL POBLACION",661,624,1285
" 07","NORTE","ALEMANIA","ESPA�OLES",0,1,1
" 07","NORTE","ALEMANIA","EXTRANJEROS",2,0,2
" 07","NORTE","ALEMANIA","TOTAL POBLACION",2,1,3
" 07","NORTE","ARGELIA","EXTRANJEROS",2,1,3
" 07","NORTE","ARGELIA","TOTAL POBLACION",2,1,3
" 07","NORTE","ARGENTINA","ESPA�OLES",1,0,1
" 07","NORTE","ARGENTINA","EXTRANJEROS",0,2,2
" 07","NORTE","ARGENTINA","TOTAL POBLACION",1,2,3
" 07","NORTE","ARMENIA","EXTRANJEROS",2,2,4
" 07","NORTE","ARMENIA","TOTAL POBLACION",2,2,4
" 07","NORTE","BELGICA","EXTRANJEROS",0,1,1
" 07","NORTE","BELGICA","TOTAL POBLACION",0,1,1
" 07","NORTE","BIELORUSIA","EXTRANJEROS",0,1,1
" 07","NORTE","BIELORUSIA","TOTAL POBLACION",0,1,1
" 07","NORTE","BOLIVIA","ESPA�OLES",3,1,4
" 07","NORTE","BOLIVIA","EXTRANJEROS",4,3,7
" 07","NORTE","BOLIVIA","TOTAL POBLACION",7,4,11
" 07","NORTE","BRASIL","EXTRANJEROS",0,2,2
" 07","NORTE","BRASIL","TOTAL POBLACION",0,2,2
" 07","NORTE","CAMERUN","EXTRANJEROS",1,0,1
" 07","NORTE","CAMERUN","TOTAL POBLACION",1,0,1
" 07","NORTE","CANADA","EXTRANJEROS",0,1,1
" 07","NORTE","CANADA","TOTAL POBLACION",0,1,1
" 07","NORTE","CHILE","EXTRANJEROS",0,3,3
" 07","NORTE","CHILE","TOTAL POBLACION",0,3,3
" 07","NORTE","CHINA","ESPA�OLES",2,1,3
" 07","NORTE","CHINA","EXTRANJEROS",3,5,8
" 07","NORTE","CHINA","TOTAL POBLACION",5,6,11
" 07","NORTE","COLOMBIA","EXTRANJEROS",1,2,3
" 07","NORTE","COLOMBIA","TOTAL POBLACION",1,2,3
" 07","NORTE","CONGO","EXTRANJEROS",1,1,2
" 07","NORTE","CONGO","TOTAL POBLACION",1,1,2
" 07","NORTE","COSTA RICA","EXTRANJEROS",0,1,1
" 07","NORTE","COSTA RICA","TOTAL POBLACION",0,1,1
" 07","NORTE","CUBA","ESPA�OLES",0,2,2
" 07","NORTE","CUBA","EXTRANJEROS",3,3,6
" 07","NORTE","CUBA","TOTAL POBLACION",3,5,8
" 07","NORTE","DINAMARCA","EXTRANJEROS",0,1,1
" 07","NORTE","DINAMARCA","TOTAL POBLACION",0,1,1
" 07","NORTE","ECUADOR","ESPA�OLES",0,3,3
" 07","NORTE","ECUADOR","EXTRANJEROS",2,0,2
" 07","NORTE","ECUADOR","TOTAL POBLACION",2,3,5
" 07","NORTE","EL SALVADOR","EXTRANJEROS",0,1,1
" 07","NORTE","EL SALVADOR","TOTAL POBLACION",0,1,1
" 07","NORTE","EMIRATOS ARABES UNIDOS","ESPA�OLES",2,0,2
" 07","NORTE","EMIRATOS ARABES UNIDOS","TOTAL POBLACION",2,0,2
" 07","NORTE","ESPA�A","ESPA�OLES",451,450,901
" 07","NORTE","ESPA�A","EXTRANJEROS",87,76,163
" 07","NORTE","ESPA�A","TOTAL POBLACION",538,526,1064
" 07","NORTE","ESTADOS UNIDOS DE AMERICA","ESPA�OLES",1,2,3
" 07","NORTE","ESTADOS UNIDOS DE AMERICA","TOTAL POBLACION",1,2,3
" 07","NORTE","FRANCIA","ESPA�OLES",1,1,2
" 07","NORTE","FRANCIA","TOTAL POBLACION",1,1,2
" 07","NORTE","GAMBIA","EXTRANJEROS",1,0,1
" 07","NORTE","GAMBIA","TOTAL POBLACION",1,0,1
" 07","NORTE","GRECIA","ESPA�OLES",0,1,1
" 07","NORTE","GRECIA","TOTAL POBLACION",0,1,1
" 07","NORTE","GUATEMALA","EXTRANJEROS",0,1,1
" 07","NORTE","GUATEMALA","TOTAL POBLACION",0,1,1
" 07","NORTE","GUINEA","EXTRANJEROS",3,0,3
" 07","NORTE","GUINEA","TOTAL POBLACION",3,0,3
" 07","NORTE","GUINEA ECUATORIAL","EXTRANJEROS",0,1,1
" 07","NORTE","GUINEA ECUATORIAL","TOTAL POBLACION",0,1,1
" 07","NORTE","IRLANDA","ESPA�OLES",0,1,1
" 07","NORTE","IRLANDA","TOTAL POBLACION",0,1,1
" 07","NORTE","ITALIA","EXTRANJEROS",4,1,5
" 07","NORTE","ITALIA","TOTAL POBLACION",4,1,5
" 07","NORTE","KAZAJSTAN","EXTRANJEROS",0,1,1
" 07","NORTE","KAZAJSTAN","TOTAL POBLACION",0,1,1
" 07","NORTE","MACEDONIA","EXTRANJEROS",1,0,1
" 07","NORTE","MACEDONIA","TOTAL POBLACION",1,0,1
" 07","NORTE","MALI","EXTRANJEROS",3,0,3
" 07","NORTE","MALI","TOTAL POBLACION",3,0,3
" 07","NORTE","MARRUECOS","EXTRANJEROS",20,5,25
" 07","NORTE","MARRUECOS","TOTAL POBLACION",20,5,25
" 07","NORTE","MEXICO","EXTRANJEROS",0,1,1
" 07","NORTE","MEXICO","TOTAL POBLACION",0,1,1
" 07","NORTE","MONTENEGRO","EXTRANJEROS",1,1,2
" 07","NORTE","MONTENEGRO","TOTAL POBLACION",1,1,2
" 07","NORTE","NICARAGUA","EXTRANJEROS",1,3,4
" 07","NORTE","NICARAGUA","TOTAL POBLACION",1,3,4
" 07","NORTE","NIGERIA","EXTRANJEROS",4,4,8
" 07","NORTE","NIGERIA","TOTAL POBLACION",4,4,8
" 07","NORTE","OTROS PAISES SIN RELACION DIPLOMATICA","EXTRANJEROS",1,0,1
" 07","NORTE","OTROS PAISES SIN RELACION DIPLOMATICA","TOTAL POBLACION",1,0,1
" 07","NORTE","PAKISTAN","EXTRANJEROS",1,0,1
" 07","NORTE","PAKISTAN","TOTAL POBLACION",1,0,1
" 07","NORTE","PARAGUAY","EXTRANJEROS",2,3,5
" 07","NORTE","PARAGUAY","TOTAL POBLACION",2,3,5
" 07","NORTE","PERU","EXTRANJEROS",1,1,2
" 07","NORTE","PERU","TOTAL POBLACION",1,1,2
" 07","NORTE","POLONIA","EXTRANJEROS",1,0,1
" 07","NORTE","POLONIA","TOTAL POBLACION",1,0,1
" 07","NORTE","PORTUGAL","EXTRANJEROS",2,4,6
" 07","NORTE","PORTUGAL","TOTAL POBLACION",2,4,6
" 07","NORTE","REINO UNIDO","EXTRANJEROS",1,1,2
" 07","NORTE","REINO UNIDO","TOTAL POBLACION",1,1,2
" 07","NORTE","REPUBLICA DEMOCRATICA DEL CONGO","EXTRANJEROS",1,0,1
" 07","NORTE","REPUBLICA DEMOCRATICA DEL CONGO","TOTAL POBLACION",1,0,1
" 07","NORTE","REPUBLICA DOMINICANA","EXTRANJEROS",2,1,3
" 07","NORTE","REPUBLICA DOMINICANA","TOTAL POBLACION",2,1,3
" 07","NORTE","RUMANIA","EXTRANJEROS",22,16,38
" 07","NORTE","RUMANIA","TOTAL POBLACION",22,16,38
" 07","NORTE","RUSIA","EXTRANJEROS",3,3,6
" 07","NORTE","RUSIA","TOTAL POBLACION",3,3,6
" 07","NORTE","SENEGAL","EXTRANJEROS",12,4,16
" 07","NORTE","SENEGAL","TOTAL POBLACION",12,4,16
" 07","NORTE","SUECIA","EXTRANJEROS",0,1,1
" 07","NORTE","SUECIA","TOTAL POBLACION",0,1,1
" 07","NORTE","UCRANIA","EXTRANJEROS",1,0,1
" 07","NORTE","UCRANIA","TOTAL POBLACION",1,0,1
" 07","NORTE","VENEZUELA","ESPA�OLES",3,0,3
" 07","NORTE","VENEZUELA","EXTRANJEROS",1,3,4
" 07","NORTE","VENEZUELA","TOTAL POBLACION",4,3,7
" 08","S. PABLO-STA. JUSTA","- TODOS -","ESPA�OLES",459,437,896
" 08","S. PABLO-STA. JUSTA","- TODOS -","EXTRANJEROS",125,187,312
" 08","S. PABLO-STA. JUSTA","- TODOS -","TOTAL POBLACION",584,624,1208
" 08","S. PABLO-STA. JUSTA","ALEMANIA","ESPA�OLES",1,0,1
" 08","S. PABLO-STA. JUSTA","ALEMANIA","EXTRANJEROS",1,2,3
" 08","S. PABLO-STA. JUSTA","ALEMANIA","TOTAL POBLACION",2,2,4
" 08","S. PABLO-STA. JUSTA","ARMENIA","EXTRANJEROS",1,0,1
" 08","S. PABLO-STA. JUSTA","ARMENIA","TOTAL POBLACION",1,0,1
" 08","S. PABLO-STA. JUSTA","BOLIVIA","EXTRANJEROS",4,4,8
" 08","S. PABLO-STA. JUSTA","BOLIVIA","TOTAL POBLACION",4,4,8
" 08","S. PABLO-STA. JUSTA","BRASIL","EXTRANJEROS",2,4,6
" 08","S. PABLO-STA. JUSTA","BRASIL","TOTAL POBLACION",2,4,6
" 08","S. PABLO-STA. JUSTA","BULGARIA","EXTRANJEROS",0,1,1
" 08","S. PABLO-STA. JUSTA","BULGARIA","TOTAL POBLACION",0,1,1
" 08","S. PABLO-STA. JUSTA","CAMERUN","EXTRANJEROS",1,0,1
" 08","S. PABLO-STA. JUSTA","CAMERUN","TOTAL POBLACION",1,0,1
" 08","S. PABLO-STA. JUSTA","CHILE","EXTRANJEROS",0,2,2
" 08","S. PABLO-STA. JUSTA","CHILE","TOTAL POBLACION",0,2,2
" 08","S. PABLO-STA. JUSTA","CHINA","EXTRANJEROS",4,6,10
" 08","S. PABLO-STA. JUSTA","CHINA","TOTAL POBLACION",4,6,10
" 08","S. PABLO-STA. JUSTA","COLOMBIA","EXTRANJEROS",5,6,11
" 08","S. PABLO-STA. JUSTA","COLOMBIA","TOTAL POBLACION",5,6,11
" 08","S. PABLO-STA. JUSTA","CUBA","EXTRANJEROS",1,3,4
" 08","S. PABLO-STA. JUSTA","CUBA","TOTAL POBLACION",1,3,4
" 08","S. PABLO-STA. JUSTA","ECUADOR","ESPA�OLES",1,3,4
" 08","S. PABLO-STA. JUSTA","ECUADOR","EXTRANJEROS",3,3,6
" 08","S. PABLO-STA. JUSTA","ECUADOR","TOTAL POBLACION",4,6,10
" 08","S. PABLO-STA. JUSTA","EL SALVADOR","EXTRANJEROS",0,3,3
" 08","S. PABLO-STA. JUSTA","EL SALVADOR","TOTAL POBLACION",0,3,3
" 08","S. PABLO-STA. JUSTA","ESPA�A","ESPA�OLES",449,427,876
" 08","S. PABLO-STA. JUSTA","ESPA�A","EXTRANJEROS",67,91,158
" 08","S. PABLO-STA. JUSTA","ESPA�A","TOTAL POBLACION",516,518,1034
" 08","S. PABLO-STA. JUSTA","ESTADOS UNIDOS DE AMERICA","ESPA�OLES",1,1,2
" 08","S. PABLO-STA. JUSTA","ESTADOS UNIDOS DE AMERICA","TOTAL POBLACION",1,1,2
" 08","S. PABLO-STA. JUSTA","ETIOPIA","ESPA�OLES",1,0,1
" 08","S. PABLO-STA. JUSTA","ETIOPIA","TOTAL POBLACION",1,0,1
" 08","S. PABLO-STA. JUSTA","FRANCIA","ESPA�OLES",0,1,1
" 08","S. PABLO-STA. JUSTA","FRANCIA","EXTRANJEROS",5,4,9
" 08","S. PABLO-STA. JUSTA","FRANCIA","TOTAL POBLACION",5,5,10
" 08","S. PABLO-STA. JUSTA","GUATEMALA","EXTRANJEROS",0,1,1
" 08","S. PABLO-STA. JUSTA","GUATEMALA","TOTAL POBLACION",0,1,1
" 08","S. PABLO-STA. JUSTA","GUINEA","EXTRANJEROS",1,0,1
" 08","S. PABLO-STA. JUSTA","GUINEA","TOTAL POBLACION",1,0,1
" 08","S. PABLO-STA. JUSTA","HUNGRIA","EXTRANJEROS",0,1,1
" 08","S. PABLO-STA. JUSTA","HUNGRIA","TOTAL POBLACION",0,1,1
" 08","S. PABLO-STA. JUSTA","ITALIA","EXTRANJEROS",2,2,4
" 08","S. PABLO-STA. JUSTA","ITALIA","TOTAL POBLACION",2,2,4
" 08","S. PABLO-STA. JUSTA","JAPON","EXTRANJEROS",1,0,1
" 08","S. PABLO-STA. JUSTA","JAPON","TOTAL POBLACION",1,0,1
" 08","S. PABLO-STA. JUSTA","LETONIA","EXTRANJEROS",1,0,1
" 08","S. PABLO-STA. JUSTA","LETONIA","TOTAL POBLACION",1,0,1
" 08","S. PABLO-STA. JUSTA","MARRUECOS","EXTRANJEROS",7,3,10
" 08","S. PABLO-STA. JUSTA","MARRUECOS","TOTAL POBLACION",7,3,10
" 08","S. PABLO-STA. JUSTA","MEXICO","EXTRANJEROS",1,5,6
" 08","S. PABLO-STA. JUSTA","MEXICO","TOTAL POBLACION",1,5,6
" 08","S. PABLO-STA. JUSTA","NAMIBIA","ESPA�OLES",1,0,1
" 08","S. PABLO-STA. JUSTA","NAMIBIA","TOTAL POBLACION",1,0,1
" 08","S. PABLO-STA. JUSTA","NICARAGUA","EXTRANJEROS",1,18,19
" 08","S. PABLO-STA. JUSTA","NICARAGUA","TOTAL POBLACION",1,18,19
" 08","S. PABLO-STA. JUSTA","PAKISTAN","EXTRANJEROS",1,0,1
" 08","S. PABLO-STA. JUSTA","PAKISTAN","TOTAL POBLACION",1,0,1
" 08","S. PABLO-STA. JUSTA","PARAGUAY","ESPA�OLES",0,1,1
" 08","S. PABLO-STA. JUSTA","PARAGUAY","EXTRANJEROS",1,7,8
" 08","S. PABLO-STA. JUSTA","PARAGUAY","TOTAL POBLACION",1,8,9
" 08","S. PABLO-STA. JUSTA","PERU","EXTRANJEROS",3,3,6
" 08","S. PABLO-STA. JUSTA","PERU","TOTAL POBLACION",3,3,6
" 08","S. PABLO-STA. JUSTA","POLONIA","EXTRANJEROS",0,3,3
" 08","S. PABLO-STA. JUSTA","POLONIA","TOTAL POBLACION",0,3,3
" 08","S. PABLO-STA. JUSTA","PORTUGAL","EXTRANJEROS",3,1,4
" 08","S. PABLO-STA. JUSTA","PORTUGAL","TOTAL POBLACION",3,1,4
" 08","S. PABLO-STA. JUSTA","REINO UNIDO","ESPA�OLES",0,2,2
" 08","S. PABLO-STA. JUSTA","REINO UNIDO","EXTRANJEROS",3,1,4
" 08","S. PABLO-STA. JUSTA","REINO UNIDO","TOTAL POBLACION",3,3,6
" 08","S. PABLO-STA. JUSTA","REPUBLICA DOMINICANA","EXTRANJEROS",2,4,6
" 08","S. PABLO-STA. JUSTA","REPUBLICA DOMINICANA","TOTAL POBLACION",2,4,6
" 08","S. PABLO-STA. JUSTA","REPUBLICA SUDAFRICANA","ESPA�OLES",1,2,3
" 08","S. PABLO-STA. JUSTA","REPUBLICA SUDAFRICANA","TOTAL POBLACION",1,2,3
" 08","S. PABLO-STA. JUSTA","RUMANIA","EXTRANJEROS",1,1,2
" 08","S. PABLO-STA. JUSTA","RUMANIA","TOTAL POBLACION",1,1,2
" 08","S. PABLO-STA. JUSTA","RUSIA","ESPA�OLES",1,0,1
" 08","S. PABLO-STA. JUSTA","RUSIA","EXTRANJEROS",1,3,4
" 08","S. PABLO-STA. JUSTA","RUSIA","TOTAL POBLACION",2,3,5
" 08","S. PABLO-STA. JUSTA","SUIZA","ESPA�OLES",1,0,1
" 08","S. PABLO-STA. JUSTA","SUIZA","TOTAL POBLACION",1,0,1
" 08","S. PABLO-STA. JUSTA","UCRANIA","ESPA�OLES",2,0,2
" 08","S. PABLO-STA. JUSTA","UCRANIA","EXTRANJEROS",0,1,1
" 08","S. PABLO-STA. JUSTA","UCRANIA","TOTAL POBLACION",2,1,3
" 08","S. PABLO-STA. JUSTA","UZBEKISTAN","EXTRANJEROS",0,1,1
" 08","S. PABLO-STA. JUSTA","UZBEKISTAN","TOTAL POBLACION",0,1,1
" 08","S. PABLO-STA. JUSTA","VENEZUELA","EXTRANJEROS",1,3,4
" 08","S. PABLO-STA. JUSTA","VENEZUELA","TOTAL POBLACION",1,3,4
" 08","S. PABLO-STA. JUSTA","YEMEN","EXTRANJEROS",1,0,1
" 08","S. PABLO-STA. JUSTA","YEMEN","TOTAL POBLACION",1,0,1
" 09","ESTE","- TODOS -","ESPA�OLES",737,702,1439
" 09","ESTE","- TODOS -","EXTRANJEROS",356,251,607
" 09","ESTE","- TODOS -","TOTAL POBLACION",1093,953,2046
" 09","ESTE","ALEMANIA","ESPA�OLES",1,0,1
" 09","ESTE","ALEMANIA","EXTRANJEROS",1,2,3
" 09","ESTE","ALEMANIA","TOTAL POBLACION",2,2,4
" 09","ESTE","ANGOLA","EXTRANJEROS",0,1,1
" 09","ESTE","ANGOLA","TOTAL POBLACION",0,1,1
" 09","ESTE","ARGELIA","ESPA�OLES",2,1,3
" 09","ESTE","ARGELIA","EXTRANJEROS",11,5,16
" 09","ESTE","ARGELIA","TOTAL POBLACION",13,6,19
" 09","ESTE","ARGENTINA","EXTRANJEROS",1,1,2
" 09","ESTE","ARGENTINA","TOTAL POBLACION",1,1,2
" 09","ESTE","BELGICA","ESPA�OLES",2,1,3
" 09","ESTE","BELGICA","EXTRANJEROS",1,0,1
" 09","ESTE","BELGICA","TOTAL POBLACION",3,1,4
" 09","ESTE","BIELORUSIA","EXTRANJEROS",1,1,2
" 09","ESTE","BIELORUSIA","TOTAL POBLACION",1,1,2
" 09","ESTE","BOLIVIA","EXTRANJEROS",0,2,2
" 09","ESTE","BOLIVIA","TOTAL POBLACION",0,2,2
" 09","ESTE","BRASIL","EXTRANJEROS",5,4,9
" 09","ESTE","BRASIL","TOTAL POBLACION",5,4,9
" 09","ESTE","BURKINA FASSO","EXTRANJEROS",1,0,1
" 09","ESTE","BURKINA FASSO","TOTAL POBLACION",1,0,1
" 09","ESTE","CAMERUN","EXTRANJEROS",15,1,16
" 09","ESTE","CAMERUN","TOTAL POBLACION",15,1,16
" 09","ESTE","CHILE","ESPA�OLES",1,0,1
" 09","ESTE","CHILE","TOTAL POBLACION",1,0,1
" 09","ESTE","CHINA","ESPA�OLES",1,1,2
" 09","ESTE","CHINA","EXTRANJEROS",13,5,18
" 09","ESTE","CHINA","TOTAL POBLACION",14,6,20
" 09","ESTE","COLOMBIA","EXTRANJEROS",6,13,19
" 09","ESTE","COLOMBIA","TOTAL POBLACION",6,13,19
" 09","ESTE","COSTA DE MARFIL","EXTRANJEROS",15,0,15
" 09","ESTE","COSTA DE MARFIL","TOTAL POBLACION",15,0,15
" 09","ESTE","CUBA","ESPA�OLES",1,1,2
" 09","ESTE","CUBA","EXTRANJEROS",1,1,2
" 09","ESTE","CUBA","TOTAL POBLACION",2,2,4
" 09","ESTE","ECUADOR","EXTRANJEROS",1,4,5
" 09","ESTE","ECUADOR","TOTAL POBLACION",1,4,5
" 09","ESTE","EGIPTO","EXTRANJEROS",0,1,1
" 09","ESTE","EGIPTO","TOTAL POBLACION",0,1,1
" 09","ESTE","EL SALVADOR","EXTRANJEROS",1,1,2
" 09","ESTE","EL SALVADOR","TOTAL POBLACION",1,1,2
" 09","ESTE","ERITREA","EXTRANJEROS",2,0,2
" 09","ESTE","ERITREA","TOTAL POBLACION",2,0,2
" 09","ESTE","ESPA�A","ESPA�OLES",721,691,1412
" 09","ESTE","ESPA�A","EXTRANJEROS",150,135,285
" 09","ESTE","ESPA�A","TOTAL POBLACION",871,826,1697
" 09","ESTE","ESTADOS UNIDOS DE AMERICA","ESPA�OLES",1,1,2
" 09","ESTE","ESTADOS UNIDOS DE AMERICA","EXTRANJEROS",1,1,2
" 09","ESTE","ESTADOS UNIDOS DE AMERICA","TOTAL POBLACION",2,2,4
" 09","ESTE","ETIOPIA","EXTRANJEROS",3,3,6
" 09","ESTE","ETIOPIA","TOTAL POBLACION",3,3,6
" 09","ESTE","FRANCIA","EXTRANJEROS",3,2,5
" 09","ESTE","FRANCIA","TOTAL POBLACION",3,2,5
" 09","ESTE","GAMBIA","EXTRANJEROS",4,0,4
" 09","ESTE","GAMBIA","TOTAL POBLACION",4,0,4
" 09","ESTE","GHANA","EXTRANJEROS",4,0,4
" 09","ESTE","GHANA","TOTAL POBLACION",4,0,4
" 09","ESTE","GRECIA","EXTRANJEROS",1,1,2
" 09","ESTE","GRECIA","TOTAL POBLACION",1,1,2
" 09","ESTE","GUATEMALA","EXTRANJEROS",1,2,3
" 09","ESTE","GUATEMALA","TOTAL POBLACION",1,2,3
" 09","ESTE","GUINEA","EXTRANJEROS",6,0,6
" 09","ESTE","GUINEA","TOTAL POBLACION",6,0,6
" 09","ESTE","GUINEA BISSAU","EXTRANJEROS",1,0,1
" 09","ESTE","GUINEA BISSAU","TOTAL POBLACION",1,0,1
" 09","ESTE","GUINEA ECUATORIAL","EXTRANJEROS",2,0,2
" 09","ESTE","GUINEA ECUATORIAL","TOTAL POBLACION",2,0,2
" 09","ESTE","HONDURAS","EXTRANJEROS",2,1,3
" 09","ESTE","HONDURAS","TOTAL POBLACION",2,1,3
" 09","ESTE","HUNGRIA","EXTRANJEROS",1,0,1
" 09","ESTE","HUNGRIA","TOTAL POBLACION",1,0,1
" 09","ESTE","INDONESIA","EXTRANJEROS",0,1,1
" 09","ESTE","INDONESIA","TOTAL POBLACION",0,1,1
" 09","ESTE","IRAK","EXTRANJEROS",4,3,7
" 09","ESTE","IRAK","TOTAL POBLACION",4,3,7
" 09","ESTE","IRAN","EXTRANJEROS",3,1,4
" 09","ESTE","IRAN","TOTAL POBLACION",3,1,4
" 09","ESTE","ITALIA","ESPA�OLES",0,1,1
" 09","ESTE","ITALIA","EXTRANJEROS",5,5,10
" 09","ESTE","ITALIA","TOTAL POBLACION",5,6,11
" 09","ESTE","JAMAICA","EXTRANJEROS",1,0,1
" 09","ESTE","JAMAICA","TOTAL POBLACION",1,0,1
" 09","ESTE","JORDANIA","EXTRANJEROS",0,1,1
" 09","ESTE","JORDANIA","TOTAL POBLACION",0,1,1
" 09","ESTE","KAZAJSTAN","EXTRANJEROS",1,0,1
" 09","ESTE","KAZAJSTAN","TOTAL POBLACION",1,0,1
" 09","ESTE","LIBIA","EXTRANJEROS",2,1,3
" 09","ESTE","LIBIA","TOTAL POBLACION",2,1,3
" 09","ESTE","MALAWI","EXTRANJEROS",1,0,1
" 09","ESTE","MALAWI","TOTAL POBLACION",1,0,1
" 09","ESTE","MALI","EXTRANJEROS",3,0,3
" 09","ESTE","MALI","TOTAL POBLACION",3,0,3
" 09","ESTE","MARRUECOS","ESPA�OLES",1,0,1
" 09","ESTE","MARRUECOS","EXTRANJEROS",8,12,20
" 09","ESTE","MARRUECOS","TOTAL POBLACION",9,12,21
" 09","ESTE","MEXICO","ESPA�OLES",0,2,2
" 09","ESTE","MEXICO","EXTRANJEROS",0,1,1
" 09","ESTE","MEXICO","TOTAL POBLACION",0,3,3
" 09","ESTE","MOLDAVIA","EXTRANJEROS",0,1,1
" 09","ESTE","MOLDAVIA","TOTAL POBLACION",0,1,1
" 09","ESTE","NEPAL","EXTRANJEROS",1,0,1
" 09","ESTE","NEPAL","TOTAL POBLACION",1,0,1
" 09","ESTE","NICARAGUA","EXTRANJEROS",2,3,5
" 09","ESTE","NICARAGUA","TOTAL POBLACION",2,3,5
" 09","ESTE","NIGER","EXTRANJEROS",2,0,2
" 09","ESTE","NIGER","TOTAL POBLACION",2,0,2
" 09","ESTE","NIGERIA","EXTRANJEROS",10,2,12
" 09","ESTE","NIGERIA","TOTAL POBLACION",10,2,12
" 09","ESTE","OTROS AFRICA SIN RELACION DIPL","EXTRANJEROS",1,0,1
" 09","ESTE","OTROS AFRICA SIN RELACION DIPL","TOTAL POBLACION",1,0,1
" 09","ESTE","OTROS PAISES SIN RELACION DIPLOMATICA","EXTRANJEROS",10,0,10
" 09","ESTE","OTROS PAISES SIN RELACION DIPLOMATICA","TOTAL POBLACION",10,0,10
" 09","ESTE","PAISES BAJOS","ESPA�OLES",0,1,1
" 09","ESTE","PAISES BAJOS","EXTRANJEROS",0,1,1
" 09","ESTE","PAISES BAJOS","TOTAL POBLACION",0,2,2
" 09","ESTE","PAKISTAN","EXTRANJEROS",3,0,3
" 09","ESTE","PAKISTAN","TOTAL POBLACION",3,0,3
" 09","ESTE","PARAGUAY","EXTRANJEROS",1,4,5
" 09","ESTE","PARAGUAY","TOTAL POBLACION",1,4,5
" 09","ESTE","PERU","EXTRANJEROS",1,3,4
" 09","ESTE","PERU","TOTAL POBLACION",1,3,4
" 09","ESTE","POLONIA","EXTRANJEROS",0,2,2
" 09","ESTE","POLONIA","TOTAL POBLACION",0,2,2
" 09","ESTE","PORTUGAL","EXTRANJEROS",3,4,7
" 09","ESTE","PORTUGAL","TOTAL POBLACION",3,4,7
" 09","ESTE","REINO UNIDO","ESPA�OLES",2,2,4
" 09","ESTE","REINO UNIDO","EXTRANJEROS",3,3,6
" 09","ESTE","REINO UNIDO","TOTAL POBLACION",5,5,10
" 09","ESTE","REPUBLICA CENTROAFRICANA","EXTRANJEROS",1,0,1
" 09","ESTE","REPUBLICA CENTROAFRICANA","TOTAL POBLACION",1,0,1
" 09","ESTE","REPUBLICA DEMOCRATICA DEL CONGO","EXTRANJEROS",1,0,1
" 09","ESTE","REPUBLICA DEMOCRATICA DEL CONGO","TOTAL POBLACION",1,0,1
" 09","ESTE","REPUBLICA DOMINICANA","ESPA�OLES",1,0,1
" 09","ESTE","REPUBLICA DOMINICANA","EXTRANJEROS",7,4,11
" 09","ESTE","REPUBLICA DOMINICANA","TOTAL POBLACION",8,4,12
" 09","ESTE","RUMANIA","EXTRANJEROS",5,3,8
" 09","ESTE","RUMANIA","TOTAL POBLACION",5,3,8
" 09","ESTE","RUSIA","ESPA�OLES",2,0,2
" 09","ESTE","RUSIA","EXTRANJEROS",2,2,4
" 09","ESTE","RUSIA","TOTAL POBLACION",4,2,6
" 09","ESTE","SENEGAL","EXTRANJEROS",5,0,5
" 09","ESTE","SENEGAL","TOTAL POBLACION",5,0,5
" 09","ESTE","SIERRA LEONA","EXTRANJEROS",1,0,1
" 09","ESTE","SIERRA LEONA","TOTAL POBLACION",1,0,1
" 09","ESTE","SIRIA","EXTRANJEROS",6,0,6
" 09","ESTE","SIRIA","TOTAL POBLACION",6,0,6
" 09","ESTE","SOMALIA","EXTRANJEROS",1,0,1
" 09","ESTE","SOMALIA","TOTAL POBLACION",1,0,1
" 09","ESTE","SUIZA","ESPA�OLES",1,0,1
" 09","ESTE","SUIZA","TOTAL POBLACION",1,0,1
" 09","ESTE","TAILANDIA","EXTRANJEROS",0,1,1
" 09","ESTE","TAILANDIA","TOTAL POBLACION",0,1,1
" 09","ESTE","TCHAD","EXTRANJEROS",1,0,1
" 09","ESTE","TCHAD","TOTAL POBLACION",1,0,1
" 09","ESTE","TOGO","EXTRANJEROS",1,0,1
" 09","ESTE","TOGO","TOTAL POBLACION",1,0,1
" 09","ESTE","TUNEZ","EXTRANJEROS",1,0,1
" 09","ESTE","TUNEZ","TOTAL POBLACION",1,0,1
" 09","ESTE","UCRANIA","EXTRANJEROS",2,2,4
" 09","ESTE","UCRANIA","TOTAL POBLACION",2,2,4
" 09","ESTE","UGANDA","EXTRANJEROS",1,0,1
" 09","ESTE","UGANDA","TOTAL POBLACION",1,0,1
" 09","ESTE","VENEZUELA","EXTRANJEROS",1,4,5
" 09","ESTE","VENEZUELA","TOTAL POBLACION",1,4,5
" 09","ESTE","YEMEN","EXTRANJEROS",1,0,1
" 09","ESTE","YEMEN","TOTAL POBLACION",1,0,1
" 10","BELLAVISTA-LA PALMERA","- TODOS -","ESPA�OLES",452,478,930
" 10","BELLAVISTA-LA PALMERA","- TODOS -","EXTRANJEROS",124,173,297
" 10","BELLAVISTA-LA PALMERA","- TODOS -","TOTAL POBLACION",576,651,1227
" 10","BELLAVISTA-LA PALMERA","ALEMANIA","EXTRANJEROS",0,1,1
" 10","BELLAVISTA-LA PALMERA","ALEMANIA","TOTAL POBLACION",0,1,1
" 10","BELLAVISTA-LA PALMERA","AUSTRIA","EXTRANJEROS",0,1,1
" 10","BELLAVISTA-LA PALMERA","AUSTRIA","TOTAL POBLACION",0,1,1
" 10","BELLAVISTA-LA PALMERA","BELGICA","ESPA�OLES",3,3,6
" 10","BELLAVISTA-LA PALMERA","BELGICA","EXTRANJEROS",0,1,1
" 10","BELLAVISTA-LA PALMERA","BELGICA","TOTAL POBLACION",3,4,7
" 10","BELLAVISTA-LA PALMERA","BOLIVIA","EXTRANJEROS",2,6,8
" 10","BELLAVISTA-LA PALMERA","BOLIVIA","TOTAL POBLACION",2,6,8
" 10","BELLAVISTA-LA PALMERA","BRASIL","EXTRANJEROS",1,1,2
" 10","BELLAVISTA-LA PALMERA","BRASIL","TOTAL POBLACION",1,1,2
" 10","BELLAVISTA-LA PALMERA","BULGARIA","EXTRANJEROS",2,0,2
" 10","BELLAVISTA-LA PALMERA","BULGARIA","TOTAL POBLACION",2,0,2
" 10","BELLAVISTA-LA PALMERA","CHILE","ESPA�OLES",1,0,1
" 10","BELLAVISTA-LA PALMERA","CHILE","TOTAL POBLACION",1,0,1
" 10","BELLAVISTA-LA PALMERA","CHINA","EXTRANJEROS",1,0,1
" 10","BELLAVISTA-LA PALMERA","CHINA","TOTAL POBLACION",1,0,1
" 10","BELLAVISTA-LA PALMERA","COLOMBIA","ESPA�OLES",1,0,1
" 10","BELLAVISTA-LA PALMERA","COLOMBIA","EXTRANJEROS",4,5,9
" 10","BELLAVISTA-LA PALMERA","COLOMBIA","TOTAL POBLACION",5,5,10
" 10","BELLAVISTA-LA PALMERA","CUBA","ESPA�OLES",1,0,1
" 10","BELLAVISTA-LA PALMERA","CUBA","EXTRANJEROS",3,1,4
" 10","BELLAVISTA-LA PALMERA","CUBA","TOTAL POBLACION",4,1,5
" 10","BELLAVISTA-LA PALMERA","ECUADOR","EXTRANJEROS",3,3,6
" 10","BELLAVISTA-LA PALMERA","ECUADOR","TOTAL POBLACION",3,3,6
" 10","BELLAVISTA-LA PALMERA","EGIPTO","EXTRANJEROS",0,1,1
" 10","BELLAVISTA-LA PALMERA","EGIPTO","TOTAL POBLACION",0,1,1
" 10","BELLAVISTA-LA PALMERA","ESPA�A","ESPA�OLES",435,466,901
" 10","BELLAVISTA-LA PALMERA","ESPA�A","EXTRANJEROS",55,68,123
" 10","BELLAVISTA-LA PALMERA","ESPA�A","TOTAL POBLACION",490,534,1024
" 10","BELLAVISTA-LA PALMERA","ESTADOS UNIDOS DE AMERICA","ESPA�OLES",4,2,6
" 10","BELLAVISTA-LA PALMERA","ESTADOS UNIDOS DE AMERICA","EXTRANJEROS",2,3,5
" 10","BELLAVISTA-LA PALMERA","ESTADOS UNIDOS DE AMERICA","TOTAL POBLACION",6,5,11
" 10","BELLAVISTA-LA PALMERA","FRANCIA","ESPA�OLES",2,4,6
" 10","BELLAVISTA-LA PALMERA","FRANCIA","EXTRANJEROS",0,1,1
" 10","BELLAVISTA-LA PALMERA","FRANCIA","TOTAL POBLACION",2,5,7
" 10","BELLAVISTA-LA PALMERA","GEORGIA","EXTRANJEROS",0,1,1
" 10","BELLAVISTA-LA PALMERA","GEORGIA","TOTAL POBLACION",0,1,1
" 10","BELLAVISTA-LA PALMERA","GUATEMALA","EXTRANJEROS",0,1,1
" 10","BELLAVISTA-LA PALMERA","GUATEMALA","TOTAL POBLACION",0,1,1
" 10","BELLAVISTA-LA PALMERA","HONDURAS","EXTRANJEROS",1,1,2
" 10","BELLAVISTA-LA PALMERA","HONDURAS","TOTAL POBLACION",1,1,2
" 10","BELLAVISTA-LA PALMERA","INDIA","EXTRANJEROS",1,0,1
" 10","BELLAVISTA-LA PALMERA","INDIA","TOTAL POBLACION",1,0,1
" 10","BELLAVISTA-LA PALMERA","IRLANDA","EXTRANJEROS",0,1,1
" 10","BELLAVISTA-LA PALMERA","IRLANDA","TOTAL POBLACION",0,1,1
" 10","BELLAVISTA-LA PALMERA","ITALIA","EXTRANJEROS",1,3,4
" 10","BELLAVISTA-LA PALMERA","ITALIA","TOTAL POBLACION",1,3,4
" 10","BELLAVISTA-LA PALMERA","LETONIA","EXTRANJEROS",0,1,1
" 10","BELLAVISTA-LA PALMERA","LETONIA","TOTAL POBLACION",0,1,1
" 10","BELLAVISTA-LA PALMERA","LITUANIA","EXTRANJEROS",1,0,1
" 10","BELLAVISTA-LA PALMERA","LITUANIA","TOTAL POBLACION",1,0,1
" 10","BELLAVISTA-LA PALMERA","MARRUECOS","EXTRANJEROS",6,17,23
" 10","BELLAVISTA-LA PALMERA","MARRUECOS","TOTAL POBLACION",6,17,23
" 10","BELLAVISTA-LA PALMERA","MEXICO","ESPA�OLES",1,0,1
" 10","BELLAVISTA-LA PALMERA","MEXICO","EXTRANJEROS",5,1,6
" 10","BELLAVISTA-LA PALMERA","MEXICO","TOTAL POBLACION",6,1,7
" 10","BELLAVISTA-LA PALMERA","NICARAGUA","EXTRANJEROS",11,27,38
" 10","BELLAVISTA-LA PALMERA","NICARAGUA","TOTAL POBLACION",11,27,38
" 10","BELLAVISTA-LA PALMERA","PAISES BAJOS","EXTRANJEROS",1,0,1
" 10","BELLAVISTA-LA PALMERA","PAISES BAJOS","TOTAL POBLACION",1,0,1
" 10","BELLAVISTA-LA PALMERA","PAKISTAN","EXTRANJEROS",1,1,2
" 10","BELLAVISTA-LA PALMERA","PAKISTAN","TOTAL POBLACION",1,1,2
" 10","BELLAVISTA-LA PALMERA","PARAGUAY","EXTRANJEROS",4,2,6
" 10","BELLAVISTA-LA PALMERA","PARAGUAY","TOTAL POBLACION",4,2,6
" 10","BELLAVISTA-LA PALMERA","PERU","EXTRANJEROS",0,3,3
" 10","BELLAVISTA-LA PALMERA","PERU","TOTAL POBLACION",0,3,3
" 10","BELLAVISTA-LA PALMERA","POLONIA","EXTRANJEROS",2,1,3
" 10","BELLAVISTA-LA PALMERA","POLONIA","TOTAL POBLACION",2,1,3
" 10","BELLAVISTA-LA PALMERA","PORTUGAL","ESPA�OLES",1,1,2
" 10","BELLAVISTA-LA PALMERA","PORTUGAL","EXTRANJEROS",1,2,3
" 10","BELLAVISTA-LA PALMERA","PORTUGAL","TOTAL POBLACION",2,3,5
" 10","BELLAVISTA-LA PALMERA","REINO UNIDO","EXTRANJEROS",1,0,1
" 10","BELLAVISTA-LA PALMERA","REINO UNIDO","TOTAL POBLACION",1,0,1
" 10","BELLAVISTA-LA PALMERA","REPUBLICA CHECA","EXTRANJEROS",0,1,1
" 10","BELLAVISTA-LA PALMERA","REPUBLICA CHECA","TOTAL POBLACION",0,1,1
" 10","BELLAVISTA-LA PALMERA","REPUBLICA DOMINICANA","EXTRANJEROS",1,0,1
" 10","BELLAVISTA-LA PALMERA","REPUBLICA DOMINICANA","TOTAL POBLACION",1,0,1
" 10","BELLAVISTA-LA PALMERA","RUMANIA","EXTRANJEROS",7,10,17
" 10","BELLAVISTA-LA PALMERA","RUMANIA","TOTAL POBLACION",7,10,17
" 10","BELLAVISTA-LA PALMERA","SENEGAL","EXTRANJEROS",2,0,2
" 10","BELLAVISTA-LA PALMERA","SENEGAL","TOTAL POBLACION",2,0,2
" 10","BELLAVISTA-LA PALMERA","SUECIA","ESPA�OLES",1,0,1
" 10","BELLAVISTA-LA PALMERA","SUECIA","EXTRANJEROS",0,1,1
" 10","BELLAVISTA-LA PALMERA","SUECIA","TOTAL POBLACION",1,1,2
" 10","BELLAVISTA-LA PALMERA","UCRANIA","EXTRANJEROS",1,3,4
" 10","BELLAVISTA-LA PALMERA","UCRANIA","TOTAL POBLACION",1,3,4
" 10","BELLAVISTA-LA PALMERA","URUGUAY","ESPA�OLES",1,0,1
" 10","BELLAVISTA-LA PALMERA","URUGUAY","EXTRANJEROS",1,2,3
" 10","BELLAVISTA-LA PALMERA","URUGUAY","TOTAL POBLACION",2,2,4
" 10","BELLAVISTA-LA PALMERA","VENEZUELA","ESPA�OLES",1,2,3
" 10","BELLAVISTA-LA PALMERA","VENEZUELA","EXTRANJEROS",3,2,5
" 10","BELLAVISTA-LA PALMERA","VENEZUELA","TOTAL POBLACION",4,4,8
" 11","LOS REMEDIOS","- TODOS -","ESPA�OLES",276,264,540
" 11","LOS REMEDIOS","- TODOS -","EXTRANJEROS",41,105,146
" 11","LOS REMEDIOS","- TODOS -","TOTAL POBLACION",317,369,686
" 11","LOS REMEDIOS","ALEMANIA","ESPA�OLES",1,1,2
" 11","LOS REMEDIOS","ALEMANIA","EXTRANJEROS",1,1,2
" 11","LOS REMEDIOS","ALEMANIA","TOTAL POBLACION",2,2,4
" 11","LOS REMEDIOS","ARGELIA","EXTRANJEROS",0,1,1
" 11","LOS REMEDIOS","ARGELIA","TOTAL POBLACION",0,1,1
" 11","LOS REMEDIOS","ARGENTINA","ESPA�OLES",1,0,1
" 11","LOS REMEDIOS","ARGENTINA","EXTRANJEROS",2,1,3
" 11","LOS REMEDIOS","ARGENTINA","TOTAL POBLACION",3,1,4
" 11","LOS REMEDIOS","BOLIVIA","EXTRANJEROS",1,2,3
" 11","LOS REMEDIOS","BOLIVIA","TOTAL POBLACION",1,2,3
" 11","LOS REMEDIOS","CHINA","EXTRANJEROS",0,6,6
" 11","LOS REMEDIOS","CHINA","TOTAL POBLACION",0,6,6
" 11","LOS REMEDIOS","COLOMBIA","EXTRANJEROS",2,2,4
" 11","LOS REMEDIOS","COLOMBIA","TOTAL POBLACION",2,2,4
" 11","LOS REMEDIOS","CROACIA","ESPA�OLES",0,1,1
" 11","LOS REMEDIOS","CROACIA","TOTAL POBLACION",0,1,1
" 11","LOS REMEDIOS","CUBA","ESPA�OLES",1,1,2
" 11","LOS REMEDIOS","CUBA","EXTRANJEROS",0,2,2
" 11","LOS REMEDIOS","CUBA","TOTAL POBLACION",1,3,4
" 11","LOS REMEDIOS","ECUADOR","ESPA�OLES",1,0,1
" 11","LOS REMEDIOS","ECUADOR","TOTAL POBLACION",1,0,1
" 11","LOS REMEDIOS","EGIPTO","ESPA�OLES",0,1,1
" 11","LOS REMEDIOS","EGIPTO","TOTAL POBLACION",0,1,1
" 11","LOS REMEDIOS","ESPA�A","ESPA�OLES",263,254,517
" 11","LOS REMEDIOS","ESPA�A","EXTRANJEROS",14,46,60
" 11","LOS REMEDIOS","ESPA�A","TOTAL POBLACION",277,300,577
" 11","LOS REMEDIOS","ESTADOS UNIDOS DE AMERICA","ESPA�OLES",2,2,4
" 11","LOS REMEDIOS","ESTADOS UNIDOS DE AMERICA","EXTRANJEROS",2,3,5
" 11","LOS REMEDIOS","ESTADOS UNIDOS DE AMERICA","TOTAL POBLACION",4,5,9
" 11","LOS REMEDIOS","ESTONIA","EXTRANJEROS",0,1,1
" 11","LOS REMEDIOS","ESTONIA","TOTAL POBLACION",0,1,1
" 11","LOS REMEDIOS","FRANCIA","ESPA�OLES",1,1,2
" 11","LOS REMEDIOS","FRANCIA","EXTRANJEROS",1,2,3
" 11","LOS REMEDIOS","FRANCIA","TOTAL POBLACION",2,3,5
" 11","LOS REMEDIOS","GEORGIA","EXTRANJEROS",0,1,1
" 11","LOS REMEDIOS","GEORGIA","TOTAL POBLACION",0,1,1
" 11","LOS REMEDIOS","HONDURAS","EXTRANJEROS",1,0,1
" 11","LOS REMEDIOS","HONDURAS","TOTAL POBLACION",1,0,1
" 11","LOS REMEDIOS","IRLANDA","ESPA�OLES",1,0,1
" 11","LOS REMEDIOS","IRLANDA","TOTAL POBLACION",1,0,1
" 11","LOS REMEDIOS","ITALIA","EXTRANJEROS",2,2,4
" 11","LOS REMEDIOS","ITALIA","TOTAL POBLACION",2,2,4
" 11","LOS REMEDIOS","JAPON","EXTRANJEROS",0,2,2
" 11","LOS REMEDIOS","JAPON","TOTAL POBLACION",0,2,2
" 11","LOS REMEDIOS","MARRUECOS","EXTRANJEROS",0,1,1
" 11","LOS REMEDIOS","MARRUECOS","TOTAL POBLACION",0,1,1
" 11","LOS REMEDIOS","MEXICO","EXTRANJEROS",0,1,1
" 11","LOS REMEDIOS","MEXICO","TOTAL POBLACION",0,1,1
" 11","LOS REMEDIOS","NICARAGUA","EXTRANJEROS",0,11,11
" 11","LOS REMEDIOS","NICARAGUA","TOTAL POBLACION",0,11,11
" 11","LOS REMEDIOS","PARAGUAY","EXTRANJEROS",1,3,4
" 11","LOS REMEDIOS","PARAGUAY","TOTAL POBLACION",1,3,4
" 11","LOS REMEDIOS","PERU","EXTRANJEROS",3,5,8
" 11","LOS REMEDIOS","PERU","TOTAL POBLACION",3,5,8
" 11","LOS REMEDIOS","PORTUGAL","EXTRANJEROS",1,2,3
" 11","LOS REMEDIOS","PORTUGAL","TOTAL POBLACION",1,2,3
" 11","LOS REMEDIOS","REINO UNIDO","ESPA�OLES",2,2,4
" 11","LOS REMEDIOS","REINO UNIDO","EXTRANJEROS",0,1,1
" 11","LOS REMEDIOS","REINO UNIDO","TOTAL POBLACION",2,3,5
" 11","LOS REMEDIOS","REPUBLICA DE COREA","EXTRANJEROS",1,2,3
" 11","LOS REMEDIOS","REPUBLICA DE COREA","TOTAL POBLACION",1,2,3
" 11","LOS REMEDIOS","REPUBLICA DOMINICANA","EXTRANJEROS",7,4,11
" 11","LOS REMEDIOS","REPUBLICA DOMINICANA","TOTAL POBLACION",7,4,11
" 11","LOS REMEDIOS","RUMANIA","EXTRANJEROS",0,1,1
" 11","LOS REMEDIOS","RUMANIA","TOTAL POBLACION",0,1,1
" 11","LOS REMEDIOS","RUSIA","ESPA�OLES",2,0,2
" 11","LOS REMEDIOS","RUSIA","TOTAL POBLACION",2,0,2
" 11","LOS REMEDIOS","SUIZA","ESPA�OLES",1,0,1
" 11","LOS REMEDIOS","SUIZA","EXTRANJEROS",1,0,1
" 11","LOS REMEDIOS","SUIZA","TOTAL POBLACION",2,0,2
" 11","LOS REMEDIOS","UZBEKISTAN","EXTRANJEROS",1,1,2
" 11","LOS REMEDIOS","UZBEKISTAN","TOTAL POBLACION",1,1,2
" 11","LOS REMEDIOS","VENEZUELA","ESPA�OLES",0,1,1
" 11","LOS REMEDIOS","VENEZUELA","EXTRANJEROS",0,1,1
" 11","LOS REMEDIOS","VENEZUELA","TOTAL POBLACION",0,2,2
"00","TOTAL MUNICIPIO","- TODOS -","ESPA�OLES",5783,5783,11566
"00","TOTAL MUNICIPIO","- TODOS -","EXTRANJEROS",2677,3035,5712
"00","TOTAL MUNICIPIO","- TODOS -","TOTAL POBLACION",8460,8818,17278
"00","TOTAL MUNICIPIO","ALBANIA","EXTRANJEROS",3,0,3
"00","TOTAL MUNICIPIO","ALBANIA","TOTAL POBLACION",3,0,3
"00","TOTAL MUNICIPIO","ALEMANIA","ESPA�OLES",9,7,16
"00","TOTAL MUNICIPIO","ALEMANIA","EXTRANJEROS",34,26,60
"00","TOTAL MUNICIPIO","ALEMANIA","TOTAL POBLACION",43,33,76
"00","TOTAL MUNICIPIO","ANGOLA","EXTRANJEROS",0,1,1
"00","TOTAL MUNICIPIO","ANGOLA","TOTAL POBLACION",0,1,1
"00","TOTAL MUNICIPIO","ARGELIA","ESPA�OLES",3,1,4
"00","TOTAL MUNICIPIO","ARGELIA","EXTRANJEROS",20,12,32
"00","TOTAL MUNICIPIO","ARGELIA","TOTAL POBLACION",23,13,36
"00","TOTAL MUNICIPIO","ARGENTINA","ESPA�OLES",6,4,10
"00","TOTAL MUNICIPIO","ARGENTINA","EXTRANJEROS",20,24,44
"00","TOTAL MUNICIPIO","ARGENTINA","TOTAL POBLACION",26,28,54
"00","TOTAL MUNICIPIO","ARMENIA","EXTRANJEROS",4,4,8
"00","TOTAL MUNICIPIO","ARMENIA","TOTAL POBLACION",4,4,8
"00","TOTAL MUNICIPIO","AUSTRALIA","ESPA�OLES",3,5,8
"00","TOTAL MUNICIPIO","AUSTRALIA","EXTRANJEROS",3,2,5
"00","TOTAL MUNICIPIO","AUSTRALIA","TOTAL POBLACION",6,7,13
"00","TOTAL MUNICIPIO","AUSTRIA","EXTRANJEROS",0,1,1
"00","TOTAL MUNICIPIO","AUSTRIA","TOTAL POBLACION",0,1,1
"00","TOTAL MUNICIPIO","AZERBAIYAN","EXTRANJEROS",0,3,3
"00","TOTAL MUNICIPIO","AZERBAIYAN","TOTAL POBLACION",0,3,3
"00","TOTAL MUNICIPIO","BAHAMAS","ESPA�OLES",0,1,1
"00","TOTAL MUNICIPIO","BAHAMAS","TOTAL POBLACION",0,1,1
"00","TOTAL MUNICIPIO","BANGLA-DESH","EXTRANJEROS",1,0,1
"00","TOTAL MUNICIPIO","BANGLA-DESH","TOTAL POBLACION",1,0,1
"00","TOTAL MUNICIPIO","BELGICA","ESPA�OLES",7,6,13
"00","TOTAL MUNICIPIO","BELGICA","EXTRANJEROS",8,5,13
"00","TOTAL MUNICIPIO","BELGICA","TOTAL POBLACION",15,11,26
"00","TOTAL MUNICIPIO","BIELORUSIA","EXTRANJEROS",2,4,6
"00","TOTAL MUNICIPIO","BIELORUSIA","TOTAL POBLACION",2,4,6
"00","TOTAL MUNICIPIO","BOLIVIA","ESPA�OLES",4,3,7
"00","TOTAL MUNICIPIO","BOLIVIA","EXTRANJEROS",47,65,112
"00","TOTAL MUNICIPIO","BOLIVIA","TOTAL POBLACION",51,68,119
"00","TOTAL MUNICIPIO","BRASIL","ESPA�OLES",2,6,8
"00","TOTAL MUNICIPIO","BRASIL","EXTRANJEROS",29,43,72
"00","TOTAL MUNICIPIO","BRASIL","TOTAL POBLACION",31,49,80
"00","TOTAL MUNICIPIO","BULGARIA","EXTRANJEROS",10,10,20
"00","TOTAL MUNICIPIO","BULGARIA","TOTAL POBLACION",10,10,20
"00","TOTAL MUNICIPIO","BURKINA FASSO","EXTRANJEROS",2,0,2
"00","TOTAL MUNICIPIO","BURKINA FASSO","TOTAL POBLACION",2,0,2
"00","TOTAL MUNICIPIO","CAMERUN","EXTRANJEROS",22,4,26
"00","TOTAL MUNICIPIO","CAMERUN","TOTAL POBLACION",22,4,26
"00","TOTAL MUNICIPIO","CANADA","ESPA�OLES",1,0,1
"00","TOTAL MUNICIPIO","CANADA","EXTRANJEROS",8,10,18
"00","TOTAL MUNICIPIO","CANADA","TOTAL POBLACION",9,10,19
"00","TOTAL MUNICIPIO","CHILE","ESPA�OLES",5,0,5
"00","TOTAL MUNICIPIO","CHILE","EXTRANJEROS",3,12,15
"00","TOTAL MUNICIPIO","CHILE","TOTAL POBLACION",8,12,20
"00","TOTAL MUNICIPIO","CHINA","ESPA�OLES",5,5,10
"00","TOTAL MUNICIPIO","CHINA","EXTRANJEROS",96,106,202
"00","TOTAL MUNICIPIO","CHINA","TOTAL POBLACION",101,111,212
"00","TOTAL MUNICIPIO","CHIPRE","EXTRANJEROS",1,0,1
"00","TOTAL MUNICIPIO","CHIPRE","TOTAL POBLACION",1,0,1
"00","TOTAL MUNICIPIO","COLOMBIA","ESPA�OLES",3,3,6
"00","TOTAL MUNICIPIO","COLOMBIA","EXTRANJEROS",47,51,98
"00","TOTAL MUNICIPIO","COLOMBIA","TOTAL POBLACION",50,54,104
"00","TOTAL MUNICIPIO","CONGO","EXTRANJEROS",1,1,2
"00","TOTAL MUNICIPIO","CONGO","TOTAL POBLACION",1,1,2
"00","TOTAL MUNICIPIO","COSTA DE MARFIL","EXTRANJEROS",16,0,16
"00","TOTAL MUNICIPIO","COSTA DE MARFIL","TOTAL POBLACION",16,0,16
"00","TOTAL MUNICIPIO","COSTA RICA","ESPA�OLES",1,2,3
"00","TOTAL MUNICIPIO","COSTA RICA","EXTRANJEROS",2,2,4
"00","TOTAL MUNICIPIO","COSTA RICA","TOTAL POBLACION",3,4,7
"00","TOTAL MUNICIPIO","CROACIA","ESPA�OLES",0,1,1
"00","TOTAL MUNICIPIO","CROACIA","EXTRANJEROS",0,1,1
"00","TOTAL MUNICIPIO","CROACIA","TOTAL POBLACION",0,2,2
"00","TOTAL MUNICIPIO","CUBA","ESPA�OLES",8,6,14
"00","TOTAL MUNICIPIO","CUBA","EXTRANJEROS",25,31,56
"00","TOTAL MUNICIPIO","CUBA","TOTAL POBLACION",33,37,70
"00","TOTAL MUNICIPIO","DINAMARCA","ESPA�OLES",0,1,1
"00","TOTAL MUNICIPIO","DINAMARCA","EXTRANJEROS",1,4,5
"00","TOTAL MUNICIPIO","DINAMARCA","TOTAL POBLACION",1,5,6
"00","TOTAL MUNICIPIO","ECUADOR","ESPA�OLES",6,9,15
"00","TOTAL MUNICIPIO","ECUADOR","EXTRANJEROS",24,29,53
"00","TOTAL MUNICIPIO","ECUADOR","TOTAL POBLACION",30,38,68
"00","TOTAL MUNICIPIO","EGIPTO","ESPA�OLES",0,1,1
"00","TOTAL MUNICIPIO","EGIPTO","EXTRANJEROS",1,2,3
"00","TOTAL MUNICIPIO","EGIPTO","TOTAL POBLACION",1,3,4
"00","TOTAL MUNICIPIO","EL SALVADOR","ESPA�OLES",0,1,1
"00","TOTAL MUNICIPIO","EL SALVADOR","EXTRANJEROS",6,16,22
"00","TOTAL MUNICIPIO","EL SALVADOR","TOTAL POBLACION",6,17,23
"00","TOTAL MUNICIPIO","EMIRATOS ARABES UNIDOS","ESPA�OLES",2,1,3
"00","TOTAL MUNICIPIO","EMIRATOS ARABES UNIDOS","TOTAL POBLACION",2,1,3
"00","TOTAL MUNICIPIO","ERITREA","EXTRANJEROS",2,0,2
"00","TOTAL MUNICIPIO","ERITREA","TOTAL POBLACION",2,0,2
"00","TOTAL MUNICIPIO","ESLOVAQUIA","EXTRANJEROS",0,2,2
"00","TOTAL MUNICIPIO","ESLOVAQUIA","TOTAL POBLACION",0,2,2
"00","TOTAL MUNICIPIO","ESLOVENIA","EXTRANJEROS",0,1,1
"00","TOTAL MUNICIPIO","ESLOVENIA","TOTAL POBLACION",0,1,1
"00","TOTAL MUNICIPIO","ESPA�A","ESPA�OLES",5623,5610,11233
"00","TOTAL MUNICIPIO","ESPA�A","EXTRANJEROS",1156,1247,2403
"00","TOTAL MUNICIPIO","ESPA�A","TOTAL POBLACION",6779,6857,13636
"00","TOTAL MUNICIPIO","ESTADOS UNIDOS DE AMERICA","ESPA�OLES",13,17,30
"00","TOTAL MUNICIPIO","ESTADOS UNIDOS DE AMERICA","EXTRANJEROS",36,64,100
"00","TOTAL MUNICIPIO","ESTADOS UNIDOS DE AMERICA","TOTAL POBLACION",49,81,130
"00","TOTAL MUNICIPIO","ESTONIA","EXTRANJEROS",0,1,1
"00","TOTAL MUNICIPIO","ESTONIA","TOTAL POBLACION",0,1,1
"00","TOTAL MUNICIPIO","ETIOPIA","ESPA�OLES",1,0,1
"00","TOTAL MUNICIPIO","ETIOPIA","EXTRANJEROS",3,3,6
"00","TOTAL MUNICIPIO","ETIOPIA","TOTAL POBLACION",4,3,7
"00","TOTAL MUNICIPIO","FILIPINAS","ESPA�OLES",0,2,2
"00","TOTAL MUNICIPIO","FILIPINAS","EXTRANJEROS",3,11,14
"00","TOTAL MUNICIPIO","FILIPINAS","TOTAL POBLACION",3,13,16
"00","TOTAL MUNICIPIO","FINLANDIA","EXTRANJEROS",2,3,5
"00","TOTAL MUNICIPIO","FINLANDIA","TOTAL POBLACION",2,3,5
"00","TOTAL MUNICIPIO","FRANCIA","ESPA�OLES",9,12,21
"00","TOTAL MUNICIPIO","FRANCIA","EXTRANJEROS",52,78,130
"00","TOTAL MUNICIPIO","FRANCIA","TOTAL POBLACION",61,90,151
"00","TOTAL MUNICIPIO","GABON","EXTRANJEROS",3,2,5
"00","TOTAL MUNICIPIO","GABON","TOTAL POBLACION",3,2,5
"00","TOTAL MUNICIPIO","GAMBIA","EXTRANJEROS",6,0,6
"00","TOTAL MUNICIPIO","GAMBIA","TOTAL POBLACION",6,0,6
"00","TOTAL MUNICIPIO","GEORGIA","EXTRANJEROS",1,5,6
"00","TOTAL MUNICIPIO","GEORGIA","TOTAL POBLACION",1,5,6
"00","TOTAL MUNICIPIO","GHANA","EXTRANJEROS",6,1,7
"00","TOTAL MUNICIPIO","GHANA","TOTAL POBLACION",6,1,7
"00","TOTAL MUNICIPIO","GRANADA","ESPA�OLES",2,0,2
"00","TOTAL MUNICIPIO","GRANADA","EXTRANJEROS",1,0,1
"00","TOTAL MUNICIPIO","GRANADA","TOTAL POBLACION",3,0,3
"00","TOTAL MUNICIPIO","GRECIA","ESPA�OLES",0,2,2
"00","TOTAL MUNICIPIO","GRECIA","EXTRANJEROS",7,4,11
"00","TOTAL MUNICIPIO","GRECIA","TOTAL POBLACION",7,6,13
"00","TOTAL MUNICIPIO","GUATEMALA","ESPA�OLES",0,2,2
"00","TOTAL MUNICIPIO","GUATEMALA","EXTRANJEROS",5,9,14
"00","TOTAL MUNICIPIO","GUATEMALA","TOTAL POBLACION",5,11,16
"00","TOTAL MUNICIPIO","GUINEA","EXTRANJEROS",15,0,15
"00","TOTAL MUNICIPIO","GUINEA","TOTAL POBLACION",15,0,15
"00","TOTAL MUNICIPIO","GUINEA BISSAU","EXTRANJEROS",1,0,1
"00","TOTAL MUNICIPIO","GUINEA BISSAU","TOTAL POBLACION",1,0,1
"00","TOTAL MUNICIPIO","GUINEA ECUATORIAL","ESPA�OLES",1,0,1
"00","TOTAL MUNICIPIO","GUINEA ECUATORIAL","EXTRANJEROS",6,1,7
"00","TOTAL MUNICIPIO","GUINEA ECUATORIAL","TOTAL POBLACION",7,1,8
"00","TOTAL MUNICIPIO","HAITI","EXTRANJEROS",1,0,1
"00","TOTAL MUNICIPIO","HAITI","TOTAL POBLACION",1,0,1
"00","TOTAL MUNICIPIO","HONDURAS","ESPA�OLES",0,2,2
"00","TOTAL MUNICIPIO","HONDURAS","EXTRANJEROS",16,36,52
"00","TOTAL MUNICIPIO","HONDURAS","TOTAL POBLACION",16,38,54
"00","TOTAL MUNICIPIO","HUNGRIA","ESPA�OLES",1,0,1
"00","TOTAL MUNICIPIO","HUNGRIA","EXTRANJEROS",3,4,7
"00","TOTAL MUNICIPIO","HUNGRIA","TOTAL POBLACION",4,4,8
"00","TOTAL MUNICIPIO","INDIA","ESPA�OLES",0,1,1
"00","TOTAL MUNICIPIO","INDIA","EXTRANJEROS",5,4,9
"00","TOTAL MUNICIPIO","INDIA","TOTAL POBLACION",5,5,10
"00","TOTAL MUNICIPIO","INDONESIA","ESPA�OLES",0,1,1
"00","TOTAL MUNICIPIO","INDONESIA","EXTRANJEROS",0,1,1
"00","TOTAL MUNICIPIO","INDONESIA","TOTAL POBLACION",0,2,2
"00","TOTAL MUNICIPIO","IRAK","EXTRANJEROS",4,3,7
"00","TOTAL MUNICIPIO","IRAK","TOTAL POBLACION",4,3,7
"00","TOTAL MUNICIPIO","IRAN","EXTRANJEROS",4,2,6
"00","TOTAL MUNICIPIO","IRAN","TOTAL POBLACION",4,2,6
"00","TOTAL MUNICIPIO","IRLANDA","ESPA�OLES",1,1,2
"00","TOTAL MUNICIPIO","IRLANDA","EXTRANJEROS",3,4,7
"00","TOTAL MUNICIPIO","IRLANDA","TOTAL POBLACION",4,5,9
"00","TOTAL MUNICIPIO","ISLANDIA","EXTRANJEROS",1,1,2
"00","TOTAL MUNICIPIO","ISLANDIA","TOTAL POBLACION",1,1,2
"00","TOTAL MUNICIPIO","ISRAEL","EXTRANJEROS",4,2,6
"00","TOTAL MUNICIPIO","ISRAEL","TOTAL POBLACION",4,2,6
"00","TOTAL MUNICIPIO","ITALIA","ESPA�OLES",0,6,6
"00","TOTAL MUNICIPIO","ITALIA","EXTRANJEROS",78,92,170
"00","TOTAL MUNICIPIO","ITALIA","TOTAL POBLACION",78,98,176
"00","TOTAL MUNICIPIO","JAMAICA","EXTRANJEROS",1,0,1
"00","TOTAL MUNICIPIO","JAMAICA","TOTAL POBLACION",1,0,1
"00","TOTAL MUNICIPIO","JAPON","ESPA�OLES",0,2,2
"00","TOTAL MUNICIPIO","JAPON","EXTRANJEROS",2,13,15
"00","TOTAL MUNICIPIO","JAPON","TOTAL POBLACION",2,15,17
"00","TOTAL MUNICIPIO","JORDANIA","ESPA�OLES",0,1,1
"00","TOTAL MUNICIPIO","JORDANIA","EXTRANJEROS",3,1,4
"00","TOTAL MUNICIPIO","JORDANIA","TOTAL POBLACION",3,2,5
"00","TOTAL MUNICIPIO","KAZAJSTAN","EXTRANJEROS",1,1,2
"00","TOTAL MUNICIPIO","KAZAJSTAN","TOTAL POBLACION",1,1,2
"00","TOTAL MUNICIPIO","KENIA","EXTRANJEROS",0,2,2
"00","TOTAL MUNICIPIO","KENIA","TOTAL POBLACION",0,2,2
"00","TOTAL MUNICIPIO","KIRGVISTAN","EXTRANJEROS",1,0,1
"00","TOTAL MUNICIPIO","KIRGVISTAN","TOTAL POBLACION",1,0,1
"00","TOTAL MUNICIPIO","LETONIA","EXTRANJEROS",1,2,3
"00","TOTAL MUNICIPIO","LETONIA","TOTAL POBLACION",1,2,3
"00","TOTAL MUNICIPIO","LIBIA","EXTRANJEROS",2,1,3
"00","TOTAL MUNICIPIO","LIBIA","TOTAL POBLACION",2,1,3
"00","TOTAL MUNICIPIO","LITUANIA","EXTRANJEROS",1,2,3
"00","TOTAL MUNICIPIO","LITUANIA","TOTAL POBLACION",1,2,3
"00","TOTAL MUNICIPIO","MACEDONIA","EXTRANJEROS",1,0,1
"00","TOTAL MUNICIPIO","MACEDONIA","TOTAL POBLACION",1,0,1
"00","TOTAL MUNICIPIO","MALAWI","EXTRANJEROS",1,0,1
"00","TOTAL MUNICIPIO","MALAWI","TOTAL POBLACION",1,0,1
"00","TOTAL MUNICIPIO","MALI","ESPA�OLES",0,1,1
"00","TOTAL MUNICIPIO","MALI","EXTRANJEROS",9,1,10
"00","TOTAL MUNICIPIO","MALI","TOTAL POBLACION",9,2,11
"00","TOTAL MUNICIPIO","MARRUECOS","ESPA�OLES",5,2,7
"00","TOTAL MUNICIPIO","MARRUECOS","EXTRANJEROS",152,116,268
"00","TOTAL MUNICIPIO","MARRUECOS","TOTAL POBLACION",157,118,275
"00","TOTAL MUNICIPIO","MAURITANIA","EXTRANJEROS",1,0,1
"00","TOTAL MUNICIPIO","MAURITANIA","TOTAL POBLACION",1,0,1
"00","TOTAL MUNICIPIO","MEXICO","ESPA�OLES",5,5,10
"00","TOTAL MUNICIPIO","MEXICO","EXTRANJEROS",21,25,46
"00","TOTAL MUNICIPIO","MEXICO","TOTAL POBLACION",26,30,56
"00","TOTAL MUNICIPIO","MOLDAVIA","EXTRANJEROS",1,3,4
"00","TOTAL MUNICIPIO","MOLDAVIA","TOTAL POBLACION",1,3,4
"00","TOTAL MUNICIPIO","MONTENEGRO","EXTRANJEROS",1,1,2
"00","TOTAL MUNICIPIO","MONTENEGRO","TOTAL POBLACION",1,1,2
"00","TOTAL MUNICIPIO","NAMIBIA","ESPA�OLES",1,0,1
"00","TOTAL MUNICIPIO","NAMIBIA","TOTAL POBLACION",1,0,1
"00","TOTAL MUNICIPIO","NEPAL","EXTRANJEROS",1,0,1
"00","TOTAL MUNICIPIO","NEPAL","TOTAL POBLACION",1,0,1
"00","TOTAL MUNICIPIO","NICARAGUA","ESPA�OLES",0,1,1
"00","TOTAL MUNICIPIO","NICARAGUA","EXTRANJEROS",38,176,214
"00","TOTAL MUNICIPIO","NICARAGUA","TOTAL POBLACION",38,177,215
"00","TOTAL MUNICIPIO","NIGER","EXTRANJEROS",2,0,2
"00","TOTAL MUNICIPIO","NIGER","TOTAL POBLACION",2,0,2
"00","TOTAL MUNICIPIO","NIGERIA","EXTRANJEROS",58,28,86
"00","TOTAL MUNICIPIO","NIGERIA","TOTAL POBLACION",58,28,86
"00","TOTAL MUNICIPIO","NORUEGA","EXTRANJEROS",1,1,2
"00","TOTAL MUNICIPIO","NORUEGA","TOTAL POBLACION",1,1,2
"00","TOTAL MUNICIPIO","NUEVA ZELANDA","EXTRANJEROS",0,1,1
"00","TOTAL MUNICIPIO","NUEVA ZELANDA","TOTAL POBLACION",0,1,1
"00","TOTAL MUNICIPIO","OTROS AFRICA SIN RELACION DIPL","EXTRANJEROS",1,0,1
"00","TOTAL MUNICIPIO","OTROS AFRICA SIN RELACION DIPL","TOTAL POBLACION",1,0,1
"00","TOTAL MUNICIPIO","OTROS PAISES SIN RELACION DIPLOMATICA","ESPA�OLES",1,0,1
"00","TOTAL MUNICIPIO","OTROS PAISES SIN RELACION DIPLOMATICA","EXTRANJEROS",11,0,11
"00","TOTAL MUNICIPIO","OTROS PAISES SIN RELACION DIPLOMATICA","TOTAL POBLACION",12,0,12
"00","TOTAL MUNICIPIO","PAISES BAJOS","ESPA�OLES",3,7,10
"00","TOTAL MUNICIPIO","PAISES BAJOS","EXTRANJEROS",6,5,11
"00","TOTAL MUNICIPIO","PAISES BAJOS","TOTAL POBLACION",9,12,21
"00","TOTAL MUNICIPIO","PAKISTAN","EXTRANJEROS",23,4,27
"00","TOTAL MUNICIPIO","PAKISTAN","TOTAL POBLACION",23,4,27
"00","TOTAL MUNICIPIO","PANAMA","ESPA�OLES",1,0,1
"00","TOTAL MUNICIPIO","PANAMA","EXTRANJEROS",3,1,4
"00","TOTAL MUNICIPIO","PANAMA","TOTAL POBLACION",4,1,5
"00","TOTAL MUNICIPIO","PARAGUAY","ESPA�OLES",5,3,8
"00","TOTAL MUNICIPIO","PARAGUAY","EXTRANJEROS",47,81,128
"00","TOTAL MUNICIPIO","PARAGUAY","TOTAL POBLACION",52,84,136
"00","TOTAL MUNICIPIO","PERU","ESPA�OLES",3,1,4
"00","TOTAL MUNICIPIO","PERU","EXTRANJEROS",40,56,96
"00","TOTAL MUNICIPIO","PERU","TOTAL POBLACION",43,57,100
"00","TOTAL MUNICIPIO","POLONIA","EXTRANJEROS",10,21,31
"00","TOTAL MUNICIPIO","POLONIA","TOTAL POBLACION",10,21,31
"00","TOTAL MUNICIPIO","PORTUGAL","ESPA�OLES",5,5,10
"00","TOTAL MUNICIPIO","PORTUGAL","EXTRANJEROS",27,22,49
"00","TOTAL MUNICIPIO","PORTUGAL","TOTAL POBLACION",32,27,59
"00","TOTAL MUNICIPIO","REINO UNIDO","ESPA�OLES",12,12,24
"00","TOTAL MUNICIPIO","REINO UNIDO","EXTRANJEROS",55,35,90
"00","TOTAL MUNICIPIO","REINO UNIDO","TOTAL POBLACION",67,47,114
"00","TOTAL MUNICIPIO","REPUBLICA CENTROAFRICANA","EXTRANJEROS",1,0,1
"00","TOTAL MUNICIPIO","REPUBLICA CENTROAFRICANA","TOTAL POBLACION",1,0,1
"00","TOTAL MUNICIPIO","REPUBLICA CHECA","EXTRANJEROS",1,4,5
"00","TOTAL MUNICIPIO","REPUBLICA CHECA","TOTAL POBLACION",1,4,5
"00","TOTAL MUNICIPIO","REPUBLICA DE COREA","ESPA�OLES",0,1,1
"00","TOTAL MUNICIPIO","REPUBLICA DE COREA","EXTRANJEROS",4,9,13
"00","TOTAL MUNICIPIO","REPUBLICA DE COREA","TOTAL POBLACION",4,10,14
"00","TOTAL MUNICIPIO","REPUBLICA DEMOCRATICA DEL CONGO","EXTRANJEROS",2,0,2
"00","TOTAL MUNICIPIO","REPUBLICA DEMOCRATICA DEL CONGO","TOTAL POBLACION",2,0,2
"00","TOTAL MUNICIPIO","REPUBLICA DOMINICANA","ESPA�OLES",2,2,4
"00","TOTAL MUNICIPIO","REPUBLICA DOMINICANA","EXTRANJEROS",33,39,72
"00","TOTAL MUNICIPIO","REPUBLICA DOMINICANA","TOTAL POBLACION",35,41,76
"00","TOTAL MUNICIPIO","REPUBLICA SUDAFRICANA","ESPA�OLES",2,3,5
"00","TOTAL MUNICIPIO","REPUBLICA SUDAFRICANA","TOTAL POBLACION",2,3,5
"00","TOTAL MUNICIPIO","RUANDA","EXTRANJEROS",1,0,1
"00","TOTAL MUNICIPIO","RUANDA","TOTAL POBLACION",1,0,1
"00","TOTAL MUNICIPIO","RUMANIA","EXTRANJEROS",113,132,245
"00","TOTAL MUNICIPIO","RUMANIA","TOTAL POBLACION",113,132,245
"00","TOTAL MUNICIPIO","RUSIA","ESPA�OLES",6,1,7
"00","TOTAL MUNICIPIO","RUSIA","EXTRANJEROS",18,79,97
"00","TOTAL MUNICIPIO","RUSIA","TOTAL POBLACION",24,80,104
"00","TOTAL MUNICIPIO","SENEGAL","ESPA�OLES",0,1,1
"00","TOTAL MUNICIPIO","SENEGAL","EXTRANJEROS",48,9,57
"00","TOTAL MUNICIPIO","SENEGAL","TOTAL POBLACION",48,10,58
"00","TOTAL MUNICIPIO","SERBIA","EXTRANJEROS",1,3,4
"00","TOTAL MUNICIPIO","SERBIA","TOTAL POBLACION",1,3,4
"00","TOTAL MUNICIPIO","SIERRA LEONA","EXTRANJEROS",2,0,2
"00","TOTAL MUNICIPIO","SIERRA LEONA","TOTAL POBLACION",2,0,2
"00","TOTAL MUNICIPIO","SIRIA","ESPA�OLES",1,1,2
"00","TOTAL MUNICIPIO","SIRIA","EXTRANJEROS",7,1,8
"00","TOTAL MUNICIPIO","SIRIA","TOTAL POBLACION",8,2,10
"00","TOTAL MUNICIPIO","SOMALIA","EXTRANJEROS",1,0,1
"00","TOTAL MUNICIPIO","SOMALIA","TOTAL POBLACION",1,0,1
"00","TOTAL MUNICIPIO","SUECIA","ESPA�OLES",1,0,1
"00","TOTAL MUNICIPIO","SUECIA","EXTRANJEROS",2,4,6
"00","TOTAL MUNICIPIO","SUECIA","TOTAL POBLACION",3,4,7
"00","TOTAL MUNICIPIO","SUIZA","ESPA�OLES",4,3,7
"00","TOTAL MUNICIPIO","SUIZA","EXTRANJEROS",4,5,9
"00","TOTAL MUNICIPIO","SUIZA","TOTAL POBLACION",8,8,16
"00","TOTAL MUNICIPIO","TAILANDIA","EXTRANJEROS",0,1,1
"00","TOTAL MUNICIPIO","TAILANDIA","TOTAL POBLACION",0,1,1
"00","TOTAL MUNICIPIO","TAIWAN","EXTRANJEROS",3,1,4
"00","TOTAL MUNICIPIO","TAIWAN","TOTAL POBLACION",3,1,4
"00","TOTAL MUNICIPIO","TANZANIA","EXTRANJEROS",0,6,6
"00","TOTAL MUNICIPIO","TANZANIA","TOTAL POBLACION",0,6,6
"00","TOTAL MUNICIPIO","TCHAD","EXTRANJEROS",2,0,2
"00","TOTAL MUNICIPIO","TCHAD","TOTAL POBLACION",2,0,2
"00","TOTAL MUNICIPIO","TOGO","EXTRANJEROS",1,0,1
"00","TOTAL MUNICIPIO","TOGO","TOTAL POBLACION",1,0,1
"00","TOTAL MUNICIPIO","TUNEZ","ESPA�OLES",0,2,2
"00","TOTAL MUNICIPIO","TUNEZ","EXTRANJEROS",1,1,2
"00","TOTAL MUNICIPIO","TUNEZ","TOTAL POBLACION",1,3,4
"00","TOTAL MUNICIPIO","TURQUIA","EXTRANJEROS",3,2,5
"00","TOTAL MUNICIPIO","TURQUIA","TOTAL POBLACION",3,2,5
"00","TOTAL MUNICIPIO","UCRANIA","ESPA�OLES",2,1,3
"00","TOTAL MUNICIPIO","UCRANIA","EXTRANJEROS",17,49,66
"00","TOTAL MUNICIPIO","UCRANIA","TOTAL POBLACION",19,50,69
"00","TOTAL MUNICIPIO","UGANDA","EXTRANJEROS",1,0,1
"00","TOTAL MUNICIPIO","UGANDA","TOTAL POBLACION",1,0,1
"00","TOTAL MUNICIPIO","URUGUAY","ESPA�OLES",1,0,1
"00","TOTAL MUNICIPIO","URUGUAY","EXTRANJEROS",2,5,7
"00","TOTAL MUNICIPIO","URUGUAY","TOTAL POBLACION",3,5,8
"00","TOTAL MUNICIPIO","UZBEKISTAN","EXTRANJEROS",1,3,4
"00","TOTAL MUNICIPIO","UZBEKISTAN","TOTAL POBLACION",1,3,4
"00","TOTAL MUNICIPIO","VENEZUELA","ESPA�OLES",7,8,15
"00","TOTAL MUNICIPIO","VENEZUELA","EXTRANJEROS",24,33,57
"00","TOTAL MUNICIPIO","VENEZUELA","TOTAL POBLACION",31,41,72
"00","TOTAL MUNICIPIO","VIET-NAM","ESPA�OLES",0,1,1
"00","TOTAL MUNICIPIO","VIET-NAM","TOTAL POBLACION",0,1,1
"00","TOTAL MUNICIPIO","YEMEN","EXTRANJEROS",2,0,2
"00","TOTAL MUNICIPIO","YEMEN","TOTAL POBLACION",2,0,2
