"CD","DISTRITO","PROCEDENCIA","NACIONALIDAD","HOMBRES","MUJERES","TOTAL"
" 01","CASCO ANTIGUO","- TODOS -","ESPA�OLES",634,718,1352
" 01","CASCO ANTIGUO","- TODOS -","EXTRANJEROS",219,283,502
" 01","CASCO ANTIGUO","- TODOS -","TOTAL POBLACION",853,1001,1854
" 01","CASCO ANTIGUO","ALBANIA","ESPA�OLES",1,0,1
" 01","CASCO ANTIGUO","ALBANIA","TOTAL POBLACION",1,0,1
" 01","CASCO ANTIGUO","ALEMANIA","ESPA�OLES",0,1,1
" 01","CASCO ANTIGUO","ALEMANIA","EXTRANJEROS",10,10,20
" 01","CASCO ANTIGUO","ALEMANIA","TOTAL POBLACION",10,11,21
" 01","CASCO ANTIGUO","ARABIA SAUDITA","EXTRANJEROS",1,0,1
" 01","CASCO ANTIGUO","ARABIA SAUDITA","TOTAL POBLACION",1,0,1
" 01","CASCO ANTIGUO","ARGELIA","EXTRANJEROS",0,1,1
" 01","CASCO ANTIGUO","ARGELIA","TOTAL POBLACION",0,1,1
" 01","CASCO ANTIGUO","ARGENTINA","EXTRANJEROS",3,5,8
" 01","CASCO ANTIGUO","ARGENTINA","TOTAL POBLACION",3,5,8
" 01","CASCO ANTIGUO","AUSTRALIA","EXTRANJEROS",1,0,1
" 01","CASCO ANTIGUO","AUSTRALIA","TOTAL POBLACION",1,0,1
" 01","CASCO ANTIGUO","AUSTRIA","EXTRANJEROS",0,1,1
" 01","CASCO ANTIGUO","AUSTRIA","TOTAL POBLACION",0,1,1
" 01","CASCO ANTIGUO","BELGICA","ESPA�OLES",1,1,2
" 01","CASCO ANTIGUO","BELGICA","EXTRANJEROS",1,4,5
" 01","CASCO ANTIGUO","BELGICA","TOTAL POBLACION",2,5,7
" 01","CASCO ANTIGUO","BOLIVIA","ESPA�OLES",1,0,1
" 01","CASCO ANTIGUO","BOLIVIA","EXTRANJEROS",3,0,3
" 01","CASCO ANTIGUO","BOLIVIA","TOTAL POBLACION",4,0,4
" 01","CASCO ANTIGUO","BRASIL","ESPA�OLES",1,0,1
" 01","CASCO ANTIGUO","BRASIL","EXTRANJEROS",5,8,13
" 01","CASCO ANTIGUO","BRASIL","TOTAL POBLACION",6,8,14
" 01","CASCO ANTIGUO","CAMBOYA","ESPA�OLES",1,0,1
" 01","CASCO ANTIGUO","CAMBOYA","TOTAL POBLACION",1,0,1
" 01","CASCO ANTIGUO","CANADA","EXTRANJEROS",0,1,1
" 01","CASCO ANTIGUO","CANADA","TOTAL POBLACION",0,1,1
" 01","CASCO ANTIGUO","CHILE","EXTRANJEROS",1,0,1
" 01","CASCO ANTIGUO","CHILE","TOTAL POBLACION",1,0,1
" 01","CASCO ANTIGUO","CHINA","ESPA�OLES",4,3,7
" 01","CASCO ANTIGUO","CHINA","EXTRANJEROS",7,8,15
" 01","CASCO ANTIGUO","CHINA","TOTAL POBLACION",11,11,22
" 01","CASCO ANTIGUO","COLOMBIA","ESPA�OLES",1,1,2
" 01","CASCO ANTIGUO","COLOMBIA","EXTRANJEROS",1,9,10
" 01","CASCO ANTIGUO","COLOMBIA","TOTAL POBLACION",2,10,12
" 01","CASCO ANTIGUO","COSTA RICA","EXTRANJEROS",0,2,2
" 01","CASCO ANTIGUO","COSTA RICA","TOTAL POBLACION",0,2,2
" 01","CASCO ANTIGUO","CUBA","ESPA�OLES",1,1,2
" 01","CASCO ANTIGUO","CUBA","EXTRANJEROS",3,4,7
" 01","CASCO ANTIGUO","CUBA","TOTAL POBLACION",4,5,9
" 01","CASCO ANTIGUO","ECUADOR","ESPA�OLES",2,1,3
" 01","CASCO ANTIGUO","ECUADOR","EXTRANJEROS",1,2,3
" 01","CASCO ANTIGUO","ECUADOR","TOTAL POBLACION",3,3,6
" 01","CASCO ANTIGUO","EGIPTO","ESPA�OLES",0,1,1
" 01","CASCO ANTIGUO","EGIPTO","TOTAL POBLACION",0,1,1
" 01","CASCO ANTIGUO","EL SALVADOR","EXTRANJEROS",0,1,1
" 01","CASCO ANTIGUO","EL SALVADOR","TOTAL POBLACION",0,1,1
" 01","CASCO ANTIGUO","EMIRATOS ARABES UNIDOS","ESPA�OLES",1,1,2
" 01","CASCO ANTIGUO","EMIRATOS ARABES UNIDOS","TOTAL POBLACION",1,1,2
" 01","CASCO ANTIGUO","ESLOVAQUIA","EXTRANJEROS",0,1,1
" 01","CASCO ANTIGUO","ESLOVAQUIA","TOTAL POBLACION",0,1,1
" 01","CASCO ANTIGUO","ESPA�A","ESPA�OLES",599,686,1285
" 01","CASCO ANTIGUO","ESPA�A","EXTRANJEROS",81,94,175
" 01","CASCO ANTIGUO","ESPA�A","TOTAL POBLACION",680,780,1460
" 01","CASCO ANTIGUO","ESTADOS UNIDOS DE AMERICA","ESPA�OLES",4,6,10
" 01","CASCO ANTIGUO","ESTADOS UNIDOS DE AMERICA","EXTRANJEROS",16,17,33
" 01","CASCO ANTIGUO","ESTADOS UNIDOS DE AMERICA","TOTAL POBLACION",20,23,43
" 01","CASCO ANTIGUO","FILIPINAS","ESPA�OLES",0,1,1
" 01","CASCO ANTIGUO","FILIPINAS","EXTRANJEROS",1,4,5
" 01","CASCO ANTIGUO","FILIPINAS","TOTAL POBLACION",1,5,6
" 01","CASCO ANTIGUO","FINLANDIA","EXTRANJEROS",0,1,1
" 01","CASCO ANTIGUO","FINLANDIA","TOTAL POBLACION",0,1,1
" 01","CASCO ANTIGUO","FRANCIA","ESPA�OLES",4,1,5
" 01","CASCO ANTIGUO","FRANCIA","EXTRANJEROS",11,14,25
" 01","CASCO ANTIGUO","FRANCIA","TOTAL POBLACION",15,15,30
" 01","CASCO ANTIGUO","GHANA","ESPA�OLES",0,1,1
" 01","CASCO ANTIGUO","GHANA","TOTAL POBLACION",0,1,1
" 01","CASCO ANTIGUO","GRECIA","EXTRANJEROS",1,2,3
" 01","CASCO ANTIGUO","GRECIA","TOTAL POBLACION",1,2,3
" 01","CASCO ANTIGUO","GUINEA","EXTRANJEROS",1,0,1
" 01","CASCO ANTIGUO","GUINEA","TOTAL POBLACION",1,0,1
" 01","CASCO ANTIGUO","HONDURAS","EXTRANJEROS",1,1,2
" 01","CASCO ANTIGUO","HONDURAS","TOTAL POBLACION",1,1,2
" 01","CASCO ANTIGUO","INDIA","EXTRANJEROS",1,0,1
" 01","CASCO ANTIGUO","INDIA","TOTAL POBLACION",1,0,1
" 01","CASCO ANTIGUO","IRAN","EXTRANJEROS",1,0,1
" 01","CASCO ANTIGUO","IRAN","TOTAL POBLACION",1,0,1
" 01","CASCO ANTIGUO","IRLANDA","ESPA�OLES",1,2,3
" 01","CASCO ANTIGUO","IRLANDA","EXTRANJEROS",1,2,3
" 01","CASCO ANTIGUO","IRLANDA","TOTAL POBLACION",2,4,6
" 01","CASCO ANTIGUO","ISRAEL","EXTRANJEROS",0,1,1
" 01","CASCO ANTIGUO","ISRAEL","TOTAL POBLACION",0,1,1
" 01","CASCO ANTIGUO","ITALIA","ESPA�OLES",0,1,1
" 01","CASCO ANTIGUO","ITALIA","EXTRANJEROS",16,22,38
" 01","CASCO ANTIGUO","ITALIA","TOTAL POBLACION",16,23,39
" 01","CASCO ANTIGUO","JAPON","ESPA�OLES",0,1,1
" 01","CASCO ANTIGUO","JAPON","EXTRANJEROS",1,0,1
" 01","CASCO ANTIGUO","JAPON","TOTAL POBLACION",1,1,2
" 01","CASCO ANTIGUO","KAZAJSTAN","EXTRANJEROS",1,1,2
" 01","CASCO ANTIGUO","KAZAJSTAN","TOTAL POBLACION",1,1,2
" 01","CASCO ANTIGUO","LETONIA","EXTRANJEROS",0,1,1
" 01","CASCO ANTIGUO","LETONIA","TOTAL POBLACION",0,1,1
" 01","CASCO ANTIGUO","LITUANIA","EXTRANJEROS",0,2,2
" 01","CASCO ANTIGUO","LITUANIA","TOTAL POBLACION",0,2,2
" 01","CASCO ANTIGUO","LUXEMBURGO","ESPA�OLES",1,0,1
" 01","CASCO ANTIGUO","LUXEMBURGO","TOTAL POBLACION",1,0,1
" 01","CASCO ANTIGUO","MARRUECOS","EXTRANJEROS",7,8,15
" 01","CASCO ANTIGUO","MARRUECOS","TOTAL POBLACION",7,8,15
" 01","CASCO ANTIGUO","MEXICO","ESPA�OLES",1,2,3
" 01","CASCO ANTIGUO","MEXICO","EXTRANJEROS",2,11,13
" 01","CASCO ANTIGUO","MEXICO","TOTAL POBLACION",3,13,16
" 01","CASCO ANTIGUO","NICARAGUA","EXTRANJEROS",1,4,5
" 01","CASCO ANTIGUO","NICARAGUA","TOTAL POBLACION",1,4,5
" 01","CASCO ANTIGUO","OTROS PAISES SIN RELACION DIPLOMATICA","EXTRANJEROS",5,1,6
" 01","CASCO ANTIGUO","OTROS PAISES SIN RELACION DIPLOMATICA","TOTAL POBLACION",5,1,6
" 01","CASCO ANTIGUO","PAISES BAJOS","ESPA�OLES",0,1,1
" 01","CASCO ANTIGUO","PAISES BAJOS","EXTRANJEROS",1,0,1
" 01","CASCO ANTIGUO","PAISES BAJOS","TOTAL POBLACION",1,1,2
" 01","CASCO ANTIGUO","PAKISTAN","EXTRANJEROS",2,0,2
" 01","CASCO ANTIGUO","PAKISTAN","TOTAL POBLACION",2,0,2
" 01","CASCO ANTIGUO","PANAMA","EXTRANJEROS",0,1,1
" 01","CASCO ANTIGUO","PANAMA","TOTAL POBLACION",0,1,1
" 01","CASCO ANTIGUO","PARAGUAY","EXTRANJEROS",1,1,2
" 01","CASCO ANTIGUO","PARAGUAY","TOTAL POBLACION",1,1,2
" 01","CASCO ANTIGUO","PERU","EXTRANJEROS",2,1,3
" 01","CASCO ANTIGUO","PERU","TOTAL POBLACION",2,1,3
" 01","CASCO ANTIGUO","POLONIA","EXTRANJEROS",0,1,1
" 01","CASCO ANTIGUO","POLONIA","TOTAL POBLACION",0,1,1
" 01","CASCO ANTIGUO","PORTUGAL","ESPA�OLES",1,0,1
" 01","CASCO ANTIGUO","PORTUGAL","EXTRANJEROS",3,2,5
" 01","CASCO ANTIGUO","PORTUGAL","TOTAL POBLACION",4,2,6
" 01","CASCO ANTIGUO","PRINCIPADO DE ANDORRA","ESPA�OLES",1,0,1
" 01","CASCO ANTIGUO","PRINCIPADO DE ANDORRA","TOTAL POBLACION",1,0,1
" 01","CASCO ANTIGUO","REINO UNIDO","ESPA�OLES",6,2,8
" 01","CASCO ANTIGUO","REINO UNIDO","EXTRANJEROS",11,11,22
" 01","CASCO ANTIGUO","REINO UNIDO","TOTAL POBLACION",17,13,30
" 01","CASCO ANTIGUO","REPUBLICA DE COREA","EXTRANJEROS",0,5,5
" 01","CASCO ANTIGUO","REPUBLICA DE COREA","TOTAL POBLACION",0,5,5
" 01","CASCO ANTIGUO","REPUBLICA DOMINICANA","EXTRANJEROS",4,2,6
" 01","CASCO ANTIGUO","REPUBLICA DOMINICANA","TOTAL POBLACION",4,2,6
" 01","CASCO ANTIGUO","RUMANIA","EXTRANJEROS",5,3,8
" 01","CASCO ANTIGUO","RUMANIA","TOTAL POBLACION",5,3,8
" 01","CASCO ANTIGUO","RUSIA","EXTRANJEROS",1,4,5
" 01","CASCO ANTIGUO","RUSIA","TOTAL POBLACION",1,4,5
" 01","CASCO ANTIGUO","SENEGAL","ESPA�OLES",0,1,1
" 01","CASCO ANTIGUO","SENEGAL","EXTRANJEROS",0,1,1
" 01","CASCO ANTIGUO","SENEGAL","TOTAL POBLACION",0,2,2
" 01","CASCO ANTIGUO","SERBIA","EXTRANJEROS",0,1,1
" 01","CASCO ANTIGUO","SERBIA","TOTAL POBLACION",0,1,1
" 01","CASCO ANTIGUO","SIRIA","EXTRANJEROS",1,1,2
" 01","CASCO ANTIGUO","SIRIA","TOTAL POBLACION",1,1,2
" 01","CASCO ANTIGUO","SUIZA","EXTRANJEROS",1,0,1
" 01","CASCO ANTIGUO","SUIZA","TOTAL POBLACION",1,0,1
" 01","CASCO ANTIGUO","TURQUIA","ESPA�OLES",1,0,1
" 01","CASCO ANTIGUO","TURQUIA","TOTAL POBLACION",1,0,1
" 01","CASCO ANTIGUO","URUGUAY","ESPA�OLES",0,2,2
" 01","CASCO ANTIGUO","URUGUAY","TOTAL POBLACION",0,2,2
" 01","CASCO ANTIGUO","VENEZUELA","ESPA�OLES",1,1,2
" 01","CASCO ANTIGUO","VENEZUELA","EXTRANJEROS",2,6,8
" 01","CASCO ANTIGUO","VENEZUELA","TOTAL POBLACION",3,7,10
" 02","MACARENA","- TODOS -","ESPA�OLES",696,734,1430
" 02","MACARENA","- TODOS -","EXTRANJEROS",432,493,925
" 02","MACARENA","- TODOS -","TOTAL POBLACION",1128,1227,2355
" 02","MACARENA","ALEMANIA","ESPA�OLES",4,0,4
" 02","MACARENA","ALEMANIA","EXTRANJEROS",3,0,3
" 02","MACARENA","ALEMANIA","TOTAL POBLACION",7,0,7
" 02","MACARENA","ARGELIA","EXTRANJEROS",2,0,2
" 02","MACARENA","ARGELIA","TOTAL POBLACION",2,0,2
" 02","MACARENA","ARGENTINA","EXTRANJEROS",6,1,7
" 02","MACARENA","ARGENTINA","TOTAL POBLACION",6,1,7
" 02","MACARENA","ARMENIA","EXTRANJEROS",1,0,1
" 02","MACARENA","ARMENIA","TOTAL POBLACION",1,0,1
" 02","MACARENA","AZERBAIYAN","EXTRANJEROS",2,1,3
" 02","MACARENA","AZERBAIYAN","TOTAL POBLACION",2,1,3
" 02","MACARENA","BELGICA","ESPA�OLES",2,1,3
" 02","MACARENA","BELGICA","TOTAL POBLACION",2,1,3
" 02","MACARENA","BOLIVIA","ESPA�OLES",2,2,4
" 02","MACARENA","BOLIVIA","EXTRANJEROS",18,17,35
" 02","MACARENA","BOLIVIA","TOTAL POBLACION",20,19,39
" 02","MACARENA","BRASIL","ESPA�OLES",1,0,1
" 02","MACARENA","BRASIL","EXTRANJEROS",2,5,7
" 02","MACARENA","BRASIL","TOTAL POBLACION",3,5,8
" 02","MACARENA","BULGARIA","EXTRANJEROS",2,2,4
" 02","MACARENA","BULGARIA","TOTAL POBLACION",2,2,4
" 02","MACARENA","CABO VERDE","EXTRANJEROS",1,0,1
" 02","MACARENA","CABO VERDE","TOTAL POBLACION",1,0,1
" 02","MACARENA","CAMERUN","EXTRANJEROS",1,1,2
" 02","MACARENA","CAMERUN","TOTAL POBLACION",1,1,2
" 02","MACARENA","CANADA","EXTRANJEROS",1,2,3
" 02","MACARENA","CANADA","TOTAL POBLACION",1,2,3
" 02","MACARENA","CHILE","ESPA�OLES",1,0,1
" 02","MACARENA","CHILE","TOTAL POBLACION",1,0,1
" 02","MACARENA","CHINA","EXTRANJEROS",8,5,13
" 02","MACARENA","CHINA","TOTAL POBLACION",8,5,13
" 02","MACARENA","CHIPRE","EXTRANJEROS",1,1,2
" 02","MACARENA","CHIPRE","TOTAL POBLACION",1,1,2
" 02","MACARENA","COLOMBIA","ESPA�OLES",2,0,2
" 02","MACARENA","COLOMBIA","EXTRANJEROS",8,14,22
" 02","MACARENA","COLOMBIA","TOTAL POBLACION",10,14,24
" 02","MACARENA","COSTA RICA","ESPA�OLES",1,1,2
" 02","MACARENA","COSTA RICA","EXTRANJEROS",1,1,2
" 02","MACARENA","COSTA RICA","TOTAL POBLACION",2,2,4
" 02","MACARENA","CUBA","ESPA�OLES",1,3,4
" 02","MACARENA","CUBA","EXTRANJEROS",1,2,3
" 02","MACARENA","CUBA","TOTAL POBLACION",2,5,7
" 02","MACARENA","ECUADOR","ESPA�OLES",5,10,15
" 02","MACARENA","ECUADOR","EXTRANJEROS",3,2,5
" 02","MACARENA","ECUADOR","TOTAL POBLACION",8,12,20
" 02","MACARENA","EGIPTO","EXTRANJEROS",0,1,1
" 02","MACARENA","EGIPTO","TOTAL POBLACION",0,1,1
" 02","MACARENA","EL SALVADOR","EXTRANJEROS",2,3,5
" 02","MACARENA","EL SALVADOR","TOTAL POBLACION",2,3,5
" 02","MACARENA","EMIRATOS ARABES UNIDOS","ESPA�OLES",1,0,1
" 02","MACARENA","EMIRATOS ARABES UNIDOS","TOTAL POBLACION",1,0,1
" 02","MACARENA","ESPA�A","ESPA�OLES",654,699,1353
" 02","MACARENA","ESPA�A","EXTRANJEROS",227,237,464
" 02","MACARENA","ESPA�A","TOTAL POBLACION",881,936,1817
" 02","MACARENA","ESTADOS UNIDOS DE AMERICA","ESPA�OLES",5,2,7
" 02","MACARENA","ESTADOS UNIDOS DE AMERICA","EXTRANJEROS",2,1,3
" 02","MACARENA","ESTADOS UNIDOS DE AMERICA","TOTAL POBLACION",7,3,10
" 02","MACARENA","FILIPINAS","EXTRANJEROS",1,6,7
" 02","MACARENA","FILIPINAS","TOTAL POBLACION",1,6,7
" 02","MACARENA","FRANCIA","ESPA�OLES",1,1,2
" 02","MACARENA","FRANCIA","EXTRANJEROS",5,2,7
" 02","MACARENA","FRANCIA","TOTAL POBLACION",6,3,9
" 02","MACARENA","GABON","EXTRANJEROS",0,1,1
" 02","MACARENA","GABON","TOTAL POBLACION",0,1,1
" 02","MACARENA","GEORGIA","EXTRANJEROS",2,1,3
" 02","MACARENA","GEORGIA","TOTAL POBLACION",2,1,3
" 02","MACARENA","GHANA","EXTRANJEROS",1,0,1
" 02","MACARENA","GHANA","TOTAL POBLACION",1,0,1
" 02","MACARENA","GUATEMALA","EXTRANJEROS",4,0,4
" 02","MACARENA","GUATEMALA","TOTAL POBLACION",4,0,4
" 02","MACARENA","GUINEA","EXTRANJEROS",0,1,1
" 02","MACARENA","GUINEA","TOTAL POBLACION",0,1,1
" 02","MACARENA","GUINEA ECUATORIAL","EXTRANJEROS",0,2,2
" 02","MACARENA","GUINEA ECUATORIAL","TOTAL POBLACION",0,2,2
" 02","MACARENA","HONDURAS","EXTRANJEROS",4,6,10
" 02","MACARENA","HONDURAS","TOTAL POBLACION",4,6,10
" 02","MACARENA","HUNGRIA","EXTRANJEROS",2,1,3
" 02","MACARENA","HUNGRIA","TOTAL POBLACION",2,1,3
" 02","MACARENA","ITALIA","ESPA�OLES",0,1,1
" 02","MACARENA","ITALIA","EXTRANJEROS",8,5,13
" 02","MACARENA","ITALIA","TOTAL POBLACION",8,6,14
" 02","MACARENA","JORDANIA","EXTRANJEROS",0,1,1
" 02","MACARENA","JORDANIA","TOTAL POBLACION",0,1,1
" 02","MACARENA","KENIA","EXTRANJEROS",1,1,2
" 02","MACARENA","KENIA","TOTAL POBLACION",1,1,2
" 02","MACARENA","LIBANO","EXTRANJEROS",1,0,1
" 02","MACARENA","LIBANO","TOTAL POBLACION",1,0,1
" 02","MACARENA","LITUANIA","EXTRANJEROS",1,0,1
" 02","MACARENA","LITUANIA","TOTAL POBLACION",1,0,1
" 02","MACARENA","LUXEMBURGO","ESPA�OLES",0,1,1
" 02","MACARENA","LUXEMBURGO","TOTAL POBLACION",0,1,1
" 02","MACARENA","MARRUECOS","ESPA�OLES",2,0,2
" 02","MACARENA","MARRUECOS","EXTRANJEROS",18,15,33
" 02","MACARENA","MARRUECOS","TOTAL POBLACION",20,15,35
" 02","MACARENA","MEXICO","ESPA�OLES",1,1,2
" 02","MACARENA","MEXICO","EXTRANJEROS",1,0,1
" 02","MACARENA","MEXICO","TOTAL POBLACION",2,1,3
" 02","MACARENA","MOLDAVIA","EXTRANJEROS",1,1,2
" 02","MACARENA","MOLDAVIA","TOTAL POBLACION",1,1,2
" 02","MACARENA","NEPAL","EXTRANJEROS",1,0,1
" 02","MACARENA","NEPAL","TOTAL POBLACION",1,0,1
" 02","MACARENA","NICARAGUA","ESPA�OLES",2,0,2
" 02","MACARENA","NICARAGUA","EXTRANJEROS",16,71,87
" 02","MACARENA","NICARAGUA","TOTAL POBLACION",18,71,89
" 02","MACARENA","NIGERIA","EXTRANJEROS",3,2,5
" 02","MACARENA","NIGERIA","TOTAL POBLACION",3,2,5
" 02","MACARENA","PAISES BAJOS","EXTRANJEROS",0,1,1
" 02","MACARENA","PAISES BAJOS","TOTAL POBLACION",0,1,1
" 02","MACARENA","PAKISTAN","EXTRANJEROS",1,0,1
" 02","MACARENA","PAKISTAN","TOTAL POBLACION",1,0,1
" 02","MACARENA","PARAGUAY","EXTRANJEROS",2,5,7
" 02","MACARENA","PARAGUAY","TOTAL POBLACION",2,5,7
" 02","MACARENA","PERU","ESPA�OLES",3,6,9
" 02","MACARENA","PERU","EXTRANJEROS",8,7,15
" 02","MACARENA","PERU","TOTAL POBLACION",11,13,24
" 02","MACARENA","POLONIA","EXTRANJEROS",0,2,2
" 02","MACARENA","POLONIA","TOTAL POBLACION",0,2,2
" 02","MACARENA","PORTUGAL","EXTRANJEROS",5,2,7
" 02","MACARENA","PORTUGAL","TOTAL POBLACION",5,2,7
" 02","MACARENA","REINO UNIDO","ESPA�OLES",2,2,4
" 02","MACARENA","REINO UNIDO","EXTRANJEROS",2,0,2
" 02","MACARENA","REINO UNIDO","TOTAL POBLACION",4,2,6
" 02","MACARENA","REPUBLICA DOMINICANA","ESPA�OLES",1,0,1
" 02","MACARENA","REPUBLICA DOMINICANA","EXTRANJEROS",3,8,11
" 02","MACARENA","REPUBLICA DOMINICANA","TOTAL POBLACION",4,8,12
" 02","MACARENA","RUMANIA","EXTRANJEROS",25,24,49
" 02","MACARENA","RUMANIA","TOTAL POBLACION",25,24,49
" 02","MACARENA","RUSIA","EXTRANJEROS",3,6,9
" 02","MACARENA","RUSIA","TOTAL POBLACION",3,6,9
" 02","MACARENA","SENEGAL","EXTRANJEROS",5,1,6
" 02","MACARENA","SENEGAL","TOTAL POBLACION",5,1,6
" 02","MACARENA","SERBIA","EXTRANJEROS",0,1,1
" 02","MACARENA","SERBIA","TOTAL POBLACION",0,1,1
" 02","MACARENA","SIRIA","ESPA�OLES",1,1,2
" 02","MACARENA","SIRIA","EXTRANJEROS",1,0,1
" 02","MACARENA","SIRIA","TOTAL POBLACION",2,1,3
" 02","MACARENA","UCRANIA","EXTRANJEROS",8,14,22
" 02","MACARENA","UCRANIA","TOTAL POBLACION",8,14,22
" 02","MACARENA","VENEZUELA","ESPA�OLES",4,3,7
" 02","MACARENA","VENEZUELA","EXTRANJEROS",7,10,17
" 02","MACARENA","VENEZUELA","TOTAL POBLACION",11,13,24
" 03","NERVION","- TODOS -","ESPA�OLES",496,583,1079
" 03","NERVION","- TODOS -","EXTRANJEROS",113,144,257
" 03","NERVION","- TODOS -","TOTAL POBLACION",609,727,1336
" 03","NERVION","AFGANISTAN","EXTRANJEROS",1,0,1
" 03","NERVION","AFGANISTAN","TOTAL POBLACION",1,0,1
" 03","NERVION","ALEMANIA","ESPA�OLES",0,2,2
" 03","NERVION","ALEMANIA","EXTRANJEROS",0,1,1
" 03","NERVION","ALEMANIA","TOTAL POBLACION",0,3,3
" 03","NERVION","ARGELIA","EXTRANJEROS",1,0,1
" 03","NERVION","ARGELIA","TOTAL POBLACION",1,0,1
" 03","NERVION","ARGENTINA","ESPA�OLES",1,0,1
" 03","NERVION","ARGENTINA","EXTRANJEROS",2,2,4
" 03","NERVION","ARGENTINA","TOTAL POBLACION",3,2,5
" 03","NERVION","AUSTRIA","EXTRANJEROS",0,1,1
" 03","NERVION","AUSTRIA","TOTAL POBLACION",0,1,1
" 03","NERVION","BELGICA","EXTRANJEROS",2,0,2
" 03","NERVION","BELGICA","TOTAL POBLACION",2,0,2
" 03","NERVION","BOLIVIA","ESPA�OLES",1,0,1
" 03","NERVION","BOLIVIA","EXTRANJEROS",1,4,5
" 03","NERVION","BOLIVIA","TOTAL POBLACION",2,4,6
" 03","NERVION","BRASIL","EXTRANJEROS",2,6,8
" 03","NERVION","BRASIL","TOTAL POBLACION",2,6,8
" 03","NERVION","CAMERUN","EXTRANJEROS",2,0,2
" 03","NERVION","CAMERUN","TOTAL POBLACION",2,0,2
" 03","NERVION","CANADA","EXTRANJEROS",1,0,1
" 03","NERVION","CANADA","TOTAL POBLACION",1,0,1
" 03","NERVION","CHILE","ESPA�OLES",2,1,3
" 03","NERVION","CHILE","EXTRANJEROS",0,1,1
" 03","NERVION","CHILE","TOTAL POBLACION",2,2,4
" 03","NERVION","CHINA","EXTRANJEROS",11,10,21
" 03","NERVION","CHINA","TOTAL POBLACION",11,10,21
" 03","NERVION","COLOMBIA","EXTRANJEROS",0,4,4
" 03","NERVION","COLOMBIA","TOTAL POBLACION",0,4,4
" 03","NERVION","ECUADOR","ESPA�OLES",1,0,1
" 03","NERVION","ECUADOR","TOTAL POBLACION",1,0,1
" 03","NERVION","ESPA�A","ESPA�OLES",477,559,1036
" 03","NERVION","ESPA�A","EXTRANJEROS",37,60,97
" 03","NERVION","ESPA�A","TOTAL POBLACION",514,619,1133
" 03","NERVION","ESTADOS UNIDOS DE AMERICA","ESPA�OLES",9,4,13
" 03","NERVION","ESTADOS UNIDOS DE AMERICA","EXTRANJEROS",4,3,7
" 03","NERVION","ESTADOS UNIDOS DE AMERICA","TOTAL POBLACION",13,7,20
" 03","NERVION","ETIOPIA","EXTRANJEROS",1,0,1
" 03","NERVION","ETIOPIA","TOTAL POBLACION",1,0,1
" 03","NERVION","FRANCIA","ESPA�OLES",2,4,6
" 03","NERVION","FRANCIA","EXTRANJEROS",5,4,9
" 03","NERVION","FRANCIA","TOTAL POBLACION",7,8,15
" 03","NERVION","GEORGIA","EXTRANJEROS",1,0,1
" 03","NERVION","GEORGIA","TOTAL POBLACION",1,0,1
" 03","NERVION","GUINEA ECUATORIAL","ESPA�OLES",1,2,3
" 03","NERVION","GUINEA ECUATORIAL","EXTRANJEROS",0,1,1
" 03","NERVION","GUINEA ECUATORIAL","TOTAL POBLACION",1,3,4
" 03","NERVION","HONDURAS","EXTRANJEROS",0,2,2
" 03","NERVION","HONDURAS","TOTAL POBLACION",0,2,2
" 03","NERVION","ISRAEL","ESPA�OLES",0,1,1
" 03","NERVION","ISRAEL","EXTRANJEROS",1,0,1
" 03","NERVION","ISRAEL","TOTAL POBLACION",1,1,2
" 03","NERVION","ITALIA","EXTRANJEROS",8,10,18
" 03","NERVION","ITALIA","TOTAL POBLACION",8,10,18
" 03","NERVION","JAPON","EXTRANJEROS",0,1,1
" 03","NERVION","JAPON","TOTAL POBLACION",0,1,1
" 03","NERVION","KAZAJSTAN","ESPA�OLES",1,0,1
" 03","NERVION","KAZAJSTAN","TOTAL POBLACION",1,0,1
" 03","NERVION","LIBANO","EXTRANJEROS",2,0,2
" 03","NERVION","LIBANO","TOTAL POBLACION",2,0,2
" 03","NERVION","MARRUECOS","ESPA�OLES",0,3,3
" 03","NERVION","MARRUECOS","EXTRANJEROS",5,0,5
" 03","NERVION","MARRUECOS","TOTAL POBLACION",5,3,8
" 03","NERVION","MEXICO","EXTRANJEROS",2,1,3
" 03","NERVION","MEXICO","TOTAL POBLACION",2,1,3
" 03","NERVION","NICARAGUA","EXTRANJEROS",1,8,9
" 03","NERVION","NICARAGUA","TOTAL POBLACION",1,8,9
" 03","NERVION","NORUEGA","EXTRANJEROS",2,2,4
" 03","NERVION","NORUEGA","TOTAL POBLACION",2,2,4
" 03","NERVION","PAISES BAJOS","ESPA�OLES",0,1,1
" 03","NERVION","PAISES BAJOS","TOTAL POBLACION",0,1,1
" 03","NERVION","PAKISTAN","EXTRANJEROS",2,1,3
" 03","NERVION","PAKISTAN","TOTAL POBLACION",2,1,3
" 03","NERVION","PALESTINA. ESTADO OBSERVADOR, NO MIEMBRO DE NACIONES UNIDAS","EXTRANJEROS",1,0,1
" 03","NERVION","PALESTINA. ESTADO OBSERVADOR, NO MIEMBRO DE NACIONES UNIDAS","TOTAL POBLACION",1,0,1
" 03","NERVION","PARAGUAY","EXTRANJEROS",2,2,4
" 03","NERVION","PARAGUAY","TOTAL POBLACION",2,2,4
" 03","NERVION","PERU","ESPA�OLES",0,1,1
" 03","NERVION","PERU","EXTRANJEROS",2,2,4
" 03","NERVION","PERU","TOTAL POBLACION",2,3,5
" 03","NERVION","PORTUGAL","ESPA�OLES",0,1,1
" 03","NERVION","PORTUGAL","EXTRANJEROS",1,1,2
" 03","NERVION","PORTUGAL","TOTAL POBLACION",1,2,3
" 03","NERVION","REINO UNIDO","ESPA�OLES",0,2,2
" 03","NERVION","REINO UNIDO","EXTRANJEROS",1,0,1
" 03","NERVION","REINO UNIDO","TOTAL POBLACION",1,2,3
" 03","NERVION","REPUBLICA DE COREA","EXTRANJEROS",3,2,5
" 03","NERVION","REPUBLICA DE COREA","TOTAL POBLACION",3,2,5
" 03","NERVION","REPUBLICA DOMINICANA","EXTRANJEROS",0,3,3
" 03","NERVION","REPUBLICA DOMINICANA","TOTAL POBLACION",0,3,3
" 03","NERVION","REPUBLICA SUDAFRICANA","ESPA�OLES",0,1,1
" 03","NERVION","REPUBLICA SUDAFRICANA","TOTAL POBLACION",0,1,1
" 03","NERVION","RUSIA","EXTRANJEROS",0,2,2
" 03","NERVION","RUSIA","TOTAL POBLACION",0,2,2
" 03","NERVION","SERBIA","EXTRANJEROS",0,1,1
" 03","NERVION","SERBIA","TOTAL POBLACION",0,1,1
" 03","NERVION","SUECIA","EXTRANJEROS",1,0,1
" 03","NERVION","SUECIA","TOTAL POBLACION",1,0,1
" 03","NERVION","SUIZA","ESPA�OLES",0,1,1
" 03","NERVION","SUIZA","TOTAL POBLACION",0,1,1
" 03","NERVION","TCHAD","EXTRANJEROS",1,0,1
" 03","NERVION","TCHAD","TOTAL POBLACION",1,0,1
" 03","NERVION","UCRANIA","EXTRANJEROS",0,1,1
" 03","NERVION","UCRANIA","TOTAL POBLACION",0,1,1
" 03","NERVION","URUGUAY","EXTRANJEROS",2,4,6
" 03","NERVION","URUGUAY","TOTAL POBLACION",2,4,6
" 03","NERVION","VENEZUELA","ESPA�OLES",1,0,1
" 03","NERVION","VENEZUELA","EXTRANJEROS",5,4,9
" 03","NERVION","VENEZUELA","TOTAL POBLACION",6,4,10
" 04","CERRO-AMATE","- TODOS -","ESPA�OLES",601,588,1189
" 04","CERRO-AMATE","- TODOS -","EXTRANJEROS",340,359,699
" 04","CERRO-AMATE","- TODOS -","TOTAL POBLACION",941,947,1888
" 04","CERRO-AMATE","ALEMANIA","ESPA�OLES",1,0,1
" 04","CERRO-AMATE","ALEMANIA","TOTAL POBLACION",1,0,1
" 04","CERRO-AMATE","ARGELIA","EXTRANJEROS",2,0,2
" 04","CERRO-AMATE","ARGELIA","TOTAL POBLACION",2,0,2
" 04","CERRO-AMATE","ARGENTINA","ESPA�OLES",1,0,1
" 04","CERRO-AMATE","ARGENTINA","EXTRANJEROS",1,2,3
" 04","CERRO-AMATE","ARGENTINA","TOTAL POBLACION",2,2,4
" 04","CERRO-AMATE","ARMENIA","EXTRANJEROS",0,1,1
" 04","CERRO-AMATE","ARMENIA","TOTAL POBLACION",0,1,1
" 04","CERRO-AMATE","BELGICA","EXTRANJEROS",0,3,3
" 04","CERRO-AMATE","BELGICA","TOTAL POBLACION",0,3,3
" 04","CERRO-AMATE","BOLIVIA","EXTRANJEROS",6,7,13
" 04","CERRO-AMATE","BOLIVIA","TOTAL POBLACION",6,7,13
" 04","CERRO-AMATE","BRASIL","ESPA�OLES",0,1,1
" 04","CERRO-AMATE","BRASIL","EXTRANJEROS",1,3,4
" 04","CERRO-AMATE","BRASIL","TOTAL POBLACION",1,4,5
" 04","CERRO-AMATE","BULGARIA","EXTRANJEROS",1,0,1
" 04","CERRO-AMATE","BULGARIA","TOTAL POBLACION",1,0,1
" 04","CERRO-AMATE","CANADA","ESPA�OLES",1,0,1
" 04","CERRO-AMATE","CANADA","TOTAL POBLACION",1,0,1
" 04","CERRO-AMATE","CHINA","EXTRANJEROS",7,11,18
" 04","CERRO-AMATE","CHINA","TOTAL POBLACION",7,11,18
" 04","CERRO-AMATE","COLOMBIA","ESPA�OLES",2,4,6
" 04","CERRO-AMATE","COLOMBIA","EXTRANJEROS",8,7,15
" 04","CERRO-AMATE","COLOMBIA","TOTAL POBLACION",10,11,21
" 04","CERRO-AMATE","CUBA","ESPA�OLES",4,8,12
" 04","CERRO-AMATE","CUBA","EXTRANJEROS",6,8,14
" 04","CERRO-AMATE","CUBA","TOTAL POBLACION",10,16,26
" 04","CERRO-AMATE","EL SALVADOR","EXTRANJEROS",1,4,5
" 04","CERRO-AMATE","EL SALVADOR","TOTAL POBLACION",1,4,5
" 04","CERRO-AMATE","ESPA�A","ESPA�OLES",582,560,1142
" 04","CERRO-AMATE","ESPA�A","EXTRANJEROS",212,194,406
" 04","CERRO-AMATE","ESPA�A","TOTAL POBLACION",794,754,1548
" 04","CERRO-AMATE","ESTADOS UNIDOS DE AMERICA","ESPA�OLES",2,2,4
" 04","CERRO-AMATE","ESTADOS UNIDOS DE AMERICA","EXTRANJEROS",0,2,2
" 04","CERRO-AMATE","ESTADOS UNIDOS DE AMERICA","TOTAL POBLACION",2,4,6
" 04","CERRO-AMATE","FRANCIA","ESPA�OLES",3,2,5
" 04","CERRO-AMATE","FRANCIA","EXTRANJEROS",0,2,2
" 04","CERRO-AMATE","FRANCIA","TOTAL POBLACION",3,4,7
" 04","CERRO-AMATE","GEORGIA","EXTRANJEROS",2,0,2
" 04","CERRO-AMATE","GEORGIA","TOTAL POBLACION",2,0,2
" 04","CERRO-AMATE","GUATEMALA","EXTRANJEROS",0,1,1
" 04","CERRO-AMATE","GUATEMALA","TOTAL POBLACION",0,1,1
" 04","CERRO-AMATE","GUINEA ECUATORIAL","ESPA�OLES",1,0,1
" 04","CERRO-AMATE","GUINEA ECUATORIAL","TOTAL POBLACION",1,0,1
" 04","CERRO-AMATE","HAITI","EXTRANJEROS",1,0,1
" 04","CERRO-AMATE","HAITI","TOTAL POBLACION",1,0,1
" 04","CERRO-AMATE","HONDURAS","ESPA�OLES",1,0,1
" 04","CERRO-AMATE","HONDURAS","EXTRANJEROS",2,10,12
" 04","CERRO-AMATE","HONDURAS","TOTAL POBLACION",3,10,13
" 04","CERRO-AMATE","IRLANDA","EXTRANJEROS",1,0,1
" 04","CERRO-AMATE","IRLANDA","TOTAL POBLACION",1,0,1
" 04","CERRO-AMATE","ITALIA","EXTRANJEROS",2,3,5
" 04","CERRO-AMATE","ITALIA","TOTAL POBLACION",2,3,5
" 04","CERRO-AMATE","MALI","EXTRANJEROS",1,0,1
" 04","CERRO-AMATE","MALI","TOTAL POBLACION",1,0,1
" 04","CERRO-AMATE","MALTA","ESPA�OLES",0,1,1
" 04","CERRO-AMATE","MALTA","TOTAL POBLACION",0,1,1
" 04","CERRO-AMATE","MARRUECOS","EXTRANJEROS",20,29,49
" 04","CERRO-AMATE","MARRUECOS","TOTAL POBLACION",20,29,49
" 04","CERRO-AMATE","MEXICO","EXTRANJEROS",4,0,4
" 04","CERRO-AMATE","MEXICO","TOTAL POBLACION",4,0,4
" 04","CERRO-AMATE","MOLDAVIA","EXTRANJEROS",0,1,1
" 04","CERRO-AMATE","MOLDAVIA","TOTAL POBLACION",0,1,1
" 04","CERRO-AMATE","NICARAGUA","EXTRANJEROS",3,12,15
" 04","CERRO-AMATE","NICARAGUA","TOTAL POBLACION",3,12,15
" 04","CERRO-AMATE","NIGERIA","EXTRANJEROS",3,4,7
" 04","CERRO-AMATE","NIGERIA","TOTAL POBLACION",3,4,7
" 04","CERRO-AMATE","OTROS PAISES SIN RELACION DIPLOMATICA","EXTRANJEROS",1,0,1
" 04","CERRO-AMATE","OTROS PAISES SIN RELACION DIPLOMATICA","TOTAL POBLACION",1,0,1
" 04","CERRO-AMATE","PAISES BAJOS","ESPA�OLES",0,1,1
" 04","CERRO-AMATE","PAISES BAJOS","EXTRANJEROS",1,1,2
" 04","CERRO-AMATE","PAISES BAJOS","TOTAL POBLACION",1,2,3
" 04","CERRO-AMATE","PAKISTAN","EXTRANJEROS",0,1,1
" 04","CERRO-AMATE","PAKISTAN","TOTAL POBLACION",0,1,1
" 04","CERRO-AMATE","PARAGUAY","EXTRANJEROS",2,9,11
" 04","CERRO-AMATE","PARAGUAY","TOTAL POBLACION",2,9,11
" 04","CERRO-AMATE","PERU","ESPA�OLES",2,4,6
" 04","CERRO-AMATE","PERU","EXTRANJEROS",1,4,5
" 04","CERRO-AMATE","PERU","TOTAL POBLACION",3,8,11
" 04","CERRO-AMATE","POLONIA","EXTRANJEROS",0,1,1
" 04","CERRO-AMATE","POLONIA","TOTAL POBLACION",0,1,1
" 04","CERRO-AMATE","PORTUGAL","ESPA�OLES",0,1,1
" 04","CERRO-AMATE","PORTUGAL","EXTRANJEROS",3,0,3
" 04","CERRO-AMATE","PORTUGAL","TOTAL POBLACION",3,1,4
" 04","CERRO-AMATE","REINO UNIDO","ESPA�OLES",1,4,5
" 04","CERRO-AMATE","REINO UNIDO","EXTRANJEROS",2,2,4
" 04","CERRO-AMATE","REINO UNIDO","TOTAL POBLACION",3,6,9
" 04","CERRO-AMATE","REPUBLICA CHECA","EXTRANJEROS",1,0,1
" 04","CERRO-AMATE","REPUBLICA CHECA","TOTAL POBLACION",1,0,1
" 04","CERRO-AMATE","REPUBLICA DE COREA","EXTRANJEROS",1,1,2
" 04","CERRO-AMATE","REPUBLICA DE COREA","TOTAL POBLACION",1,1,2
" 04","CERRO-AMATE","REPUBLICA DOMINICANA","EXTRANJEROS",0,5,5
" 04","CERRO-AMATE","REPUBLICA DOMINICANA","TOTAL POBLACION",0,5,5
" 04","CERRO-AMATE","RUMANIA","EXTRANJEROS",32,22,54
" 04","CERRO-AMATE","RUMANIA","TOTAL POBLACION",32,22,54
" 04","CERRO-AMATE","RUSIA","EXTRANJEROS",2,3,5
" 04","CERRO-AMATE","RUSIA","TOTAL POBLACION",2,3,5
" 04","CERRO-AMATE","SENEGAL","EXTRANJEROS",4,0,4
" 04","CERRO-AMATE","SENEGAL","TOTAL POBLACION",4,0,4
" 04","CERRO-AMATE","UCRANIA","EXTRANJEROS",1,3,4
" 04","CERRO-AMATE","UCRANIA","TOTAL POBLACION",1,3,4
" 04","CERRO-AMATE","URUGUAY","EXTRANJEROS",1,0,1
" 04","CERRO-AMATE","URUGUAY","TOTAL POBLACION",1,0,1
" 04","CERRO-AMATE","VENEZUELA","EXTRANJEROS",4,3,7
" 04","CERRO-AMATE","VENEZUELA","TOTAL POBLACION",4,3,7
" 05","SUR","- TODOS -","ESPA�OLES",707,715,1422
" 05","SUR","- TODOS -","EXTRANJEROS",149,209,358
" 05","SUR","- TODOS -","TOTAL POBLACION",856,924,1780
" 05","SUR","ALEMANIA","ESPA�OLES",2,3,5
" 05","SUR","ALEMANIA","TOTAL POBLACION",2,3,5
" 05","SUR","ARGELIA","EXTRANJEROS",1,0,1
" 05","SUR","ARGELIA","TOTAL POBLACION",1,0,1
" 05","SUR","ARGENTINA","ESPA�OLES",0,2,2
" 05","SUR","ARGENTINA","EXTRANJEROS",0,1,1
" 05","SUR","ARGENTINA","TOTAL POBLACION",0,3,3
" 05","SUR","AUSTRALIA","ESPA�OLES",1,0,1
" 05","SUR","AUSTRALIA","TOTAL POBLACION",1,0,1
" 05","SUR","BELGICA","ESPA�OLES",1,0,1
" 05","SUR","BELGICA","TOTAL POBLACION",1,0,1
" 05","SUR","BIELORUSIA","EXTRANJEROS",0,1,1
" 05","SUR","BIELORUSIA","TOTAL POBLACION",0,1,1
" 05","SUR","BOLIVIA","EXTRANJEROS",0,4,4
" 05","SUR","BOLIVIA","TOTAL POBLACION",0,4,4
" 05","SUR","BRASIL","EXTRANJEROS",5,3,8
" 05","SUR","BRASIL","TOTAL POBLACION",5,3,8
" 05","SUR","BULGARIA","EXTRANJEROS",0,1,1
" 05","SUR","BULGARIA","TOTAL POBLACION",0,1,1
" 05","SUR","CHILE","EXTRANJEROS",1,0,1
" 05","SUR","CHILE","TOTAL POBLACION",1,0,1
" 05","SUR","CHINA","ESPA�OLES",1,2,3
" 05","SUR","CHINA","EXTRANJEROS",1,10,11
" 05","SUR","CHINA","TOTAL POBLACION",2,12,14
" 05","SUR","COLOMBIA","ESPA�OLES",1,0,1
" 05","SUR","COLOMBIA","EXTRANJEROS",0,5,5
" 05","SUR","COLOMBIA","TOTAL POBLACION",1,5,6
" 05","SUR","COSTA DE MARFIL","EXTRANJEROS",1,0,1
" 05","SUR","COSTA DE MARFIL","TOTAL POBLACION",1,0,1
" 05","SUR","COSTA RICA","EXTRANJEROS",1,0,1
" 05","SUR","COSTA RICA","TOTAL POBLACION",1,0,1
" 05","SUR","CUBA","EXTRANJEROS",4,0,4
" 05","SUR","CUBA","TOTAL POBLACION",4,0,4
" 05","SUR","ECUADOR","ESPA�OLES",0,3,3
" 05","SUR","ECUADOR","EXTRANJEROS",2,2,4
" 05","SUR","ECUADOR","TOTAL POBLACION",2,5,7
" 05","SUR","EL SALVADOR","EXTRANJEROS",0,4,4
" 05","SUR","EL SALVADOR","TOTAL POBLACION",0,4,4
" 05","SUR","EMIRATOS ARABES UNIDOS","ESPA�OLES",0,1,1
" 05","SUR","EMIRATOS ARABES UNIDOS","TOTAL POBLACION",0,1,1
" 05","SUR","ESPA�A","ESPA�OLES",679,681,1360
" 05","SUR","ESPA�A","EXTRANJEROS",85,102,187
" 05","SUR","ESPA�A","TOTAL POBLACION",764,783,1547
" 05","SUR","ESTADOS UNIDOS DE AMERICA","ESPA�OLES",7,8,15
" 05","SUR","ESTADOS UNIDOS DE AMERICA","EXTRANJEROS",0,1,1
" 05","SUR","ESTADOS UNIDOS DE AMERICA","TOTAL POBLACION",7,9,16
" 05","SUR","FILIPINAS","EXTRANJEROS",0,2,2
" 05","SUR","FILIPINAS","TOTAL POBLACION",0,2,2
" 05","SUR","FRANCIA","ESPA�OLES",4,5,9
" 05","SUR","FRANCIA","EXTRANJEROS",2,0,2
" 05","SUR","FRANCIA","TOTAL POBLACION",6,5,11
" 05","SUR","GABON","EXTRANJEROS",2,0,2
" 05","SUR","GABON","TOTAL POBLACION",2,0,2
" 05","SUR","GEORGIA","EXTRANJEROS",1,1,2
" 05","SUR","GEORGIA","TOTAL POBLACION",1,1,2
" 05","SUR","GUINEA ECUATORIAL","EXTRANJEROS",0,1,1
" 05","SUR","GUINEA ECUATORIAL","TOTAL POBLACION",0,1,1
" 05","SUR","HONDURAS","EXTRANJEROS",0,4,4
" 05","SUR","HONDURAS","TOTAL POBLACION",0,4,4
" 05","SUR","IRAN","EXTRANJEROS",1,0,1
" 05","SUR","IRAN","TOTAL POBLACION",1,0,1
" 05","SUR","IRLANDA","ESPA�OLES",0,1,1
" 05","SUR","IRLANDA","TOTAL POBLACION",0,1,1
" 05","SUR","ITALIA","EXTRANJEROS",2,0,2
" 05","SUR","ITALIA","TOTAL POBLACION",2,0,2
" 05","SUR","JAPON","EXTRANJEROS",1,1,2
" 05","SUR","JAPON","TOTAL POBLACION",1,1,2
" 05","SUR","LITUANIA","EXTRANJEROS",0,1,1
" 05","SUR","LITUANIA","TOTAL POBLACION",0,1,1
" 05","SUR","MARRUECOS","ESPA�OLES",1,1,2
" 05","SUR","MARRUECOS","EXTRANJEROS",4,6,10
" 05","SUR","MARRUECOS","TOTAL POBLACION",5,7,12
" 05","SUR","MEXICO","ESPA�OLES",1,0,1
" 05","SUR","MEXICO","EXTRANJEROS",1,4,5
" 05","SUR","MEXICO","TOTAL POBLACION",2,4,6
" 05","SUR","MOZAMBIQUE","ESPA�OLES",0,1,1
" 05","SUR","MOZAMBIQUE","TOTAL POBLACION",0,1,1
" 05","SUR","NICARAGUA","EXTRANJEROS",7,21,28
" 05","SUR","NICARAGUA","TOTAL POBLACION",7,21,28
" 05","SUR","NIGERIA","EXTRANJEROS",3,4,7
" 05","SUR","NIGERIA","TOTAL POBLACION",3,4,7
" 05","SUR","PAISES BAJOS","ESPA�OLES",1,3,4
" 05","SUR","PAISES BAJOS","EXTRANJEROS",0,1,1
" 05","SUR","PAISES BAJOS","TOTAL POBLACION",1,4,5
" 05","SUR","PANAMA","ESPA�OLES",2,1,3
" 05","SUR","PANAMA","EXTRANJEROS",0,2,2
" 05","SUR","PANAMA","TOTAL POBLACION",2,3,5
" 05","SUR","PARAGUAY","EXTRANJEROS",3,6,9
" 05","SUR","PARAGUAY","TOTAL POBLACION",3,6,9
" 05","SUR","PERU","ESPA�OLES",1,0,1
" 05","SUR","PERU","EXTRANJEROS",2,4,6
" 05","SUR","PERU","TOTAL POBLACION",3,4,7
" 05","SUR","POLONIA","EXTRANJEROS",1,1,2
" 05","SUR","POLONIA","TOTAL POBLACION",1,1,2
" 05","SUR","PORTUGAL","ESPA�OLES",1,1,2
" 05","SUR","PORTUGAL","EXTRANJEROS",0,3,3
" 05","SUR","PORTUGAL","TOTAL POBLACION",1,4,5
" 05","SUR","REINO UNIDO","ESPA�OLES",1,0,1
" 05","SUR","REINO UNIDO","TOTAL POBLACION",1,0,1
" 05","SUR","REPUBLICA DOMINICANA","EXTRANJEROS",2,1,3
" 05","SUR","REPUBLICA DOMINICANA","TOTAL POBLACION",2,1,3
" 05","SUR","RUMANIA","EXTRANJEROS",2,3,5
" 05","SUR","RUMANIA","TOTAL POBLACION",2,3,5
" 05","SUR","RUSIA","ESPA�OLES",1,0,1
" 05","SUR","RUSIA","EXTRANJEROS",2,2,4
" 05","SUR","RUSIA","TOTAL POBLACION",3,2,5
" 05","SUR","SENEGAL","EXTRANJEROS",4,0,4
" 05","SUR","SENEGAL","TOTAL POBLACION",4,0,4
" 05","SUR","SINGAPUR","ESPA�OLES",1,0,1
" 05","SUR","SINGAPUR","TOTAL POBLACION",1,0,1
" 05","SUR","TUNEZ","EXTRANJEROS",1,0,1
" 05","SUR","TUNEZ","TOTAL POBLACION",1,0,1
" 05","SUR","UCRANIA","EXTRANJEROS",6,4,10
" 05","SUR","UCRANIA","TOTAL POBLACION",6,4,10
" 05","SUR","VENEZUELA","ESPA�OLES",1,2,3
" 05","SUR","VENEZUELA","EXTRANJEROS",1,2,3
" 05","SUR","VENEZUELA","TOTAL POBLACION",2,4,6
" 05","SUR","VIET-NAM","EXTRANJEROS",0,1,1
" 05","SUR","VIET-NAM","TOTAL POBLACION",0,1,1
" 06","TRIANA","- TODOS -","ESPA�OLES",531,533,1064
" 06","TRIANA","- TODOS -","EXTRANJEROS",116,191,307
" 06","TRIANA","- TODOS -","TOTAL POBLACION",647,724,1371
" 06","TRIANA","ALEMANIA","EXTRANJEROS",2,1,3
" 06","TRIANA","ALEMANIA","TOTAL POBLACION",2,1,3
" 06","TRIANA","ARGELIA","ESPA�OLES",1,1,2
" 06","TRIANA","ARGELIA","EXTRANJEROS",2,0,2
" 06","TRIANA","ARGELIA","TOTAL POBLACION",3,1,4
" 06","TRIANA","ARGENTINA","ESPA�OLES",1,0,1
" 06","TRIANA","ARGENTINA","EXTRANJEROS",3,3,6
" 06","TRIANA","ARGENTINA","TOTAL POBLACION",4,3,7
" 06","TRIANA","AUSTRALIA","EXTRANJEROS",4,4,8
" 06","TRIANA","AUSTRALIA","TOTAL POBLACION",4,4,8
" 06","TRIANA","BOLIVIA","EXTRANJEROS",4,3,7
" 06","TRIANA","BOLIVIA","TOTAL POBLACION",4,3,7
" 06","TRIANA","BRASIL","ESPA�OLES",1,0,1
" 06","TRIANA","BRASIL","EXTRANJEROS",1,6,7
" 06","TRIANA","BRASIL","TOTAL POBLACION",2,6,8
" 06","TRIANA","CAMERUN","ESPA�OLES",0,1,1
" 06","TRIANA","CAMERUN","TOTAL POBLACION",0,1,1
" 06","TRIANA","CHINA","EXTRANJEROS",3,4,7
" 06","TRIANA","CHINA","TOTAL POBLACION",3,4,7
" 06","TRIANA","COLOMBIA","ESPA�OLES",0,1,1
" 06","TRIANA","COLOMBIA","EXTRANJEROS",2,3,5
" 06","TRIANA","COLOMBIA","TOTAL POBLACION",2,4,6
" 06","TRIANA","CUBA","EXTRANJEROS",0,4,4
" 06","TRIANA","CUBA","TOTAL POBLACION",0,4,4
" 06","TRIANA","ECUADOR","ESPA�OLES",1,1,2
" 06","TRIANA","ECUADOR","EXTRANJEROS",1,1,2
" 06","TRIANA","ECUADOR","TOTAL POBLACION",2,2,4
" 06","TRIANA","EGIPTO","EXTRANJEROS",2,2,4
" 06","TRIANA","EGIPTO","TOTAL POBLACION",2,2,4
" 06","TRIANA","EL SALVADOR","EXTRANJEROS",0,2,2
" 06","TRIANA","EL SALVADOR","TOTAL POBLACION",0,2,2
" 06","TRIANA","EMIRATOS ARABES UNIDOS","ESPA�OLES",3,2,5
" 06","TRIANA","EMIRATOS ARABES UNIDOS","TOTAL POBLACION",3,2,5
" 06","TRIANA","ESPA�A","ESPA�OLES",508,510,1018
" 06","TRIANA","ESPA�A","EXTRANJEROS",56,93,149
" 06","TRIANA","ESPA�A","TOTAL POBLACION",564,603,1167
" 06","TRIANA","ESTADOS UNIDOS DE AMERICA","ESPA�OLES",3,3,6
" 06","TRIANA","ESTADOS UNIDOS DE AMERICA","EXTRANJEROS",1,5,6
" 06","TRIANA","ESTADOS UNIDOS DE AMERICA","TOTAL POBLACION",4,8,12
" 06","TRIANA","ETIOPIA","ESPA�OLES",0,1,1
" 06","TRIANA","ETIOPIA","TOTAL POBLACION",0,1,1
" 06","TRIANA","FRANCIA","ESPA�OLES",3,3,6
" 06","TRIANA","FRANCIA","EXTRANJEROS",1,4,5
" 06","TRIANA","FRANCIA","TOTAL POBLACION",4,7,11
" 06","TRIANA","GUATEMALA","EXTRANJEROS",0,2,2
" 06","TRIANA","GUATEMALA","TOTAL POBLACION",0,2,2
" 06","TRIANA","HONDURAS","EXTRANJEROS",0,1,1
" 06","TRIANA","HONDURAS","TOTAL POBLACION",0,1,1
" 06","TRIANA","INDIA","EXTRANJEROS",2,0,2
" 06","TRIANA","INDIA","TOTAL POBLACION",2,0,2
" 06","TRIANA","IRAN","EXTRANJEROS",1,0,1
" 06","TRIANA","IRAN","TOTAL POBLACION",1,0,1
" 06","TRIANA","ISRAEL","EXTRANJEROS",1,0,1
" 06","TRIANA","ISRAEL","TOTAL POBLACION",1,0,1
" 06","TRIANA","ITALIA","ESPA�OLES",1,0,1
" 06","TRIANA","ITALIA","EXTRANJEROS",3,4,7
" 06","TRIANA","ITALIA","TOTAL POBLACION",4,4,8
" 06","TRIANA","JAPON","EXTRANJEROS",0,4,4
" 06","TRIANA","JAPON","TOTAL POBLACION",0,4,4
" 06","TRIANA","LITUANIA","EXTRANJEROS",0,1,1
" 06","TRIANA","LITUANIA","TOTAL POBLACION",0,1,1
" 06","TRIANA","MARRUECOS","ESPA�OLES",1,0,1
" 06","TRIANA","MARRUECOS","EXTRANJEROS",3,3,6
" 06","TRIANA","MARRUECOS","TOTAL POBLACION",4,3,7
" 06","TRIANA","MEXICO","ESPA�OLES",2,3,5
" 06","TRIANA","MEXICO","EXTRANJEROS",1,2,3
" 06","TRIANA","MEXICO","TOTAL POBLACION",3,5,8
" 06","TRIANA","NICARAGUA","EXTRANJEROS",1,4,5
" 06","TRIANA","NICARAGUA","TOTAL POBLACION",1,4,5
" 06","TRIANA","NIGERIA","EXTRANJEROS",1,0,1
" 06","TRIANA","NIGERIA","TOTAL POBLACION",1,0,1
" 06","TRIANA","PAISES BAJOS","ESPA�OLES",0,1,1
" 06","TRIANA","PAISES BAJOS","TOTAL POBLACION",0,1,1
" 06","TRIANA","PAKISTAN","EXTRANJEROS",1,0,1
" 06","TRIANA","PAKISTAN","TOTAL POBLACION",1,0,1
" 06","TRIANA","PANAMA","EXTRANJEROS",1,0,1
" 06","TRIANA","PANAMA","TOTAL POBLACION",1,0,1
" 06","TRIANA","PARAGUAY","EXTRANJEROS",1,6,7
" 06","TRIANA","PARAGUAY","TOTAL POBLACION",1,6,7
" 06","TRIANA","PERU","ESPA�OLES",2,0,2
" 06","TRIANA","PERU","EXTRANJEROS",3,3,6
" 06","TRIANA","PERU","TOTAL POBLACION",5,3,8
" 06","TRIANA","PORTUGAL","ESPA�OLES",1,1,2
" 06","TRIANA","PORTUGAL","EXTRANJEROS",2,1,3
" 06","TRIANA","PORTUGAL","TOTAL POBLACION",3,2,5
" 06","TRIANA","REINO UNIDO","ESPA�OLES",2,0,2
" 06","TRIANA","REINO UNIDO","EXTRANJEROS",2,3,5
" 06","TRIANA","REINO UNIDO","TOTAL POBLACION",4,3,7
" 06","TRIANA","REPUBLICA DE COREA","EXTRANJEROS",1,1,2
" 06","TRIANA","REPUBLICA DE COREA","TOTAL POBLACION",1,1,2
" 06","TRIANA","REPUBLICA DOMINICANA","EXTRANJEROS",0,7,7
" 06","TRIANA","REPUBLICA DOMINICANA","TOTAL POBLACION",0,7,7
" 06","TRIANA","RUMANIA","EXTRANJEROS",3,4,7
" 06","TRIANA","RUMANIA","TOTAL POBLACION",3,4,7
" 06","TRIANA","RUSIA","EXTRANJEROS",0,1,1
" 06","TRIANA","RUSIA","TOTAL POBLACION",0,1,1
" 06","TRIANA","SAN MARINO","EXTRANJEROS",0,1,1
" 06","TRIANA","SAN MARINO","TOTAL POBLACION",0,1,1
" 06","TRIANA","SIRIA","EXTRANJEROS",1,0,1
" 06","TRIANA","SIRIA","TOTAL POBLACION",1,0,1
" 06","TRIANA","SUECIA","ESPA�OLES",0,1,1
" 06","TRIANA","SUECIA","EXTRANJEROS",0,1,1
" 06","TRIANA","SUECIA","TOTAL POBLACION",0,2,2
" 06","TRIANA","SUIZA","ESPA�OLES",1,0,1
" 06","TRIANA","SUIZA","TOTAL POBLACION",1,0,1
" 06","TRIANA","TURQUIA","EXTRANJEROS",0,1,1
" 06","TRIANA","TURQUIA","TOTAL POBLACION",0,1,1
" 06","TRIANA","UCRANIA","EXTRANJEROS",3,3,6
" 06","TRIANA","UCRANIA","TOTAL POBLACION",3,3,6
" 06","TRIANA","UZBEKISTAN","EXTRANJEROS",1,0,1
" 06","TRIANA","UZBEKISTAN","TOTAL POBLACION",1,0,1
" 06","TRIANA","VENEZUELA","ESPA�OLES",0,4,4
" 06","TRIANA","VENEZUELA","EXTRANJEROS",2,3,5
" 06","TRIANA","VENEZUELA","TOTAL POBLACION",2,7,9
" 07","NORTE","- TODOS -","ESPA�OLES",521,509,1030
" 07","NORTE","- TODOS -","EXTRANJEROS",137,118,255
" 07","NORTE","- TODOS -","TOTAL POBLACION",658,627,1285
" 07","NORTE","ALEMANIA","ESPA�OLES",2,5,7
" 07","NORTE","ALEMANIA","TOTAL POBLACION",2,5,7
" 07","NORTE","ARGELIA","EXTRANJEROS",1,0,1
" 07","NORTE","ARGELIA","TOTAL POBLACION",1,0,1
" 07","NORTE","ARGENTINA","EXTRANJEROS",2,0,2
" 07","NORTE","ARGENTINA","TOTAL POBLACION",2,0,2
" 07","NORTE","AUSTRIA","EXTRANJEROS",1,0,1
" 07","NORTE","AUSTRIA","TOTAL POBLACION",1,0,1
" 07","NORTE","AZERBAIYAN","EXTRANJEROS",1,0,1
" 07","NORTE","AZERBAIYAN","TOTAL POBLACION",1,0,1
" 07","NORTE","BANGLA-DESH","EXTRANJEROS",2,0,2
" 07","NORTE","BANGLA-DESH","TOTAL POBLACION",2,0,2
" 07","NORTE","BOLIVIA","ESPA�OLES",1,0,1
" 07","NORTE","BOLIVIA","EXTRANJEROS",2,2,4
" 07","NORTE","BOLIVIA","TOTAL POBLACION",3,2,5
" 07","NORTE","BRASIL","ESPA�OLES",0,1,1
" 07","NORTE","BRASIL","EXTRANJEROS",1,2,3
" 07","NORTE","BRASIL","TOTAL POBLACION",1,3,4
" 07","NORTE","BULGARIA","EXTRANJEROS",1,0,1
" 07","NORTE","BULGARIA","TOTAL POBLACION",1,0,1
" 07","NORTE","CHILE","ESPA�OLES",0,1,1
" 07","NORTE","CHILE","TOTAL POBLACION",0,1,1
" 07","NORTE","CHINA","EXTRANJEROS",1,3,4
" 07","NORTE","CHINA","TOTAL POBLACION",1,3,4
" 07","NORTE","COLOMBIA","EXTRANJEROS",5,2,7
" 07","NORTE","COLOMBIA","TOTAL POBLACION",5,2,7
" 07","NORTE","CUBA","ESPA�OLES",0,1,1
" 07","NORTE","CUBA","EXTRANJEROS",1,0,1
" 07","NORTE","CUBA","TOTAL POBLACION",1,1,2
" 07","NORTE","ECUADOR","EXTRANJEROS",3,0,3
" 07","NORTE","ECUADOR","TOTAL POBLACION",3,0,3
" 07","NORTE","ESPA�A","ESPA�OLES",512,498,1010
" 07","NORTE","ESPA�A","EXTRANJEROS",80,68,148
" 07","NORTE","ESPA�A","TOTAL POBLACION",592,566,1158
" 07","NORTE","ESTADOS UNIDOS DE AMERICA","ESPA�OLES",0,1,1
" 07","NORTE","ESTADOS UNIDOS DE AMERICA","EXTRANJEROS",0,1,1
" 07","NORTE","ESTADOS UNIDOS DE AMERICA","TOTAL POBLACION",0,2,2
" 07","NORTE","FILIPINAS","EXTRANJEROS",1,0,1
" 07","NORTE","FILIPINAS","TOTAL POBLACION",1,0,1
" 07","NORTE","FINLANDIA","ESPA�OLES",1,0,1
" 07","NORTE","FINLANDIA","TOTAL POBLACION",1,0,1
" 07","NORTE","FRANCIA","ESPA�OLES",2,1,3
" 07","NORTE","FRANCIA","EXTRANJEROS",1,0,1
" 07","NORTE","FRANCIA","TOTAL POBLACION",3,1,4
" 07","NORTE","HONDURAS","EXTRANJEROS",1,0,1
" 07","NORTE","HONDURAS","TOTAL POBLACION",1,0,1
" 07","NORTE","ISLANDIA","EXTRANJEROS",1,2,3
" 07","NORTE","ISLANDIA","TOTAL POBLACION",1,2,3
" 07","NORTE","ITALIA","EXTRANJEROS",3,2,5
" 07","NORTE","ITALIA","TOTAL POBLACION",3,2,5
" 07","NORTE","JAPON","EXTRANJEROS",0,1,1
" 07","NORTE","JAPON","TOTAL POBLACION",0,1,1
" 07","NORTE","JORDANIA","ESPA�OLES",1,0,1
" 07","NORTE","JORDANIA","TOTAL POBLACION",1,0,1
" 07","NORTE","MARRUECOS","EXTRANJEROS",8,3,11
" 07","NORTE","MARRUECOS","TOTAL POBLACION",8,3,11
" 07","NORTE","MEXICO","ESPA�OLES",1,0,1
" 07","NORTE","MEXICO","EXTRANJEROS",2,2,4
" 07","NORTE","MEXICO","TOTAL POBLACION",3,2,5
" 07","NORTE","NICARAGUA","EXTRANJEROS",0,6,6
" 07","NORTE","NICARAGUA","TOTAL POBLACION",0,6,6
" 07","NORTE","NIGERIA","EXTRANJEROS",0,1,1
" 07","NORTE","NIGERIA","TOTAL POBLACION",0,1,1
" 07","NORTE","PAKISTAN","EXTRANJEROS",3,2,5
" 07","NORTE","PAKISTAN","TOTAL POBLACION",3,2,5
" 07","NORTE","PARAGUAY","EXTRANJEROS",0,2,2
" 07","NORTE","PARAGUAY","TOTAL POBLACION",0,2,2
" 07","NORTE","POLONIA","EXTRANJEROS",0,1,1
" 07","NORTE","POLONIA","TOTAL POBLACION",0,1,1
" 07","NORTE","PORTUGAL","EXTRANJEROS",0,2,2
" 07","NORTE","PORTUGAL","TOTAL POBLACION",0,2,2
" 07","NORTE","PRINCIPADO DE ANDORRA","ESPA�OLES",0,1,1
" 07","NORTE","PRINCIPADO DE ANDORRA","TOTAL POBLACION",0,1,1
" 07","NORTE","REPUBLICA DOMINICANA","EXTRANJEROS",0,1,1
" 07","NORTE","REPUBLICA DOMINICANA","TOTAL POBLACION",0,1,1
" 07","NORTE","RUMANIA","EXTRANJEROS",6,8,14
" 07","NORTE","RUMANIA","TOTAL POBLACION",6,8,14
" 07","NORTE","RUSIA","EXTRANJEROS",0,1,1
" 07","NORTE","RUSIA","TOTAL POBLACION",0,1,1
" 07","NORTE","SAN MARINO","EXTRANJEROS",1,0,1
" 07","NORTE","SAN MARINO","TOTAL POBLACION",1,0,1
" 07","NORTE","SENEGAL","EXTRANJEROS",8,2,10
" 07","NORTE","SENEGAL","TOTAL POBLACION",8,2,10
" 07","NORTE","SUECIA","EXTRANJEROS",1,0,1
" 07","NORTE","SUECIA","TOTAL POBLACION",1,0,1
" 07","NORTE","SUIZA","ESPA�OLES",1,0,1
" 07","NORTE","SUIZA","TOTAL POBLACION",1,0,1
" 07","NORTE","TAILANDIA","EXTRANJEROS",0,1,1
" 07","NORTE","TAILANDIA","TOTAL POBLACION",0,1,1
" 07","NORTE","VENEZUELA","EXTRANJEROS",0,3,3
" 07","NORTE","VENEZUELA","TOTAL POBLACION",0,3,3
" 08","S. PABLO-STA. JUSTA","- TODOS -","ESPA�OLES",517,510,1027
" 08","S. PABLO-STA. JUSTA","- TODOS -","EXTRANJEROS",108,137,245
" 08","S. PABLO-STA. JUSTA","- TODOS -","TOTAL POBLACION",625,647,1272
" 08","S. PABLO-STA. JUSTA","ALEMANIA","ESPA�OLES",2,1,3
" 08","S. PABLO-STA. JUSTA","ALEMANIA","EXTRANJEROS",3,3,6
" 08","S. PABLO-STA. JUSTA","ALEMANIA","TOTAL POBLACION",5,4,9
" 08","S. PABLO-STA. JUSTA","ARGENTINA","ESPA�OLES",0,1,1
" 08","S. PABLO-STA. JUSTA","ARGENTINA","TOTAL POBLACION",0,1,1
" 08","S. PABLO-STA. JUSTA","ARMENIA","EXTRANJEROS",1,1,2
" 08","S. PABLO-STA. JUSTA","ARMENIA","TOTAL POBLACION",1,1,2
" 08","S. PABLO-STA. JUSTA","AUSTRALIA","ESPA�OLES",1,2,3
" 08","S. PABLO-STA. JUSTA","AUSTRALIA","TOTAL POBLACION",1,2,3
" 08","S. PABLO-STA. JUSTA","BELGICA","ESPA�OLES",3,1,4
" 08","S. PABLO-STA. JUSTA","BELGICA","TOTAL POBLACION",3,1,4
" 08","S. PABLO-STA. JUSTA","BOLIVIA","ESPA�OLES",1,2,3
" 08","S. PABLO-STA. JUSTA","BOLIVIA","TOTAL POBLACION",1,2,3
" 08","S. PABLO-STA. JUSTA","BRASIL","EXTRANJEROS",1,1,2
" 08","S. PABLO-STA. JUSTA","BRASIL","TOTAL POBLACION",1,1,2
" 08","S. PABLO-STA. JUSTA","CABO VERDE","ESPA�OLES",1,0,1
" 08","S. PABLO-STA. JUSTA","CABO VERDE","TOTAL POBLACION",1,0,1
" 08","S. PABLO-STA. JUSTA","CHILE","ESPA�OLES",2,1,3
" 08","S. PABLO-STA. JUSTA","CHILE","TOTAL POBLACION",2,1,3
" 08","S. PABLO-STA. JUSTA","CHINA","EXTRANJEROS",11,9,20
" 08","S. PABLO-STA. JUSTA","CHINA","TOTAL POBLACION",11,9,20
" 08","S. PABLO-STA. JUSTA","COLOMBIA","ESPA�OLES",1,0,1
" 08","S. PABLO-STA. JUSTA","COLOMBIA","EXTRANJEROS",3,2,5
" 08","S. PABLO-STA. JUSTA","COLOMBIA","TOTAL POBLACION",4,2,6
" 08","S. PABLO-STA. JUSTA","COSTA RICA","EXTRANJEROS",1,1,2
" 08","S. PABLO-STA. JUSTA","COSTA RICA","TOTAL POBLACION",1,1,2
" 08","S. PABLO-STA. JUSTA","CUBA","ESPA�OLES",0,1,1
" 08","S. PABLO-STA. JUSTA","CUBA","TOTAL POBLACION",0,1,1
" 08","S. PABLO-STA. JUSTA","ECUADOR","ESPA�OLES",1,1,2
" 08","S. PABLO-STA. JUSTA","ECUADOR","TOTAL POBLACION",1,1,2
" 08","S. PABLO-STA. JUSTA","EL SALVADOR","EXTRANJEROS",1,0,1
" 08","S. PABLO-STA. JUSTA","EL SALVADOR","TOTAL POBLACION",1,0,1
" 08","S. PABLO-STA. JUSTA","ESPA�A","ESPA�OLES",501,490,991
" 08","S. PABLO-STA. JUSTA","ESPA�A","EXTRANJEROS",46,74,120
" 08","S. PABLO-STA. JUSTA","ESPA�A","TOTAL POBLACION",547,564,1111
" 08","S. PABLO-STA. JUSTA","ESTADOS UNIDOS DE AMERICA","ESPA�OLES",1,0,1
" 08","S. PABLO-STA. JUSTA","ESTADOS UNIDOS DE AMERICA","EXTRANJEROS",0,1,1
" 08","S. PABLO-STA. JUSTA","ESTADOS UNIDOS DE AMERICA","TOTAL POBLACION",1,1,2
" 08","S. PABLO-STA. JUSTA","ETIOPIA","EXTRANJEROS",1,0,1
" 08","S. PABLO-STA. JUSTA","ETIOPIA","TOTAL POBLACION",1,0,1
" 08","S. PABLO-STA. JUSTA","FINLANDIA","EXTRANJEROS",0,1,1
" 08","S. PABLO-STA. JUSTA","FINLANDIA","TOTAL POBLACION",0,1,1
" 08","S. PABLO-STA. JUSTA","FRANCIA","ESPA�OLES",0,1,1
" 08","S. PABLO-STA. JUSTA","FRANCIA","EXTRANJEROS",5,1,6
" 08","S. PABLO-STA. JUSTA","FRANCIA","TOTAL POBLACION",5,2,7
" 08","S. PABLO-STA. JUSTA","GUATEMALA","EXTRANJEROS",1,2,3
" 08","S. PABLO-STA. JUSTA","GUATEMALA","TOTAL POBLACION",1,2,3
" 08","S. PABLO-STA. JUSTA","HONDURAS","EXTRANJEROS",0,1,1
" 08","S. PABLO-STA. JUSTA","HONDURAS","TOTAL POBLACION",0,1,1
" 08","S. PABLO-STA. JUSTA","HUNGRIA","EXTRANJEROS",1,0,1
" 08","S. PABLO-STA. JUSTA","HUNGRIA","TOTAL POBLACION",1,0,1
" 08","S. PABLO-STA. JUSTA","ITALIA","EXTRANJEROS",3,3,6
" 08","S. PABLO-STA. JUSTA","ITALIA","TOTAL POBLACION",3,3,6
" 08","S. PABLO-STA. JUSTA","LIBANO","ESPA�OLES",0,1,1
" 08","S. PABLO-STA. JUSTA","LIBANO","EXTRANJEROS",1,1,2
" 08","S. PABLO-STA. JUSTA","LIBANO","TOTAL POBLACION",1,2,3
" 08","S. PABLO-STA. JUSTA","MALI","EXTRANJEROS",3,0,3
" 08","S. PABLO-STA. JUSTA","MALI","TOTAL POBLACION",3,0,3
" 08","S. PABLO-STA. JUSTA","MARRUECOS","ESPA�OLES",1,2,3
" 08","S. PABLO-STA. JUSTA","MARRUECOS","EXTRANJEROS",8,2,10
" 08","S. PABLO-STA. JUSTA","MARRUECOS","TOTAL POBLACION",9,4,13
" 08","S. PABLO-STA. JUSTA","MEXICO","EXTRANJEROS",1,3,4
" 08","S. PABLO-STA. JUSTA","MEXICO","TOTAL POBLACION",1,3,4
" 08","S. PABLO-STA. JUSTA","NICARAGUA","ESPA�OLES",0,1,1
" 08","S. PABLO-STA. JUSTA","NICARAGUA","EXTRANJEROS",3,12,15
" 08","S. PABLO-STA. JUSTA","NICARAGUA","TOTAL POBLACION",3,13,16
" 08","S. PABLO-STA. JUSTA","OTROS PAISES SIN RELACION DIPLOMATICA","EXTRANJEROS",1,0,1
" 08","S. PABLO-STA. JUSTA","OTROS PAISES SIN RELACION DIPLOMATICA","TOTAL POBLACION",1,0,1
" 08","S. PABLO-STA. JUSTA","PAISES BAJOS","EXTRANJEROS",0,1,1
" 08","S. PABLO-STA. JUSTA","PAISES BAJOS","TOTAL POBLACION",0,1,1
" 08","S. PABLO-STA. JUSTA","PARAGUAY","EXTRANJEROS",2,0,2
" 08","S. PABLO-STA. JUSTA","PARAGUAY","TOTAL POBLACION",2,0,2
" 08","S. PABLO-STA. JUSTA","PERU","ESPA�OLES",1,1,2
" 08","S. PABLO-STA. JUSTA","PERU","EXTRANJEROS",0,2,2
" 08","S. PABLO-STA. JUSTA","PERU","TOTAL POBLACION",1,3,4
" 08","S. PABLO-STA. JUSTA","PORTUGAL","EXTRANJEROS",3,3,6
" 08","S. PABLO-STA. JUSTA","PORTUGAL","TOTAL POBLACION",3,3,6
" 08","S. PABLO-STA. JUSTA","REINO UNIDO","ESPA�OLES",0,4,4
" 08","S. PABLO-STA. JUSTA","REINO UNIDO","EXTRANJEROS",2,2,4
" 08","S. PABLO-STA. JUSTA","REINO UNIDO","TOTAL POBLACION",2,6,8
" 08","S. PABLO-STA. JUSTA","REPUBLICA DEMOCRATICA DEL CONGO","EXTRANJEROS",0,1,1
" 08","S. PABLO-STA. JUSTA","REPUBLICA DEMOCRATICA DEL CONGO","TOTAL POBLACION",0,1,1
" 08","S. PABLO-STA. JUSTA","RUMANIA","EXTRANJEROS",1,1,2
" 08","S. PABLO-STA. JUSTA","RUMANIA","TOTAL POBLACION",1,1,2
" 08","S. PABLO-STA. JUSTA","RUSIA","EXTRANJEROS",1,4,5
" 08","S. PABLO-STA. JUSTA","RUSIA","TOTAL POBLACION",1,4,5
" 08","S. PABLO-STA. JUSTA","SENEGAL","EXTRANJEROS",2,0,2
" 08","S. PABLO-STA. JUSTA","SENEGAL","TOTAL POBLACION",2,0,2
" 08","S. PABLO-STA. JUSTA","SUECIA","EXTRANJEROS",0,1,1
" 08","S. PABLO-STA. JUSTA","SUECIA","TOTAL POBLACION",0,1,1
" 08","S. PABLO-STA. JUSTA","TURQUIA","EXTRANJEROS",0,1,1
" 08","S. PABLO-STA. JUSTA","TURQUIA","TOTAL POBLACION",0,1,1
" 08","S. PABLO-STA. JUSTA","UCRANIA","EXTRANJEROS",0,1,1
" 08","S. PABLO-STA. JUSTA","UCRANIA","TOTAL POBLACION",0,1,1
" 08","S. PABLO-STA. JUSTA","VENEZUELA","ESPA�OLES",1,0,1
" 08","S. PABLO-STA. JUSTA","VENEZUELA","EXTRANJEROS",2,2,4
" 08","S. PABLO-STA. JUSTA","VENEZUELA","TOTAL POBLACION",3,2,5
" 09","ESTE","- TODOS -","ESPA�OLES",779,776,1555
" 09","ESTE","- TODOS -","EXTRANJEROS",283,222,505
" 09","ESTE","- TODOS -","TOTAL POBLACION",1062,998,2060
" 09","ESTE","AFGANISTAN","EXTRANJEROS",12,5,17
" 09","ESTE","AFGANISTAN","TOTAL POBLACION",12,5,17
" 09","ESTE","ALEMANIA","ESPA�OLES",0,1,1
" 09","ESTE","ALEMANIA","EXTRANJEROS",3,1,4
" 09","ESTE","ALEMANIA","TOTAL POBLACION",3,2,5
" 09","ESTE","ARABIA SAUDITA","ESPA�OLES",1,0,1
" 09","ESTE","ARABIA SAUDITA","TOTAL POBLACION",1,0,1
" 09","ESTE","ARGELIA","EXTRANJEROS",10,4,14
" 09","ESTE","ARGELIA","TOTAL POBLACION",10,4,14
" 09","ESTE","ARGENTINA","ESPA�OLES",0,3,3
" 09","ESTE","ARGENTINA","EXTRANJEROS",1,0,1
" 09","ESTE","ARGENTINA","TOTAL POBLACION",1,3,4
" 09","ESTE","BELGICA","ESPA�OLES",0,1,1
" 09","ESTE","BELGICA","EXTRANJEROS",1,0,1
" 09","ESTE","BELGICA","TOTAL POBLACION",1,1,2
" 09","ESTE","BIELORUSIA","EXTRANJEROS",1,0,1
" 09","ESTE","BIELORUSIA","TOTAL POBLACION",1,0,1
" 09","ESTE","BOLIVIA","EXTRANJEROS",2,0,2
" 09","ESTE","BOLIVIA","TOTAL POBLACION",2,0,2
" 09","ESTE","BOSNIA-HERZEGOVINA","ESPA�OLES",1,0,1
" 09","ESTE","BOSNIA-HERZEGOVINA","TOTAL POBLACION",1,0,1
" 09","ESTE","BRASIL","ESPA�OLES",1,0,1
" 09","ESTE","BRASIL","EXTRANJEROS",2,6,8
" 09","ESTE","BRASIL","TOTAL POBLACION",3,6,9
" 09","ESTE","BULGARIA","EXTRANJEROS",1,0,1
" 09","ESTE","BULGARIA","TOTAL POBLACION",1,0,1
" 09","ESTE","CAMERUN","EXTRANJEROS",11,1,12
" 09","ESTE","CAMERUN","TOTAL POBLACION",11,1,12
" 09","ESTE","CHILE","ESPA�OLES",1,1,2
" 09","ESTE","CHILE","TOTAL POBLACION",1,1,2
" 09","ESTE","CHINA","ESPA�OLES",0,2,2
" 09","ESTE","CHINA","EXTRANJEROS",6,5,11
" 09","ESTE","CHINA","TOTAL POBLACION",6,7,13
" 09","ESTE","COLOMBIA","EXTRANJEROS",3,6,9
" 09","ESTE","COLOMBIA","TOTAL POBLACION",3,6,9
" 09","ESTE","CONGO","EXTRANJEROS",2,0,2
" 09","ESTE","CONGO","TOTAL POBLACION",2,0,2
" 09","ESTE","COSTA DE MARFIL","EXTRANJEROS",2,3,5
" 09","ESTE","COSTA DE MARFIL","TOTAL POBLACION",2,3,5
" 09","ESTE","COSTA RICA","ESPA�OLES",0,1,1
" 09","ESTE","COSTA RICA","TOTAL POBLACION",0,1,1
" 09","ESTE","CROACIA","EXTRANJEROS",1,1,2
" 09","ESTE","CROACIA","TOTAL POBLACION",1,1,2
" 09","ESTE","CUBA","ESPA�OLES",1,0,1
" 09","ESTE","CUBA","EXTRANJEROS",2,3,5
" 09","ESTE","CUBA","TOTAL POBLACION",3,3,6
" 09","ESTE","ECUADOR","EXTRANJEROS",1,4,5
" 09","ESTE","ECUADOR","TOTAL POBLACION",1,4,5
" 09","ESTE","EGIPTO","ESPA�OLES",1,0,1
" 09","ESTE","EGIPTO","TOTAL POBLACION",1,0,1
" 09","ESTE","EL SALVADOR","EXTRANJEROS",2,3,5
" 09","ESTE","EL SALVADOR","TOTAL POBLACION",2,3,5
" 09","ESTE","ERITREA","EXTRANJEROS",1,0,1
" 09","ESTE","ERITREA","TOTAL POBLACION",1,0,1
" 09","ESTE","ESPA�A","ESPA�OLES",767,754,1521
" 09","ESTE","ESPA�A","EXTRANJEROS",132,96,228
" 09","ESTE","ESPA�A","TOTAL POBLACION",899,850,1749
" 09","ESTE","ESTADOS UNIDOS DE AMERICA","ESPA�OLES",0,2,2
" 09","ESTE","ESTADOS UNIDOS DE AMERICA","EXTRANJEROS",0,1,1
" 09","ESTE","ESTADOS UNIDOS DE AMERICA","TOTAL POBLACION",0,3,3
" 09","ESTE","FRANCIA","ESPA�OLES",2,2,4
" 09","ESTE","FRANCIA","EXTRANJEROS",3,3,6
" 09","ESTE","FRANCIA","TOTAL POBLACION",5,5,10
" 09","ESTE","GAMBIA","EXTRANJEROS",0,1,1
" 09","ESTE","GAMBIA","TOTAL POBLACION",0,1,1
" 09","ESTE","GEORGIA","EXTRANJEROS",3,3,6
" 09","ESTE","GEORGIA","TOTAL POBLACION",3,3,6
" 09","ESTE","GUINEA","EXTRANJEROS",3,2,5
" 09","ESTE","GUINEA","TOTAL POBLACION",3,2,5
" 09","ESTE","HONDURAS","EXTRANJEROS",0,2,2
" 09","ESTE","HONDURAS","TOTAL POBLACION",0,2,2
" 09","ESTE","IRAK","EXTRANJEROS",2,0,2
" 09","ESTE","IRAK","TOTAL POBLACION",2,0,2
" 09","ESTE","IRAN","EXTRANJEROS",1,0,1
" 09","ESTE","IRAN","TOTAL POBLACION",1,0,1
" 09","ESTE","ITALIA","ESPA�OLES",0,1,1
" 09","ESTE","ITALIA","EXTRANJEROS",2,5,7
" 09","ESTE","ITALIA","TOTAL POBLACION",2,6,8
" 09","ESTE","JORDANIA","EXTRANJEROS",2,0,2
" 09","ESTE","JORDANIA","TOTAL POBLACION",2,0,2
" 09","ESTE","LIBANO","EXTRANJEROS",5,4,9
" 09","ESTE","LIBANO","TOTAL POBLACION",5,4,9
" 09","ESTE","LIBIA","EXTRANJEROS",1,1,2
" 09","ESTE","LIBIA","TOTAL POBLACION",1,1,2
" 09","ESTE","MALI","EXTRANJEROS",8,0,8
" 09","ESTE","MALI","TOTAL POBLACION",8,0,8
" 09","ESTE","MARRUECOS","ESPA�OLES",2,1,3
" 09","ESTE","MARRUECOS","EXTRANJEROS",4,5,9
" 09","ESTE","MARRUECOS","TOTAL POBLACION",6,6,12
" 09","ESTE","MEXICO","EXTRANJEROS",1,1,2
" 09","ESTE","MEXICO","TOTAL POBLACION",1,1,2
" 09","ESTE","NICARAGUA","EXTRANJEROS",0,9,9
" 09","ESTE","NICARAGUA","TOTAL POBLACION",0,9,9
" 09","ESTE","NIGERIA","EXTRANJEROS",3,2,5
" 09","ESTE","NIGERIA","TOTAL POBLACION",3,2,5
" 09","ESTE","OTROS PAISES SIN RELACION DIPLOMATICA","EXTRANJEROS",6,0,6
" 09","ESTE","OTROS PAISES SIN RELACION DIPLOMATICA","TOTAL POBLACION",6,0,6
" 09","ESTE","PAISES BAJOS","ESPA�OLES",0,1,1
" 09","ESTE","PAISES BAJOS","TOTAL POBLACION",0,1,1
" 09","ESTE","PANAMA","ESPA�OLES",0,1,1
" 09","ESTE","PANAMA","TOTAL POBLACION",0,1,1
" 09","ESTE","PARAGUAY","EXTRANJEROS",0,1,1
" 09","ESTE","PARAGUAY","TOTAL POBLACION",0,1,1
" 09","ESTE","POLONIA","EXTRANJEROS",0,1,1
" 09","ESTE","POLONIA","TOTAL POBLACION",0,1,1
" 09","ESTE","PORTUGAL","EXTRANJEROS",1,1,2
" 09","ESTE","PORTUGAL","TOTAL POBLACION",1,1,2
" 09","ESTE","REINO UNIDO","ESPA�OLES",2,3,5
" 09","ESTE","REINO UNIDO","EXTRANJEROS",2,1,3
" 09","ESTE","REINO UNIDO","TOTAL POBLACION",4,4,8
" 09","ESTE","REPUBLICA DEMOCRATICA DEL CONGO","EXTRANJEROS",3,2,5
" 09","ESTE","REPUBLICA DEMOCRATICA DEL CONGO","TOTAL POBLACION",3,2,5
" 09","ESTE","REPUBLICA DOMINICANA","EXTRANJEROS",1,1,2
" 09","ESTE","REPUBLICA DOMINICANA","TOTAL POBLACION",1,1,2
" 09","ESTE","RUMANIA","EXTRANJEROS",2,5,7
" 09","ESTE","RUMANIA","TOTAL POBLACION",2,5,7
" 09","ESTE","RUSIA","EXTRANJEROS",5,4,9
" 09","ESTE","RUSIA","TOTAL POBLACION",5,4,9
" 09","ESTE","SENEGAL","EXTRANJEROS",1,0,1
" 09","ESTE","SENEGAL","TOTAL POBLACION",1,0,1
" 09","ESTE","SIERRA LEONA","EXTRANJEROS",1,0,1
" 09","ESTE","SIERRA LEONA","TOTAL POBLACION",1,0,1
" 09","ESTE","SINGAPUR","ESPA�OLES",0,1,1
" 09","ESTE","SINGAPUR","EXTRANJEROS",1,0,1
" 09","ESTE","SINGAPUR","TOTAL POBLACION",1,1,2
" 09","ESTE","SIRIA","EXTRANJEROS",19,15,34
" 09","ESTE","SIRIA","TOTAL POBLACION",19,15,34
" 09","ESTE","SOMALIA","EXTRANJEROS",2,6,8
" 09","ESTE","SOMALIA","TOTAL POBLACION",2,6,8
" 09","ESTE","SUDAN","EXTRANJEROS",1,0,1
" 09","ESTE","SUDAN","TOTAL POBLACION",1,0,1
" 09","ESTE","SUECIA","EXTRANJEROS",1,0,1
" 09","ESTE","SUECIA","TOTAL POBLACION",1,0,1
" 09","ESTE","TOGO","EXTRANJEROS",1,0,1
" 09","ESTE","TOGO","TOTAL POBLACION",1,0,1
" 09","ESTE","UCRANIA","EXTRANJEROS",2,3,5
" 09","ESTE","UCRANIA","TOTAL POBLACION",2,3,5
" 09","ESTE","URUGUAY","ESPA�OLES",0,1,1
" 09","ESTE","URUGUAY","TOTAL POBLACION",0,1,1
" 09","ESTE","VENEZUELA","EXTRANJEROS",0,5,5
" 09","ESTE","VENEZUELA","TOTAL POBLACION",0,5,5
" 10","BELLAVISTA-LA PALMERA","- TODOS -","ESPA�OLES",479,453,932
" 10","BELLAVISTA-LA PALMERA","- TODOS -","EXTRANJEROS",99,131,230
" 10","BELLAVISTA-LA PALMERA","- TODOS -","TOTAL POBLACION",578,584,1162
" 10","BELLAVISTA-LA PALMERA","ALEMANIA","ESPA�OLES",3,2,5
" 10","BELLAVISTA-LA PALMERA","ALEMANIA","EXTRANJEROS",1,0,1
" 10","BELLAVISTA-LA PALMERA","ALEMANIA","TOTAL POBLACION",4,2,6
" 10","BELLAVISTA-LA PALMERA","ARGENTINA","ESPA�OLES",0,1,1
" 10","BELLAVISTA-LA PALMERA","ARGENTINA","TOTAL POBLACION",0,1,1
" 10","BELLAVISTA-LA PALMERA","AUSTRIA","EXTRANJEROS",0,1,1
" 10","BELLAVISTA-LA PALMERA","AUSTRIA","TOTAL POBLACION",0,1,1
" 10","BELLAVISTA-LA PALMERA","BAHREIN","ESPA�OLES",1,0,1
" 10","BELLAVISTA-LA PALMERA","BAHREIN","TOTAL POBLACION",1,0,1
" 10","BELLAVISTA-LA PALMERA","BELGICA","ESPA�OLES",2,2,4
" 10","BELLAVISTA-LA PALMERA","BELGICA","TOTAL POBLACION",2,2,4
" 10","BELLAVISTA-LA PALMERA","BOLIVIA","EXTRANJEROS",4,3,7
" 10","BELLAVISTA-LA PALMERA","BOLIVIA","TOTAL POBLACION",4,3,7
" 10","BELLAVISTA-LA PALMERA","BRASIL","ESPA�OLES",1,0,1
" 10","BELLAVISTA-LA PALMERA","BRASIL","EXTRANJEROS",0,2,2
" 10","BELLAVISTA-LA PALMERA","BRASIL","TOTAL POBLACION",1,2,3
" 10","BELLAVISTA-LA PALMERA","CHILE","EXTRANJEROS",2,2,4
" 10","BELLAVISTA-LA PALMERA","CHILE","TOTAL POBLACION",2,2,4
" 10","BELLAVISTA-LA PALMERA","CHINA","EXTRANJEROS",1,2,3
" 10","BELLAVISTA-LA PALMERA","CHINA","TOTAL POBLACION",1,2,3
" 10","BELLAVISTA-LA PALMERA","COLOMBIA","ESPA�OLES",1,0,1
" 10","BELLAVISTA-LA PALMERA","COLOMBIA","EXTRANJEROS",1,3,4
" 10","BELLAVISTA-LA PALMERA","COLOMBIA","TOTAL POBLACION",2,3,5
" 10","BELLAVISTA-LA PALMERA","COSTA RICA","ESPA�OLES",0,1,1
" 10","BELLAVISTA-LA PALMERA","COSTA RICA","EXTRANJEROS",0,1,1
" 10","BELLAVISTA-LA PALMERA","COSTA RICA","TOTAL POBLACION",0,2,2
" 10","BELLAVISTA-LA PALMERA","CUBA","EXTRANJEROS",1,1,2
" 10","BELLAVISTA-LA PALMERA","CUBA","TOTAL POBLACION",1,1,2
" 10","BELLAVISTA-LA PALMERA","ECUADOR","ESPA�OLES",0,1,1
" 10","BELLAVISTA-LA PALMERA","ECUADOR","EXTRANJEROS",1,1,2
" 10","BELLAVISTA-LA PALMERA","ECUADOR","TOTAL POBLACION",1,2,3
" 10","BELLAVISTA-LA PALMERA","EL SALVADOR","EXTRANJEROS",1,2,3
" 10","BELLAVISTA-LA PALMERA","EL SALVADOR","TOTAL POBLACION",1,2,3
" 10","BELLAVISTA-LA PALMERA","ESPA�A","ESPA�OLES",452,430,882
" 10","BELLAVISTA-LA PALMERA","ESPA�A","EXTRANJEROS",62,78,140
" 10","BELLAVISTA-LA PALMERA","ESPA�A","TOTAL POBLACION",514,508,1022
" 10","BELLAVISTA-LA PALMERA","ESTADOS UNIDOS DE AMERICA","ESPA�OLES",12,8,20
" 10","BELLAVISTA-LA PALMERA","ESTADOS UNIDOS DE AMERICA","EXTRANJEROS",0,3,3
" 10","BELLAVISTA-LA PALMERA","ESTADOS UNIDOS DE AMERICA","TOTAL POBLACION",12,11,23
" 10","BELLAVISTA-LA PALMERA","FRANCIA","EXTRANJEROS",0,1,1
" 10","BELLAVISTA-LA PALMERA","FRANCIA","TOTAL POBLACION",0,1,1
" 10","BELLAVISTA-LA PALMERA","GEORGIA","EXTRANJEROS",1,1,2
" 10","BELLAVISTA-LA PALMERA","GEORGIA","TOTAL POBLACION",1,1,2
" 10","BELLAVISTA-LA PALMERA","GUATEMALA","EXTRANJEROS",0,1,1
" 10","BELLAVISTA-LA PALMERA","GUATEMALA","TOTAL POBLACION",0,1,1
" 10","BELLAVISTA-LA PALMERA","GUINEA BISSAU","ESPA�OLES",1,0,1
" 10","BELLAVISTA-LA PALMERA","GUINEA BISSAU","EXTRANJEROS",0,1,1
" 10","BELLAVISTA-LA PALMERA","GUINEA BISSAU","TOTAL POBLACION",1,1,2
" 10","BELLAVISTA-LA PALMERA","ITALIA","ESPA�OLES",3,1,4
" 10","BELLAVISTA-LA PALMERA","ITALIA","EXTRANJEROS",3,0,3
" 10","BELLAVISTA-LA PALMERA","ITALIA","TOTAL POBLACION",6,1,7
" 10","BELLAVISTA-LA PALMERA","JORDANIA","EXTRANJEROS",0,1,1
" 10","BELLAVISTA-LA PALMERA","JORDANIA","TOTAL POBLACION",0,1,1
" 10","BELLAVISTA-LA PALMERA","MARRUECOS","EXTRANJEROS",7,3,10
" 10","BELLAVISTA-LA PALMERA","MARRUECOS","TOTAL POBLACION",7,3,10
" 10","BELLAVISTA-LA PALMERA","MEXICO","ESPA�OLES",1,2,3
" 10","BELLAVISTA-LA PALMERA","MEXICO","EXTRANJEROS",1,1,2
" 10","BELLAVISTA-LA PALMERA","MEXICO","TOTAL POBLACION",2,3,5
" 10","BELLAVISTA-LA PALMERA","NICARAGUA","EXTRANJEROS",0,8,8
" 10","BELLAVISTA-LA PALMERA","NICARAGUA","TOTAL POBLACION",0,8,8
" 10","BELLAVISTA-LA PALMERA","NIGERIA","EXTRANJEROS",0,1,1
" 10","BELLAVISTA-LA PALMERA","NIGERIA","TOTAL POBLACION",0,1,1
" 10","BELLAVISTA-LA PALMERA","PALESTINA. ESTADO OBSERVADOR, NO MIEMBRO DE NACIONES UNIDAS","ESPA�OLES",0,1,1
" 10","BELLAVISTA-LA PALMERA","PALESTINA. ESTADO OBSERVADOR, NO MIEMBRO DE NACIONES UNIDAS","TOTAL POBLACION",0,1,1
" 10","BELLAVISTA-LA PALMERA","PANAMA","EXTRANJEROS",1,0,1
" 10","BELLAVISTA-LA PALMERA","PANAMA","TOTAL POBLACION",1,0,1
" 10","BELLAVISTA-LA PALMERA","PORTUGAL","EXTRANJEROS",3,0,3
" 10","BELLAVISTA-LA PALMERA","PORTUGAL","TOTAL POBLACION",3,0,3
" 10","BELLAVISTA-LA PALMERA","REPUBLICA DOMINICANA","ESPA�OLES",0,1,1
" 10","BELLAVISTA-LA PALMERA","REPUBLICA DOMINICANA","TOTAL POBLACION",0,1,1
" 10","BELLAVISTA-LA PALMERA","REPUBLICA SUDAFRICANA","EXTRANJEROS",1,0,1
" 10","BELLAVISTA-LA PALMERA","REPUBLICA SUDAFRICANA","TOTAL POBLACION",1,0,1
" 10","BELLAVISTA-LA PALMERA","RUSIA","EXTRANJEROS",0,3,3
" 10","BELLAVISTA-LA PALMERA","RUSIA","TOTAL POBLACION",0,3,3
" 10","BELLAVISTA-LA PALMERA","SENEGAL","EXTRANJEROS",1,1,2
" 10","BELLAVISTA-LA PALMERA","SENEGAL","TOTAL POBLACION",1,1,2
" 10","BELLAVISTA-LA PALMERA","SERBIA","EXTRANJEROS",1,0,1
" 10","BELLAVISTA-LA PALMERA","SERBIA","TOTAL POBLACION",1,0,1
" 10","BELLAVISTA-LA PALMERA","SIRIA","EXTRANJEROS",0,1,1
" 10","BELLAVISTA-LA PALMERA","SIRIA","TOTAL POBLACION",0,1,1
" 10","BELLAVISTA-LA PALMERA","UCRANIA","EXTRANJEROS",2,2,4
" 10","BELLAVISTA-LA PALMERA","UCRANIA","TOTAL POBLACION",2,2,4
" 10","BELLAVISTA-LA PALMERA","URUGUAY","ESPA�OLES",2,2,4
" 10","BELLAVISTA-LA PALMERA","URUGUAY","TOTAL POBLACION",2,2,4
" 10","BELLAVISTA-LA PALMERA","VENEZUELA","ESPA�OLES",0,1,1
" 10","BELLAVISTA-LA PALMERA","VENEZUELA","EXTRANJEROS",4,7,11
" 10","BELLAVISTA-LA PALMERA","VENEZUELA","TOTAL POBLACION",4,8,12
" 11","LOS REMEDIOS","- TODOS -","ESPA�OLES",283,335,618
" 11","LOS REMEDIOS","- TODOS -","EXTRANJEROS",48,84,132
" 11","LOS REMEDIOS","- TODOS -","TOTAL POBLACION",331,419,750
" 11","LOS REMEDIOS","ARGENTINA","EXTRANJEROS",2,0,2
" 11","LOS REMEDIOS","ARGENTINA","TOTAL POBLACION",2,0,2
" 11","LOS REMEDIOS","AUSTRALIA","EXTRANJEROS",1,0,1
" 11","LOS REMEDIOS","AUSTRALIA","TOTAL POBLACION",1,0,1
" 11","LOS REMEDIOS","BELGICA","EXTRANJEROS",1,0,1
" 11","LOS REMEDIOS","BELGICA","TOTAL POBLACION",1,0,1
" 11","LOS REMEDIOS","BOLIVIA","EXTRANJEROS",4,3,7
" 11","LOS REMEDIOS","BOLIVIA","TOTAL POBLACION",4,3,7
" 11","LOS REMEDIOS","BRASIL","EXTRANJEROS",0,1,1
" 11","LOS REMEDIOS","BRASIL","TOTAL POBLACION",0,1,1
" 11","LOS REMEDIOS","CHILE","ESPA�OLES",1,1,2
" 11","LOS REMEDIOS","CHILE","TOTAL POBLACION",1,1,2
" 11","LOS REMEDIOS","CHINA","EXTRANJEROS",2,0,2
" 11","LOS REMEDIOS","CHINA","TOTAL POBLACION",2,0,2
" 11","LOS REMEDIOS","COLOMBIA","EXTRANJEROS",2,0,2
" 11","LOS REMEDIOS","COLOMBIA","TOTAL POBLACION",2,0,2
" 11","LOS REMEDIOS","CUBA","EXTRANJEROS",0,1,1
" 11","LOS REMEDIOS","CUBA","TOTAL POBLACION",0,1,1
" 11","LOS REMEDIOS","ECUADOR","ESPA�OLES",4,1,5
" 11","LOS REMEDIOS","ECUADOR","TOTAL POBLACION",4,1,5
" 11","LOS REMEDIOS","ESPA�A","ESPA�OLES",270,321,591
" 11","LOS REMEDIOS","ESPA�A","EXTRANJEROS",19,48,67
" 11","LOS REMEDIOS","ESPA�A","TOTAL POBLACION",289,369,658
" 11","LOS REMEDIOS","ESTADOS UNIDOS DE AMERICA","ESPA�OLES",1,4,5
" 11","LOS REMEDIOS","ESTADOS UNIDOS DE AMERICA","EXTRANJEROS",2,1,3
" 11","LOS REMEDIOS","ESTADOS UNIDOS DE AMERICA","TOTAL POBLACION",3,5,8
" 11","LOS REMEDIOS","FILIPINAS","EXTRANJEROS",0,1,1
" 11","LOS REMEDIOS","FILIPINAS","TOTAL POBLACION",0,1,1
" 11","LOS REMEDIOS","GUATEMALA","EXTRANJEROS",0,2,2
" 11","LOS REMEDIOS","GUATEMALA","TOTAL POBLACION",0,2,2
" 11","LOS REMEDIOS","HONDURAS","EXTRANJEROS",0,1,1
" 11","LOS REMEDIOS","HONDURAS","TOTAL POBLACION",0,1,1
" 11","LOS REMEDIOS","HUNGRIA","EXTRANJEROS",0,1,1
" 11","LOS REMEDIOS","HUNGRIA","TOTAL POBLACION",0,1,1
" 11","LOS REMEDIOS","IRLANDA","EXTRANJEROS",1,0,1
" 11","LOS REMEDIOS","IRLANDA","TOTAL POBLACION",1,0,1
" 11","LOS REMEDIOS","ITALIA","ESPA�OLES",1,0,1
" 11","LOS REMEDIOS","ITALIA","EXTRANJEROS",1,1,2
" 11","LOS REMEDIOS","ITALIA","TOTAL POBLACION",2,1,3
" 11","LOS REMEDIOS","MALASIA","EXTRANJEROS",0,1,1
" 11","LOS REMEDIOS","MALASIA","TOTAL POBLACION",0,1,1
" 11","LOS REMEDIOS","MARRUECOS","ESPA�OLES",0,1,1
" 11","LOS REMEDIOS","MARRUECOS","TOTAL POBLACION",0,1,1
" 11","LOS REMEDIOS","MEXICO","ESPA�OLES",1,0,1
" 11","LOS REMEDIOS","MEXICO","EXTRANJEROS",1,0,1
" 11","LOS REMEDIOS","MEXICO","TOTAL POBLACION",2,0,2
" 11","LOS REMEDIOS","NICARAGUA","EXTRANJEROS",1,12,13
" 11","LOS REMEDIOS","NICARAGUA","TOTAL POBLACION",1,12,13
" 11","LOS REMEDIOS","PAISES BAJOS","ESPA�OLES",1,0,1
" 11","LOS REMEDIOS","PAISES BAJOS","TOTAL POBLACION",1,0,1
" 11","LOS REMEDIOS","PAKISTAN","EXTRANJEROS",2,0,2
" 11","LOS REMEDIOS","PAKISTAN","TOTAL POBLACION",2,0,2
" 11","LOS REMEDIOS","PANAMA","ESPA�OLES",1,1,2
" 11","LOS REMEDIOS","PANAMA","TOTAL POBLACION",1,1,2
" 11","LOS REMEDIOS","PARAGUAY","EXTRANJEROS",2,1,3
" 11","LOS REMEDIOS","PARAGUAY","TOTAL POBLACION",2,1,3
" 11","LOS REMEDIOS","PERU","ESPA�OLES",1,1,2
" 11","LOS REMEDIOS","PERU","EXTRANJEROS",1,1,2
" 11","LOS REMEDIOS","PERU","TOTAL POBLACION",2,2,4
" 11","LOS REMEDIOS","REINO UNIDO","ESPA�OLES",0,2,2
" 11","LOS REMEDIOS","REINO UNIDO","TOTAL POBLACION",0,2,2
" 11","LOS REMEDIOS","REPUBLICA CHECA","EXTRANJEROS",0,1,1
" 11","LOS REMEDIOS","REPUBLICA CHECA","TOTAL POBLACION",0,1,1
" 11","LOS REMEDIOS","REPUBLICA DE COREA","EXTRANJEROS",0,1,1
" 11","LOS REMEDIOS","REPUBLICA DE COREA","TOTAL POBLACION",0,1,1
" 11","LOS REMEDIOS","REPUBLICA DOMINICANA","EXTRANJEROS",5,3,8
" 11","LOS REMEDIOS","REPUBLICA DOMINICANA","TOTAL POBLACION",5,3,8
" 11","LOS REMEDIOS","RUMANIA","EXTRANJEROS",1,2,3
" 11","LOS REMEDIOS","RUMANIA","TOTAL POBLACION",1,2,3
" 11","LOS REMEDIOS","SUECIA","ESPA�OLES",2,1,3
" 11","LOS REMEDIOS","SUECIA","TOTAL POBLACION",2,1,3
" 11","LOS REMEDIOS","SUIZA","EXTRANJEROS",0,1,1
" 11","LOS REMEDIOS","SUIZA","TOTAL POBLACION",0,1,1
" 11","LOS REMEDIOS","VENEZUELA","ESPA�OLES",0,2,2
" 11","LOS REMEDIOS","VENEZUELA","EXTRANJEROS",0,1,1
" 11","LOS REMEDIOS","VENEZUELA","TOTAL POBLACION",0,3,3
"00","TOTAL MUNICIPIO","- TODOS -","ESPA�OLES",6244,6454,12698
"00","TOTAL MUNICIPIO","- TODOS -","EXTRANJEROS",2044,2371,4415
"00","TOTAL MUNICIPIO","- TODOS -","TOTAL POBLACION",8288,8825,17113
"00","TOTAL MUNICIPIO","AFGANISTAN","EXTRANJEROS",13,5,18
"00","TOTAL MUNICIPIO","AFGANISTAN","TOTAL POBLACION",13,5,18
"00","TOTAL MUNICIPIO","ALBANIA","ESPA�OLES",1,0,1
"00","TOTAL MUNICIPIO","ALBANIA","TOTAL POBLACION",1,0,1
"00","TOTAL MUNICIPIO","ALEMANIA","ESPA�OLES",14,15,29
"00","TOTAL MUNICIPIO","ALEMANIA","EXTRANJEROS",22,16,38
"00","TOTAL MUNICIPIO","ALEMANIA","TOTAL POBLACION",36,31,67
"00","TOTAL MUNICIPIO","ARABIA SAUDITA","ESPA�OLES",1,0,1
"00","TOTAL MUNICIPIO","ARABIA SAUDITA","EXTRANJEROS",1,0,1
"00","TOTAL MUNICIPIO","ARABIA SAUDITA","TOTAL POBLACION",2,0,2
"00","TOTAL MUNICIPIO","ARGELIA","ESPA�OLES",1,1,2
"00","TOTAL MUNICIPIO","ARGELIA","EXTRANJEROS",19,5,24
"00","TOTAL MUNICIPIO","ARGELIA","TOTAL POBLACION",20,6,26
"00","TOTAL MUNICIPIO","ARGENTINA","ESPA�OLES",3,7,10
"00","TOTAL MUNICIPIO","ARGENTINA","EXTRANJEROS",20,14,34
"00","TOTAL MUNICIPIO","ARGENTINA","TOTAL POBLACION",23,21,44
"00","TOTAL MUNICIPIO","ARMENIA","EXTRANJEROS",2,2,4
"00","TOTAL MUNICIPIO","ARMENIA","TOTAL POBLACION",2,2,4
"00","TOTAL MUNICIPIO","AUSTRALIA","ESPA�OLES",2,2,4
"00","TOTAL MUNICIPIO","AUSTRALIA","EXTRANJEROS",6,4,10
"00","TOTAL MUNICIPIO","AUSTRALIA","TOTAL POBLACION",8,6,14
"00","TOTAL MUNICIPIO","AUSTRIA","EXTRANJEROS",1,3,4
"00","TOTAL MUNICIPIO","AUSTRIA","TOTAL POBLACION",1,3,4
"00","TOTAL MUNICIPIO","AZERBAIYAN","EXTRANJEROS",3,1,4
"00","TOTAL MUNICIPIO","AZERBAIYAN","TOTAL POBLACION",3,1,4
"00","TOTAL MUNICIPIO","BAHREIN","ESPA�OLES",1,0,1
"00","TOTAL MUNICIPIO","BAHREIN","TOTAL POBLACION",1,0,1
"00","TOTAL MUNICIPIO","BANGLA-DESH","EXTRANJEROS",2,0,2
"00","TOTAL MUNICIPIO","BANGLA-DESH","TOTAL POBLACION",2,0,2
"00","TOTAL MUNICIPIO","BELGICA","ESPA�OLES",9,6,15
"00","TOTAL MUNICIPIO","BELGICA","EXTRANJEROS",5,7,12
"00","TOTAL MUNICIPIO","BELGICA","TOTAL POBLACION",14,13,27
"00","TOTAL MUNICIPIO","BIELORUSIA","EXTRANJEROS",1,1,2
"00","TOTAL MUNICIPIO","BIELORUSIA","TOTAL POBLACION",1,1,2
"00","TOTAL MUNICIPIO","BOLIVIA","ESPA�OLES",6,4,10
"00","TOTAL MUNICIPIO","BOLIVIA","EXTRANJEROS",44,43,87
"00","TOTAL MUNICIPIO","BOLIVIA","TOTAL POBLACION",50,47,97
"00","TOTAL MUNICIPIO","BOSNIA-HERZEGOVINA","ESPA�OLES",1,0,1
"00","TOTAL MUNICIPIO","BOSNIA-HERZEGOVINA","TOTAL POBLACION",1,0,1
"00","TOTAL MUNICIPIO","BRASIL","ESPA�OLES",5,2,7
"00","TOTAL MUNICIPIO","BRASIL","EXTRANJEROS",20,43,63
"00","TOTAL MUNICIPIO","BRASIL","TOTAL POBLACION",25,45,70
"00","TOTAL MUNICIPIO","BULGARIA","EXTRANJEROS",5,3,8
"00","TOTAL MUNICIPIO","BULGARIA","TOTAL POBLACION",5,3,8
"00","TOTAL MUNICIPIO","CABO VERDE","ESPA�OLES",1,0,1
"00","TOTAL MUNICIPIO","CABO VERDE","EXTRANJEROS",1,0,1
"00","TOTAL MUNICIPIO","CABO VERDE","TOTAL POBLACION",2,0,2
"00","TOTAL MUNICIPIO","CAMBOYA","ESPA�OLES",1,0,1
"00","TOTAL MUNICIPIO","CAMBOYA","TOTAL POBLACION",1,0,1
"00","TOTAL MUNICIPIO","CAMERUN","ESPA�OLES",0,1,1
"00","TOTAL MUNICIPIO","CAMERUN","EXTRANJEROS",14,2,16
"00","TOTAL MUNICIPIO","CAMERUN","TOTAL POBLACION",14,3,17
"00","TOTAL MUNICIPIO","CANADA","ESPA�OLES",1,0,1
"00","TOTAL MUNICIPIO","CANADA","EXTRANJEROS",2,3,5
"00","TOTAL MUNICIPIO","CANADA","TOTAL POBLACION",3,3,6
"00","TOTAL MUNICIPIO","CHILE","ESPA�OLES",7,5,12
"00","TOTAL MUNICIPIO","CHILE","EXTRANJEROS",4,3,7
"00","TOTAL MUNICIPIO","CHILE","TOTAL POBLACION",11,8,19
"00","TOTAL MUNICIPIO","CHINA","ESPA�OLES",5,7,12
"00","TOTAL MUNICIPIO","CHINA","EXTRANJEROS",58,67,125
"00","TOTAL MUNICIPIO","CHINA","TOTAL POBLACION",63,74,137
"00","TOTAL MUNICIPIO","CHIPRE","EXTRANJEROS",1,1,2
"00","TOTAL MUNICIPIO","CHIPRE","TOTAL POBLACION",1,1,2
"00","TOTAL MUNICIPIO","COLOMBIA","ESPA�OLES",8,6,14
"00","TOTAL MUNICIPIO","COLOMBIA","EXTRANJEROS",33,55,88
"00","TOTAL MUNICIPIO","COLOMBIA","TOTAL POBLACION",41,61,102
"00","TOTAL MUNICIPIO","CONGO","EXTRANJEROS",2,0,2
"00","TOTAL MUNICIPIO","CONGO","TOTAL POBLACION",2,0,2
"00","TOTAL MUNICIPIO","COSTA DE MARFIL","EXTRANJEROS",3,3,6
"00","TOTAL MUNICIPIO","COSTA DE MARFIL","TOTAL POBLACION",3,3,6
"00","TOTAL MUNICIPIO","COSTA RICA","ESPA�OLES",1,3,4
"00","TOTAL MUNICIPIO","COSTA RICA","EXTRANJEROS",3,5,8
"00","TOTAL MUNICIPIO","COSTA RICA","TOTAL POBLACION",4,8,12
"00","TOTAL MUNICIPIO","CROACIA","EXTRANJEROS",1,1,2
"00","TOTAL MUNICIPIO","CROACIA","TOTAL POBLACION",1,1,2
"00","TOTAL MUNICIPIO","CUBA","ESPA�OLES",7,14,21
"00","TOTAL MUNICIPIO","CUBA","EXTRANJEROS",18,23,41
"00","TOTAL MUNICIPIO","CUBA","TOTAL POBLACION",25,37,62
"00","TOTAL MUNICIPIO","ECUADOR","ESPA�OLES",14,18,32
"00","TOTAL MUNICIPIO","ECUADOR","EXTRANJEROS",12,12,24
"00","TOTAL MUNICIPIO","ECUADOR","TOTAL POBLACION",26,30,56
"00","TOTAL MUNICIPIO","EGIPTO","ESPA�OLES",1,1,2
"00","TOTAL MUNICIPIO","EGIPTO","EXTRANJEROS",2,3,5
"00","TOTAL MUNICIPIO","EGIPTO","TOTAL POBLACION",3,4,7
"00","TOTAL MUNICIPIO","EL SALVADOR","EXTRANJEROS",7,19,26
"00","TOTAL MUNICIPIO","EL SALVADOR","TOTAL POBLACION",7,19,26
"00","TOTAL MUNICIPIO","EMIRATOS ARABES UNIDOS","ESPA�OLES",5,4,9
"00","TOTAL MUNICIPIO","EMIRATOS ARABES UNIDOS","TOTAL POBLACION",5,4,9
"00","TOTAL MUNICIPIO","ERITREA","EXTRANJEROS",1,0,1
"00","TOTAL MUNICIPIO","ERITREA","TOTAL POBLACION",1,0,1
"00","TOTAL MUNICIPIO","ESLOVAQUIA","EXTRANJEROS",0,1,1
"00","TOTAL MUNICIPIO","ESLOVAQUIA","TOTAL POBLACION",0,1,1
"00","TOTAL MUNICIPIO","ESPA�A","ESPA�OLES",6001,6188,12189
"00","TOTAL MUNICIPIO","ESPA�A","EXTRANJEROS",1037,1144,2181
"00","TOTAL MUNICIPIO","ESPA�A","TOTAL POBLACION",7038,7332,14370
"00","TOTAL MUNICIPIO","ESTADOS UNIDOS DE AMERICA","ESPA�OLES",44,40,84
"00","TOTAL MUNICIPIO","ESTADOS UNIDOS DE AMERICA","EXTRANJEROS",25,36,61
"00","TOTAL MUNICIPIO","ESTADOS UNIDOS DE AMERICA","TOTAL POBLACION",69,76,145
"00","TOTAL MUNICIPIO","ETIOPIA","ESPA�OLES",0,1,1
"00","TOTAL MUNICIPIO","ETIOPIA","EXTRANJEROS",2,0,2
"00","TOTAL MUNICIPIO","ETIOPIA","TOTAL POBLACION",2,1,3
"00","TOTAL MUNICIPIO","FILIPINAS","ESPA�OLES",0,1,1
"00","TOTAL MUNICIPIO","FILIPINAS","EXTRANJEROS",3,13,16
"00","TOTAL MUNICIPIO","FILIPINAS","TOTAL POBLACION",3,14,17
"00","TOTAL MUNICIPIO","FINLANDIA","ESPA�OLES",1,0,1
"00","TOTAL MUNICIPIO","FINLANDIA","EXTRANJEROS",0,2,2
"00","TOTAL MUNICIPIO","FINLANDIA","TOTAL POBLACION",1,2,3
"00","TOTAL MUNICIPIO","FRANCIA","ESPA�OLES",21,20,41
"00","TOTAL MUNICIPIO","FRANCIA","EXTRANJEROS",33,31,64
"00","TOTAL MUNICIPIO","FRANCIA","TOTAL POBLACION",54,51,105
"00","TOTAL MUNICIPIO","GABON","EXTRANJEROS",2,1,3
"00","TOTAL MUNICIPIO","GABON","TOTAL POBLACION",2,1,3
"00","TOTAL MUNICIPIO","GAMBIA","EXTRANJEROS",0,1,1
"00","TOTAL MUNICIPIO","GAMBIA","TOTAL POBLACION",0,1,1
"00","TOTAL MUNICIPIO","GEORGIA","EXTRANJEROS",10,6,16
"00","TOTAL MUNICIPIO","GEORGIA","TOTAL POBLACION",10,6,16
"00","TOTAL MUNICIPIO","GHANA","ESPA�OLES",0,1,1
"00","TOTAL MUNICIPIO","GHANA","EXTRANJEROS",1,0,1
"00","TOTAL MUNICIPIO","GHANA","TOTAL POBLACION",1,1,2
"00","TOTAL MUNICIPIO","GRECIA","EXTRANJEROS",1,2,3
"00","TOTAL MUNICIPIO","GRECIA","TOTAL POBLACION",1,2,3
"00","TOTAL MUNICIPIO","GUATEMALA","EXTRANJEROS",5,8,13
"00","TOTAL MUNICIPIO","GUATEMALA","TOTAL POBLACION",5,8,13
"00","TOTAL MUNICIPIO","GUINEA","EXTRANJEROS",4,3,7
"00","TOTAL MUNICIPIO","GUINEA","TOTAL POBLACION",4,3,7
"00","TOTAL MUNICIPIO","GUINEA BISSAU","ESPA�OLES",1,0,1
"00","TOTAL MUNICIPIO","GUINEA BISSAU","EXTRANJEROS",0,1,1
"00","TOTAL MUNICIPIO","GUINEA BISSAU","TOTAL POBLACION",1,1,2
"00","TOTAL MUNICIPIO","GUINEA ECUATORIAL","ESPA�OLES",2,2,4
"00","TOTAL MUNICIPIO","GUINEA ECUATORIAL","EXTRANJEROS",0,4,4
"00","TOTAL MUNICIPIO","GUINEA ECUATORIAL","TOTAL POBLACION",2,6,8
"00","TOTAL MUNICIPIO","HAITI","EXTRANJEROS",1,0,1
"00","TOTAL MUNICIPIO","HAITI","TOTAL POBLACION",1,0,1
"00","TOTAL MUNICIPIO","HONDURAS","ESPA�OLES",1,0,1
"00","TOTAL MUNICIPIO","HONDURAS","EXTRANJEROS",8,28,36
"00","TOTAL MUNICIPIO","HONDURAS","TOTAL POBLACION",9,28,37
"00","TOTAL MUNICIPIO","HUNGRIA","EXTRANJEROS",3,2,5
"00","TOTAL MUNICIPIO","HUNGRIA","TOTAL POBLACION",3,2,5
"00","TOTAL MUNICIPIO","INDIA","EXTRANJEROS",3,0,3
"00","TOTAL MUNICIPIO","INDIA","TOTAL POBLACION",3,0,3
"00","TOTAL MUNICIPIO","IRAK","EXTRANJEROS",2,0,2
"00","TOTAL MUNICIPIO","IRAK","TOTAL POBLACION",2,0,2
"00","TOTAL MUNICIPIO","IRAN","EXTRANJEROS",4,0,4
"00","TOTAL MUNICIPIO","IRAN","TOTAL POBLACION",4,0,4
"00","TOTAL MUNICIPIO","IRLANDA","ESPA�OLES",1,3,4
"00","TOTAL MUNICIPIO","IRLANDA","EXTRANJEROS",3,2,5
"00","TOTAL MUNICIPIO","IRLANDA","TOTAL POBLACION",4,5,9
"00","TOTAL MUNICIPIO","ISLANDIA","EXTRANJEROS",1,2,3
"00","TOTAL MUNICIPIO","ISLANDIA","TOTAL POBLACION",1,2,3
"00","TOTAL MUNICIPIO","ISRAEL","ESPA�OLES",0,1,1
"00","TOTAL MUNICIPIO","ISRAEL","EXTRANJEROS",2,1,3
"00","TOTAL MUNICIPIO","ISRAEL","TOTAL POBLACION",2,2,4
"00","TOTAL MUNICIPIO","ITALIA","ESPA�OLES",5,4,9
"00","TOTAL MUNICIPIO","ITALIA","EXTRANJEROS",51,55,106
"00","TOTAL MUNICIPIO","ITALIA","TOTAL POBLACION",56,59,115
"00","TOTAL MUNICIPIO","JAPON","ESPA�OLES",0,1,1
"00","TOTAL MUNICIPIO","JAPON","EXTRANJEROS",2,7,9
"00","TOTAL MUNICIPIO","JAPON","TOTAL POBLACION",2,8,10
"00","TOTAL MUNICIPIO","JORDANIA","ESPA�OLES",1,0,1
"00","TOTAL MUNICIPIO","JORDANIA","EXTRANJEROS",2,2,4
"00","TOTAL MUNICIPIO","JORDANIA","TOTAL POBLACION",3,2,5
"00","TOTAL MUNICIPIO","KAZAJSTAN","ESPA�OLES",1,0,1
"00","TOTAL MUNICIPIO","KAZAJSTAN","EXTRANJEROS",1,1,2
"00","TOTAL MUNICIPIO","KAZAJSTAN","TOTAL POBLACION",2,1,3
"00","TOTAL MUNICIPIO","KENIA","EXTRANJEROS",1,1,2
"00","TOTAL MUNICIPIO","KENIA","TOTAL POBLACION",1,1,2
"00","TOTAL MUNICIPIO","LETONIA","EXTRANJEROS",0,1,1
"00","TOTAL MUNICIPIO","LETONIA","TOTAL POBLACION",0,1,1
"00","TOTAL MUNICIPIO","LIBANO","ESPA�OLES",0,1,1
"00","TOTAL MUNICIPIO","LIBANO","EXTRANJEROS",9,5,14
"00","TOTAL MUNICIPIO","LIBANO","TOTAL POBLACION",9,6,15
"00","TOTAL MUNICIPIO","LIBIA","EXTRANJEROS",1,1,2
"00","TOTAL MUNICIPIO","LIBIA","TOTAL POBLACION",1,1,2
"00","TOTAL MUNICIPIO","LITUANIA","EXTRANJEROS",1,4,5
"00","TOTAL MUNICIPIO","LITUANIA","TOTAL POBLACION",1,4,5
"00","TOTAL MUNICIPIO","LUXEMBURGO","ESPA�OLES",1,1,2
"00","TOTAL MUNICIPIO","LUXEMBURGO","TOTAL POBLACION",1,1,2
"00","TOTAL MUNICIPIO","MALASIA","EXTRANJEROS",0,1,1
"00","TOTAL MUNICIPIO","MALASIA","TOTAL POBLACION",0,1,1
"00","TOTAL MUNICIPIO","MALI","EXTRANJEROS",12,0,12
"00","TOTAL MUNICIPIO","MALI","TOTAL POBLACION",12,0,12
"00","TOTAL MUNICIPIO","MALTA","ESPA�OLES",0,1,1
"00","TOTAL MUNICIPIO","MALTA","TOTAL POBLACION",0,1,1
"00","TOTAL MUNICIPIO","MARRUECOS","ESPA�OLES",7,8,15
"00","TOTAL MUNICIPIO","MARRUECOS","EXTRANJEROS",84,74,158
"00","TOTAL MUNICIPIO","MARRUECOS","TOTAL POBLACION",91,82,173
"00","TOTAL MUNICIPIO","MEXICO","ESPA�OLES",8,8,16
"00","TOTAL MUNICIPIO","MEXICO","EXTRANJEROS",17,25,42
"00","TOTAL MUNICIPIO","MEXICO","TOTAL POBLACION",25,33,58
"00","TOTAL MUNICIPIO","MOLDAVIA","EXTRANJEROS",1,2,3
"00","TOTAL MUNICIPIO","MOLDAVIA","TOTAL POBLACION",1,2,3
"00","TOTAL MUNICIPIO","MOZAMBIQUE","ESPA�OLES",0,1,1
"00","TOTAL MUNICIPIO","MOZAMBIQUE","TOTAL POBLACION",0,1,1
"00","TOTAL MUNICIPIO","NEPAL","EXTRANJEROS",1,0,1
"00","TOTAL MUNICIPIO","NEPAL","TOTAL POBLACION",1,0,1
"00","TOTAL MUNICIPIO","NICARAGUA","ESPA�OLES",2,1,3
"00","TOTAL MUNICIPIO","NICARAGUA","EXTRANJEROS",33,167,200
"00","TOTAL MUNICIPIO","NICARAGUA","TOTAL POBLACION",35,168,203
"00","TOTAL MUNICIPIO","NIGERIA","EXTRANJEROS",13,14,27
"00","TOTAL MUNICIPIO","NIGERIA","TOTAL POBLACION",13,14,27
"00","TOTAL MUNICIPIO","NORUEGA","EXTRANJEROS",2,2,4
"00","TOTAL MUNICIPIO","NORUEGA","TOTAL POBLACION",2,2,4
"00","TOTAL MUNICIPIO","OTROS PAISES SIN RELACION DIPLOMATICA","EXTRANJEROS",13,1,14
"00","TOTAL MUNICIPIO","OTROS PAISES SIN RELACION DIPLOMATICA","TOTAL POBLACION",13,1,14
"00","TOTAL MUNICIPIO","PAISES BAJOS","ESPA�OLES",2,8,10
"00","TOTAL MUNICIPIO","PAISES BAJOS","EXTRANJEROS",2,4,6
"00","TOTAL MUNICIPIO","PAISES BAJOS","TOTAL POBLACION",4,12,16
"00","TOTAL MUNICIPIO","PAKISTAN","EXTRANJEROS",11,4,15
"00","TOTAL MUNICIPIO","PAKISTAN","TOTAL POBLACION",11,4,15
"00","TOTAL MUNICIPIO","PALESTINA. ESTADO OBSERVADOR, NO MIEMBRO DE NACIONES UNIDAS","ESPA�OLES",0,1,1
"00","TOTAL MUNICIPIO","PALESTINA. ESTADO OBSERVADOR, NO MIEMBRO DE NACIONES UNIDAS","EXTRANJEROS",1,0,1
"00","TOTAL MUNICIPIO","PALESTINA. ESTADO OBSERVADOR, NO MIEMBRO DE NACIONES UNIDAS","TOTAL POBLACION",1,1,2
"00","TOTAL MUNICIPIO","PANAMA","ESPA�OLES",3,3,6
"00","TOTAL MUNICIPIO","PANAMA","EXTRANJEROS",2,3,5
"00","TOTAL MUNICIPIO","PANAMA","TOTAL POBLACION",5,6,11
"00","TOTAL MUNICIPIO","PARAGUAY","EXTRANJEROS",15,33,48
"00","TOTAL MUNICIPIO","PARAGUAY","TOTAL POBLACION",15,33,48
"00","TOTAL MUNICIPIO","PERU","ESPA�OLES",10,13,23
"00","TOTAL MUNICIPIO","PERU","EXTRANJEROS",19,24,43
"00","TOTAL MUNICIPIO","PERU","TOTAL POBLACION",29,37,66
"00","TOTAL MUNICIPIO","POLONIA","EXTRANJEROS",1,7,8
"00","TOTAL MUNICIPIO","POLONIA","TOTAL POBLACION",1,7,8
"00","TOTAL MUNICIPIO","PORTUGAL","ESPA�OLES",3,4,7
"00","TOTAL MUNICIPIO","PORTUGAL","EXTRANJEROS",21,15,36
"00","TOTAL MUNICIPIO","PORTUGAL","TOTAL POBLACION",24,19,43
"00","TOTAL MUNICIPIO","PRINCIPADO DE ANDORRA","ESPA�OLES",1,1,2
"00","TOTAL MUNICIPIO","PRINCIPADO DE ANDORRA","TOTAL POBLACION",1,1,2
"00","TOTAL MUNICIPIO","REINO UNIDO","ESPA�OLES",14,19,33
"00","TOTAL MUNICIPIO","REINO UNIDO","EXTRANJEROS",22,19,41
"00","TOTAL MUNICIPIO","REINO UNIDO","TOTAL POBLACION",36,38,74
"00","TOTAL MUNICIPIO","REPUBLICA CHECA","EXTRANJEROS",1,1,2
"00","TOTAL MUNICIPIO","REPUBLICA CHECA","TOTAL POBLACION",1,1,2
"00","TOTAL MUNICIPIO","REPUBLICA DE COREA","EXTRANJEROS",5,10,15
"00","TOTAL MUNICIPIO","REPUBLICA DE COREA","TOTAL POBLACION",5,10,15
"00","TOTAL MUNICIPIO","REPUBLICA DEMOCRATICA DEL CONGO","EXTRANJEROS",3,3,6
"00","TOTAL MUNICIPIO","REPUBLICA DEMOCRATICA DEL CONGO","TOTAL POBLACION",3,3,6
"00","TOTAL MUNICIPIO","REPUBLICA DOMINICANA","ESPA�OLES",1,1,2
"00","TOTAL MUNICIPIO","REPUBLICA DOMINICANA","EXTRANJEROS",15,31,46
"00","TOTAL MUNICIPIO","REPUBLICA DOMINICANA","TOTAL POBLACION",16,32,48
"00","TOTAL MUNICIPIO","REPUBLICA SUDAFRICANA","ESPA�OLES",0,1,1
"00","TOTAL MUNICIPIO","REPUBLICA SUDAFRICANA","EXTRANJEROS",1,0,1
"00","TOTAL MUNICIPIO","REPUBLICA SUDAFRICANA","TOTAL POBLACION",1,1,2
"00","TOTAL MUNICIPIO","RUMANIA","EXTRANJEROS",77,72,149
"00","TOTAL MUNICIPIO","RUMANIA","TOTAL POBLACION",77,72,149
"00","TOTAL MUNICIPIO","RUSIA","ESPA�OLES",1,0,1
"00","TOTAL MUNICIPIO","RUSIA","EXTRANJEROS",14,30,44
"00","TOTAL MUNICIPIO","RUSIA","TOTAL POBLACION",15,30,45
"00","TOTAL MUNICIPIO","SAN MARINO","EXTRANJEROS",1,1,2
"00","TOTAL MUNICIPIO","SAN MARINO","TOTAL POBLACION",1,1,2
"00","TOTAL MUNICIPIO","SENEGAL","ESPA�OLES",0,1,1
"00","TOTAL MUNICIPIO","SENEGAL","EXTRANJEROS",25,5,30
"00","TOTAL MUNICIPIO","SENEGAL","TOTAL POBLACION",25,6,31
"00","TOTAL MUNICIPIO","SERBIA","EXTRANJEROS",1,3,4
"00","TOTAL MUNICIPIO","SERBIA","TOTAL POBLACION",1,3,4
"00","TOTAL MUNICIPIO","SIERRA LEONA","EXTRANJEROS",1,0,1
"00","TOTAL MUNICIPIO","SIERRA LEONA","TOTAL POBLACION",1,0,1
"00","TOTAL MUNICIPIO","SINGAPUR","ESPA�OLES",1,1,2
"00","TOTAL MUNICIPIO","SINGAPUR","EXTRANJEROS",1,0,1
"00","TOTAL MUNICIPIO","SINGAPUR","TOTAL POBLACION",2,1,3
"00","TOTAL MUNICIPIO","SIRIA","ESPA�OLES",1,1,2
"00","TOTAL MUNICIPIO","SIRIA","EXTRANJEROS",22,17,39
"00","TOTAL MUNICIPIO","SIRIA","TOTAL POBLACION",23,18,41
"00","TOTAL MUNICIPIO","SOMALIA","EXTRANJEROS",2,6,8
"00","TOTAL MUNICIPIO","SOMALIA","TOTAL POBLACION",2,6,8
"00","TOTAL MUNICIPIO","SUDAN","EXTRANJEROS",1,0,1
"00","TOTAL MUNICIPIO","SUDAN","TOTAL POBLACION",1,0,1
"00","TOTAL MUNICIPIO","SUECIA","ESPA�OLES",2,2,4
"00","TOTAL MUNICIPIO","SUECIA","EXTRANJEROS",3,2,5
"00","TOTAL MUNICIPIO","SUECIA","TOTAL POBLACION",5,4,9
"00","TOTAL MUNICIPIO","SUIZA","ESPA�OLES",2,1,3
"00","TOTAL MUNICIPIO","SUIZA","EXTRANJEROS",1,1,2
"00","TOTAL MUNICIPIO","SUIZA","TOTAL POBLACION",3,2,5
"00","TOTAL MUNICIPIO","TAILANDIA","EXTRANJEROS",0,1,1
"00","TOTAL MUNICIPIO","TAILANDIA","TOTAL POBLACION",0,1,1
"00","TOTAL MUNICIPIO","TCHAD","EXTRANJEROS",1,0,1
"00","TOTAL MUNICIPIO","TCHAD","TOTAL POBLACION",1,0,1
"00","TOTAL MUNICIPIO","TOGO","EXTRANJEROS",1,0,1
"00","TOTAL MUNICIPIO","TOGO","TOTAL POBLACION",1,0,1
"00","TOTAL MUNICIPIO","TUNEZ","EXTRANJEROS",1,0,1
"00","TOTAL MUNICIPIO","TUNEZ","TOTAL POBLACION",1,0,1
"00","TOTAL MUNICIPIO","TURQUIA","ESPA�OLES",1,0,1
"00","TOTAL MUNICIPIO","TURQUIA","EXTRANJEROS",0,2,2
"00","TOTAL MUNICIPIO","TURQUIA","TOTAL POBLACION",1,2,3
"00","TOTAL MUNICIPIO","UCRANIA","EXTRANJEROS",22,31,53
"00","TOTAL MUNICIPIO","UCRANIA","TOTAL POBLACION",22,31,53
"00","TOTAL MUNICIPIO","URUGUAY","ESPA�OLES",2,5,7
"00","TOTAL MUNICIPIO","URUGUAY","EXTRANJEROS",3,4,7
"00","TOTAL MUNICIPIO","URUGUAY","TOTAL POBLACION",5,9,14
"00","TOTAL MUNICIPIO","UZBEKISTAN","EXTRANJEROS",1,0,1
"00","TOTAL MUNICIPIO","UZBEKISTAN","TOTAL POBLACION",1,0,1
"00","TOTAL MUNICIPIO","VENEZUELA","ESPA�OLES",8,13,21
"00","TOTAL MUNICIPIO","VENEZUELA","EXTRANJEROS",27,46,73
"00","TOTAL MUNICIPIO","VENEZUELA","TOTAL POBLACION",35,59,94
"00","TOTAL MUNICIPIO","VIET-NAM","EXTRANJEROS",0,1,1
"00","TOTAL MUNICIPIO","VIET-NAM","TOTAL POBLACION",0,1,1
