"CD","ND","DESTINO","NACION","HOMBRES","MUJERES","TOTAL"
" 01","CASCO ANTIGUO","- FUERA DE LA PROVINCIA DE SEVILLA","ESPAÑOLES",388,466,854
" 01","CASCO ANTIGUO","- FUERA DE LA PROVINCIA DE SEVILLA","EXTRANJEROS",81,83,164
" 01","CASCO ANTIGUO","- FUERA DE LA PROVINCIA DE SEVILLA","NO CONSTA",1,1,2
" 01","CASCO ANTIGUO","- FUERA DE LA PROVINCIA DE SEVILLA","TOTAL POBLACION",470,550,1020
" 01","CASCO ANTIGUO","- PROVINCIA DE SEVILLA","ESPAÑOLES",314,327,641
" 01","CASCO ANTIGUO","- PROVINCIA DE SEVILLA","EXTRANJEROS",24,30,54
" 01","CASCO ANTIGUO","- PROVINCIA DE SEVILLA","TOTAL POBLACION",338,357,695
" 01","CASCO ANTIGUO","AGUADULCE","ESPAÑOLES",0,1,1
" 01","CASCO ANTIGUO","AGUADULCE","TOTAL POBLACION",0,1,1
" 01","CASCO ANTIGUO","ALBAIDA DEL ALJARAFE","ESPAÑOLES",1,1,2
" 01","CASCO ANTIGUO","ALBAIDA DEL ALJARAFE","TOTAL POBLACION",1,1,2
" 01","CASCO ANTIGUO","ALCALA DE GUADAIRA","ESPAÑOLES",14,17,31
" 01","CASCO ANTIGUO","ALCALA DE GUADAIRA","EXTRANJEROS",4,2,6
" 01","CASCO ANTIGUO","ALCALA DE GUADAIRA","TOTAL POBLACION",18,19,37
" 01","CASCO ANTIGUO","ALCALA DEL RIO","ESPAÑOLES",2,3,5
" 01","CASCO ANTIGUO","ALCALA DEL RIO","TOTAL POBLACION",2,3,5
" 01","CASCO ANTIGUO","ALGABA (LA)","ESPAÑOLES",1,3,4
" 01","CASCO ANTIGUO","ALGABA (LA)","EXTRANJEROS",0,1,1
" 01","CASCO ANTIGUO","ALGABA (LA)","TOTAL POBLACION",1,4,5
" 01","CASCO ANTIGUO","ALMADEN DE LA PLATA","ESPAÑOLES",2,0,2
" 01","CASCO ANTIGUO","ALMADEN DE LA PLATA","TOTAL POBLACION",2,0,2
" 01","CASCO ANTIGUO","ALMENSILLA","ESPAÑOLES",2,3,5
" 01","CASCO ANTIGUO","ALMENSILLA","TOTAL POBLACION",2,3,5
" 01","CASCO ANTIGUO","ARAHAL (EL)","ESPAÑOLES",2,1,3
" 01","CASCO ANTIGUO","ARAHAL (EL)","TOTAL POBLACION",2,1,3
" 01","CASCO ANTIGUO","AZNALCAZAR","ESPAÑOLES",4,1,5
" 01","CASCO ANTIGUO","AZNALCAZAR","TOTAL POBLACION",4,1,5
" 01","CASCO ANTIGUO","BENACAZON","ESPAÑOLES",0,3,3
" 01","CASCO ANTIGUO","BENACAZON","TOTAL POBLACION",0,3,3
" 01","CASCO ANTIGUO","BOLLULLOS DE LA MITACION","ESPAÑOLES",3,9,12
" 01","CASCO ANTIGUO","BOLLULLOS DE LA MITACION","EXTRANJEROS",3,1,4
" 01","CASCO ANTIGUO","BOLLULLOS DE LA MITACION","TOTAL POBLACION",6,10,16
" 01","CASCO ANTIGUO","BORMUJOS","ESPAÑOLES",14,4,18
" 01","CASCO ANTIGUO","BORMUJOS","EXTRANJEROS",1,0,1
" 01","CASCO ANTIGUO","BORMUJOS","TOTAL POBLACION",15,4,19
" 01","CASCO ANTIGUO","BRENES","EXTRANJEROS",0,1,1
" 01","CASCO ANTIGUO","BRENES","TOTAL POBLACION",0,1,1
" 01","CASCO ANTIGUO","BURGUILLOS","ESPAÑOLES",3,1,4
" 01","CASCO ANTIGUO","BURGUILLOS","TOTAL POBLACION",3,1,4
" 01","CASCO ANTIGUO","CABEZAS DE SAN JUAN (LAS)","ESPAÑOLES",0,2,2
" 01","CASCO ANTIGUO","CABEZAS DE SAN JUAN (LAS)","EXTRANJEROS",0,1,1
" 01","CASCO ANTIGUO","CABEZAS DE SAN JUAN (LAS)","TOTAL POBLACION",0,3,3
" 01","CASCO ANTIGUO","CAMAS","ESPAÑOLES",15,25,40
" 01","CASCO ANTIGUO","CAMAS","EXTRANJEROS",3,2,5
" 01","CASCO ANTIGUO","CAMAS","TOTAL POBLACION",18,27,45
" 01","CASCO ANTIGUO","CANTILLANA","ESPAÑOLES",4,2,6
" 01","CASCO ANTIGUO","CANTILLANA","TOTAL POBLACION",4,2,6
" 01","CASCO ANTIGUO","CARMONA","ESPAÑOLES",10,7,17
" 01","CASCO ANTIGUO","CARMONA","EXTRANJEROS",0,1,1
" 01","CASCO ANTIGUO","CARMONA","TOTAL POBLACION",10,8,18
" 01","CASCO ANTIGUO","CARRION DE LOS CESPEDES","ESPAÑOLES",0,1,1
" 01","CASCO ANTIGUO","CARRION DE LOS CESPEDES","TOTAL POBLACION",0,1,1
" 01","CASCO ANTIGUO","CASTILBLANCO DE LOS ARROYOS","ESPAÑOLES",2,3,5
" 01","CASCO ANTIGUO","CASTILBLANCO DE LOS ARROYOS","TOTAL POBLACION",2,3,5
" 01","CASCO ANTIGUO","CASTILLEJA DE GUZMAN","ESPAÑOLES",3,5,8
" 01","CASCO ANTIGUO","CASTILLEJA DE GUZMAN","TOTAL POBLACION",3,5,8
" 01","CASCO ANTIGUO","CASTILLEJA DE LA CUESTA","ESPAÑOLES",8,9,17
" 01","CASCO ANTIGUO","CASTILLEJA DE LA CUESTA","TOTAL POBLACION",8,9,17
" 01","CASCO ANTIGUO","CASTILLO DE LAS GUARDAS (EL)","ESPAÑOLES",0,2,2
" 01","CASCO ANTIGUO","CASTILLO DE LAS GUARDAS (EL)","EXTRANJEROS",0,2,2
" 01","CASCO ANTIGUO","CASTILLO DE LAS GUARDAS (EL)","TOTAL POBLACION",0,4,4
" 01","CASCO ANTIGUO","CAZALLA DE LA SIERRA","ESPAÑOLES",0,1,1
" 01","CASCO ANTIGUO","CAZALLA DE LA SIERRA","TOTAL POBLACION",0,1,1
" 01","CASCO ANTIGUO","CONSTANTINA","ESPAÑOLES",1,1,2
" 01","CASCO ANTIGUO","CONSTANTINA","TOTAL POBLACION",1,1,2
" 01","CASCO ANTIGUO","CORIA DEL RIO","ESPAÑOLES",7,6,13
" 01","CASCO ANTIGUO","CORIA DEL RIO","TOTAL POBLACION",7,6,13
" 01","CASCO ANTIGUO","CORONIL (EL)","ESPAÑOLES",0,2,2
" 01","CASCO ANTIGUO","CORONIL (EL)","TOTAL POBLACION",0,2,2
" 01","CASCO ANTIGUO","DOS HERMANAS","ESPAÑOLES",29,26,55
" 01","CASCO ANTIGUO","DOS HERMANAS","EXTRANJEROS",2,4,6
" 01","CASCO ANTIGUO","DOS HERMANAS","TOTAL POBLACION",31,30,61
" 01","CASCO ANTIGUO","ESPARTINAS","ESPAÑOLES",22,24,46
" 01","CASCO ANTIGUO","ESPARTINAS","TOTAL POBLACION",22,24,46
" 01","CASCO ANTIGUO","GELVES","ESPAÑOLES",7,8,15
" 01","CASCO ANTIGUO","GELVES","TOTAL POBLACION",7,8,15
" 01","CASCO ANTIGUO","GERENA","ESPAÑOLES",9,7,16
" 01","CASCO ANTIGUO","GERENA","TOTAL POBLACION",9,7,16
" 01","CASCO ANTIGUO","GINES","ESPAÑOLES",16,7,23
" 01","CASCO ANTIGUO","GINES","EXTRANJEROS",1,0,1
" 01","CASCO ANTIGUO","GINES","TOTAL POBLACION",17,7,24
" 01","CASCO ANTIGUO","GUADALCANAL","ESPAÑOLES",0,1,1
" 01","CASCO ANTIGUO","GUADALCANAL","TOTAL POBLACION",0,1,1
" 01","CASCO ANTIGUO","GUILLENA","ESPAÑOLES",4,6,10
" 01","CASCO ANTIGUO","GUILLENA","TOTAL POBLACION",4,6,10
" 01","CASCO ANTIGUO","LANTEJUELA (LA)","ESPAÑOLES",0,1,1
" 01","CASCO ANTIGUO","LANTEJUELA (LA)","TOTAL POBLACION",0,1,1
" 01","CASCO ANTIGUO","LEBRIJA","ESPAÑOLES",2,1,3
" 01","CASCO ANTIGUO","LEBRIJA","EXTRANJEROS",0,1,1
" 01","CASCO ANTIGUO","LEBRIJA","TOTAL POBLACION",2,2,4
" 01","CASCO ANTIGUO","LORA DEL RIO","ESPAÑOLES",1,2,3
" 01","CASCO ANTIGUO","LORA DEL RIO","TOTAL POBLACION",1,2,3
" 01","CASCO ANTIGUO","MAIRENA DEL ALCOR","ESPAÑOLES",3,1,4
" 01","CASCO ANTIGUO","MAIRENA DEL ALCOR","EXTRANJEROS",0,1,1
" 01","CASCO ANTIGUO","MAIRENA DEL ALCOR","TOTAL POBLACION",3,2,5
" 01","CASCO ANTIGUO","MAIRENA DEL ALJARAFE","ESPAÑOLES",30,32,62
" 01","CASCO ANTIGUO","MAIRENA DEL ALJARAFE","EXTRANJEROS",3,2,5
" 01","CASCO ANTIGUO","MAIRENA DEL ALJARAFE","TOTAL POBLACION",33,34,67
" 01","CASCO ANTIGUO","MARCHENA","ESPAÑOLES",0,1,1
" 01","CASCO ANTIGUO","MARCHENA","TOTAL POBLACION",0,1,1
" 01","CASCO ANTIGUO","MONTELLANO","ESPAÑOLES",1,1,2
" 01","CASCO ANTIGUO","MONTELLANO","TOTAL POBLACION",1,1,2
" 01","CASCO ANTIGUO","MORON DE LA FRONTERA","ESPAÑOLES",4,1,5
" 01","CASCO ANTIGUO","MORON DE LA FRONTERA","TOTAL POBLACION",4,1,5
" 01","CASCO ANTIGUO","OLIVARES","ESPAÑOLES",1,1,2
" 01","CASCO ANTIGUO","OLIVARES","TOTAL POBLACION",1,1,2
" 01","CASCO ANTIGUO","OSUNA","ESPAÑOLES",1,1,2
" 01","CASCO ANTIGUO","OSUNA","TOTAL POBLACION",1,1,2
" 01","CASCO ANTIGUO","PALACIOS Y VILLAFRANCA (LOS)","ESPAÑOLES",5,7,12
" 01","CASCO ANTIGUO","PALACIOS Y VILLAFRANCA (LOS)","TOTAL POBLACION",5,7,12
" 01","CASCO ANTIGUO","PALOMARES DEL RIO","ESPAÑOLES",2,7,9
" 01","CASCO ANTIGUO","PALOMARES DEL RIO","EXTRANJEROS",0,1,1
" 01","CASCO ANTIGUO","PALOMARES DEL RIO","TOTAL POBLACION",2,8,10
" 01","CASCO ANTIGUO","PEDROSO (EL)","ESPAÑOLES",1,0,1
" 01","CASCO ANTIGUO","PEDROSO (EL)","TOTAL POBLACION",1,0,1
" 01","CASCO ANTIGUO","PILAS","ESPAÑOLES",0,1,1
" 01","CASCO ANTIGUO","PILAS","TOTAL POBLACION",0,1,1
" 01","CASCO ANTIGUO","PUEBLA DE LOS INFANTES (LA)","ESPAÑOLES",1,1,2
" 01","CASCO ANTIGUO","PUEBLA DE LOS INFANTES (LA)","TOTAL POBLACION",1,1,2
" 01","CASCO ANTIGUO","RINCONADA (LA)","ESPAÑOLES",5,5,10
" 01","CASCO ANTIGUO","RINCONADA (LA)","EXTRANJEROS",1,0,1
" 01","CASCO ANTIGUO","RINCONADA (LA)","TOTAL POBLACION",6,5,11
" 01","CASCO ANTIGUO","RONQUILLO (EL)","ESPAÑOLES",5,0,5
" 01","CASCO ANTIGUO","RONQUILLO (EL)","TOTAL POBLACION",5,0,5
" 01","CASCO ANTIGUO","SALTERAS","ESPAÑOLES",4,9,13
" 01","CASCO ANTIGUO","SALTERAS","EXTRANJEROS",1,0,1
" 01","CASCO ANTIGUO","SALTERAS","TOTAL POBLACION",5,9,14
" 01","CASCO ANTIGUO","SAN JUAN DE AZNALFARACHE","ESPAÑOLES",18,15,33
" 01","CASCO ANTIGUO","SAN JUAN DE AZNALFARACHE","EXTRANJEROS",4,3,7
" 01","CASCO ANTIGUO","SAN JUAN DE AZNALFARACHE","TOTAL POBLACION",22,18,40
" 01","CASCO ANTIGUO","SANLUCAR LA MAYOR","ESPAÑOLES",6,4,10
" 01","CASCO ANTIGUO","SANLUCAR LA MAYOR","TOTAL POBLACION",6,4,10
" 01","CASCO ANTIGUO","SANTIPONCE","ESPAÑOLES",2,5,7
" 01","CASCO ANTIGUO","SANTIPONCE","TOTAL POBLACION",2,5,7
" 01","CASCO ANTIGUO","TOCINA","ESPAÑOLES",1,0,1
" 01","CASCO ANTIGUO","TOCINA","TOTAL POBLACION",1,0,1
" 01","CASCO ANTIGUO","TOMARES","ESPAÑOLES",25,27,52
" 01","CASCO ANTIGUO","TOMARES","EXTRANJEROS",1,4,5
" 01","CASCO ANTIGUO","TOMARES","TOTAL POBLACION",26,31,57
" 01","CASCO ANTIGUO","UMBRETE","ESPAÑOLES",3,5,8
" 01","CASCO ANTIGUO","UMBRETE","TOTAL POBLACION",3,5,8
" 01","CASCO ANTIGUO","UTRERA","ESPAÑOLES",0,2,2
" 01","CASCO ANTIGUO","UTRERA","EXTRANJEROS",0,1,1
" 01","CASCO ANTIGUO","UTRERA","TOTAL POBLACION",0,3,3
" 01","CASCO ANTIGUO","VALENCINA DE LA CONCEPCION","ESPAÑOLES",2,2,4
" 01","CASCO ANTIGUO","VALENCINA DE LA CONCEPCION","EXTRANJEROS",0,1,1
" 01","CASCO ANTIGUO","VALENCINA DE LA CONCEPCION","TOTAL POBLACION",2,3,5
" 01","CASCO ANTIGUO","VILLANUEVA DEL ARISCAL","ESPAÑOLES",3,1,4
" 01","CASCO ANTIGUO","VILLANUEVA DEL ARISCAL","EXTRANJEROS",0,1,1
" 01","CASCO ANTIGUO","VILLANUEVA DEL ARISCAL","TOTAL POBLACION",3,2,5
" 01","CASCO ANTIGUO","VILLANUEVA DEL RIO Y MINAS","ESPAÑOLES",2,2,4
" 01","CASCO ANTIGUO","VILLANUEVA DEL RIO Y MINAS","TOTAL POBLACION",2,2,4
" 01","CASCO ANTIGUO","VISO DEL ALCOR (EL)","ESPAÑOLES",1,0,1
" 01","CASCO ANTIGUO","VISO DEL ALCOR (EL)","TOTAL POBLACION",1,0,1
" 02","MACARENA","- FUERA DE LA PROVINCIA DE SEVILLA","ESPAÑOLES",412,425,837
" 02","MACARENA","- FUERA DE LA PROVINCIA DE SEVILLA","EXTRANJEROS",154,174,328
" 02","MACARENA","- FUERA DE LA PROVINCIA DE SEVILLA","NO CONSTA",0,1,1
" 02","MACARENA","- FUERA DE LA PROVINCIA DE SEVILLA","TOTAL POBLACION",566,600,1166
" 02","MACARENA","- PROVINCIA DE SEVILLA","ESPAÑOLES",402,425,827
" 02","MACARENA","- PROVINCIA DE SEVILLA","EXTRANJEROS",67,76,143
" 02","MACARENA","- PROVINCIA DE SEVILLA","NO CONSTA",1,0,1
" 02","MACARENA","- PROVINCIA DE SEVILLA","TOTAL POBLACION",470,501,971
" 02","MACARENA","AGUADULCE","ESPAÑOLES",0,1,1
" 02","MACARENA","AGUADULCE","EXTRANJEROS",1,0,1
" 02","MACARENA","AGUADULCE","TOTAL POBLACION",1,1,2
" 02","MACARENA","ALANIS","ESPAÑOLES",0,1,1
" 02","MACARENA","ALANIS","TOTAL POBLACION",0,1,1
" 02","MACARENA","ALBAIDA DEL ALJARAFE","EXTRANJEROS",0,1,1
" 02","MACARENA","ALBAIDA DEL ALJARAFE","TOTAL POBLACION",0,1,1
" 02","MACARENA","ALCALA DE GUADAIRA","ESPAÑOLES",24,24,48
" 02","MACARENA","ALCALA DE GUADAIRA","EXTRANJEROS",6,2,8
" 02","MACARENA","ALCALA DE GUADAIRA","TOTAL POBLACION",30,26,56
" 02","MACARENA","ALCALA DEL RIO","ESPAÑOLES",7,9,16
" 02","MACARENA","ALCALA DEL RIO","EXTRANJEROS",5,4,9
" 02","MACARENA","ALCALA DEL RIO","TOTAL POBLACION",12,13,25
" 02","MACARENA","ALGABA (LA)","ESPAÑOLES",13,12,25
" 02","MACARENA","ALGABA (LA)","EXTRANJEROS",0,1,1
" 02","MACARENA","ALGABA (LA)","TOTAL POBLACION",13,13,26
" 02","MACARENA","ALGAMITAS","ESPAÑOLES",0,1,1
" 02","MACARENA","ALGAMITAS","TOTAL POBLACION",0,1,1
" 02","MACARENA","ALMADEN DE LA PLATA","ESPAÑOLES",3,1,4
" 02","MACARENA","ALMADEN DE LA PLATA","TOTAL POBLACION",3,1,4
" 02","MACARENA","ALMENSILLA","ESPAÑOLES",2,1,3
" 02","MACARENA","ALMENSILLA","EXTRANJEROS",2,3,5
" 02","MACARENA","ALMENSILLA","TOTAL POBLACION",4,4,8
" 02","MACARENA","ARAHAL (EL)","ESPAÑOLES",1,3,4
" 02","MACARENA","ARAHAL (EL)","TOTAL POBLACION",1,3,4
" 02","MACARENA","AZNALCAZAR","ESPAÑOLES",3,0,3
" 02","MACARENA","AZNALCAZAR","EXTRANJEROS",3,2,5
" 02","MACARENA","AZNALCAZAR","TOTAL POBLACION",6,2,8
" 02","MACARENA","AZNALCOLLAR","ESPAÑOLES",0,1,1
" 02","MACARENA","AZNALCOLLAR","TOTAL POBLACION",0,1,1
" 02","MACARENA","BENACAZON","ESPAÑOLES",5,1,6
" 02","MACARENA","BENACAZON","EXTRANJEROS",0,3,3
" 02","MACARENA","BENACAZON","TOTAL POBLACION",5,4,9
" 02","MACARENA","BOLLULLOS DE LA MITACION","ESPAÑOLES",11,9,20
" 02","MACARENA","BOLLULLOS DE LA MITACION","EXTRANJEROS",1,0,1
" 02","MACARENA","BOLLULLOS DE LA MITACION","TOTAL POBLACION",12,9,21
" 02","MACARENA","BORMUJOS","ESPAÑOLES",16,20,36
" 02","MACARENA","BORMUJOS","EXTRANJEROS",3,2,5
" 02","MACARENA","BORMUJOS","TOTAL POBLACION",19,22,41
" 02","MACARENA","BRENES","ESPAÑOLES",5,4,9
" 02","MACARENA","BRENES","EXTRANJEROS",0,3,3
" 02","MACARENA","BRENES","TOTAL POBLACION",5,7,12
" 02","MACARENA","BURGUILLOS","ESPAÑOLES",12,9,21
" 02","MACARENA","BURGUILLOS","EXTRANJEROS",1,2,3
" 02","MACARENA","BURGUILLOS","TOTAL POBLACION",13,11,24
" 02","MACARENA","CABEZAS DE SAN JUAN (LAS)","ESPAÑOLES",4,1,5
" 02","MACARENA","CABEZAS DE SAN JUAN (LAS)","TOTAL POBLACION",4,1,5
" 02","MACARENA","CAMAS","ESPAÑOLES",20,19,39
" 02","MACARENA","CAMAS","EXTRANJEROS",6,3,9
" 02","MACARENA","CAMAS","NO CONSTA",1,0,1
" 02","MACARENA","CAMAS","TOTAL POBLACION",27,22,49
" 02","MACARENA","CAMPANA (LA)","ESPAÑOLES",2,2,4
" 02","MACARENA","CAMPANA (LA)","EXTRANJEROS",0,1,1
" 02","MACARENA","CAMPANA (LA)","TOTAL POBLACION",2,3,5
" 02","MACARENA","CANTILLANA","ESPAÑOLES",2,3,5
" 02","MACARENA","CANTILLANA","EXTRANJEROS",2,1,3
" 02","MACARENA","CANTILLANA","TOTAL POBLACION",4,4,8
" 02","MACARENA","CARMONA","ESPAÑOLES",11,7,18
" 02","MACARENA","CARMONA","EXTRANJEROS",2,1,3
" 02","MACARENA","CARMONA","TOTAL POBLACION",13,8,21
" 02","MACARENA","CARRION DE LOS CESPEDES","ESPAÑOLES",2,2,4
" 02","MACARENA","CARRION DE LOS CESPEDES","TOTAL POBLACION",2,2,4
" 02","MACARENA","CASTILBLANCO DE LOS ARROYOS","ESPAÑOLES",8,5,13
" 02","MACARENA","CASTILBLANCO DE LOS ARROYOS","TOTAL POBLACION",8,5,13
" 02","MACARENA","CASTILLEJA DE GUZMAN","ESPAÑOLES",3,2,5
" 02","MACARENA","CASTILLEJA DE GUZMAN","TOTAL POBLACION",3,2,5
" 02","MACARENA","CASTILLEJA DE LA CUESTA","ESPAÑOLES",5,13,18
" 02","MACARENA","CASTILLEJA DE LA CUESTA","EXTRANJEROS",2,5,7
" 02","MACARENA","CASTILLEJA DE LA CUESTA","TOTAL POBLACION",7,18,25
" 02","MACARENA","CASTILLO DE LAS GUARDAS (EL)","ESPAÑOLES",0,1,1
" 02","MACARENA","CASTILLO DE LAS GUARDAS (EL)","TOTAL POBLACION",0,1,1
" 02","MACARENA","CAZALLA DE LA SIERRA","ESPAÑOLES",2,7,9
" 02","MACARENA","CAZALLA DE LA SIERRA","TOTAL POBLACION",2,7,9
" 02","MACARENA","CONSTANTINA","ESPAÑOLES",1,3,4
" 02","MACARENA","CONSTANTINA","TOTAL POBLACION",1,3,4
" 02","MACARENA","CORIA DEL RIO","ESPAÑOLES",14,11,25
" 02","MACARENA","CORIA DEL RIO","EXTRANJEROS",2,2,4
" 02","MACARENA","CORIA DEL RIO","TOTAL POBLACION",16,13,29
" 02","MACARENA","CORIPE","ESPAÑOLES",0,1,1
" 02","MACARENA","CORIPE","TOTAL POBLACION",0,1,1
" 02","MACARENA","CORONIL (EL)","EXTRANJEROS",0,1,1
" 02","MACARENA","CORONIL (EL)","TOTAL POBLACION",0,1,1
" 02","MACARENA","CORRALES (LOS)","EXTRANJEROS",1,0,1
" 02","MACARENA","CORRALES (LOS)","TOTAL POBLACION",1,0,1
" 02","MACARENA","DOS HERMANAS","ESPAÑOLES",40,34,74
" 02","MACARENA","DOS HERMANAS","EXTRANJEROS",2,6,8
" 02","MACARENA","DOS HERMANAS","TOTAL POBLACION",42,40,82
" 02","MACARENA","ECIJA","ESPAÑOLES",1,0,1
" 02","MACARENA","ECIJA","TOTAL POBLACION",1,0,1
" 02","MACARENA","ESPARTINAS","ESPAÑOLES",8,10,18
" 02","MACARENA","ESPARTINAS","TOTAL POBLACION",8,10,18
" 02","MACARENA","ESTEPA","ESPAÑOLES",0,1,1
" 02","MACARENA","ESTEPA","TOTAL POBLACION",0,1,1
" 02","MACARENA","FUENTES DE ANDALUCIA","ESPAÑOLES",0,1,1
" 02","MACARENA","FUENTES DE ANDALUCIA","TOTAL POBLACION",0,1,1
" 02","MACARENA","GARROBO (EL)","ESPAÑOLES",0,1,1
" 02","MACARENA","GARROBO (EL)","TOTAL POBLACION",0,1,1
" 02","MACARENA","GELVES","ESPAÑOLES",4,6,10
" 02","MACARENA","GELVES","EXTRANJEROS",0,1,1
" 02","MACARENA","GELVES","TOTAL POBLACION",4,7,11
" 02","MACARENA","GERENA","ESPAÑOLES",3,7,10
" 02","MACARENA","GERENA","TOTAL POBLACION",3,7,10
" 02","MACARENA","GINES","ESPAÑOLES",1,1,2
" 02","MACARENA","GINES","EXTRANJEROS",2,1,3
" 02","MACARENA","GINES","TOTAL POBLACION",3,2,5
" 02","MACARENA","GUADALCANAL","ESPAÑOLES",2,0,2
" 02","MACARENA","GUADALCANAL","TOTAL POBLACION",2,0,2
" 02","MACARENA","GUILLENA","ESPAÑOLES",11,10,21
" 02","MACARENA","GUILLENA","EXTRANJEROS",1,1,2
" 02","MACARENA","GUILLENA","TOTAL POBLACION",12,11,23
" 02","MACARENA","HERRERA","ESPAÑOLES",0,1,1
" 02","MACARENA","HERRERA","TOTAL POBLACION",0,1,1
" 02","MACARENA","HUEVAR DEL ALJARAFE","ESPAÑOLES",2,3,5
" 02","MACARENA","HUEVAR DEL ALJARAFE","TOTAL POBLACION",2,3,5
" 02","MACARENA","ISLA MAYOR","ESPAÑOLES",2,2,4
" 02","MACARENA","ISLA MAYOR","TOTAL POBLACION",2,2,4
" 02","MACARENA","LEBRIJA","ESPAÑOLES",1,1,2
" 02","MACARENA","LEBRIJA","EXTRANJEROS",1,1,2
" 02","MACARENA","LEBRIJA","TOTAL POBLACION",2,2,4
" 02","MACARENA","LORA DEL RIO","ESPAÑOLES",1,1,2
" 02","MACARENA","LORA DEL RIO","EXTRANJEROS",0,2,2
" 02","MACARENA","LORA DEL RIO","TOTAL POBLACION",1,3,4
" 02","MACARENA","LUISIANA (LA)","ESPAÑOLES",1,0,1
" 02","MACARENA","LUISIANA (LA)","TOTAL POBLACION",1,0,1
" 02","MACARENA","MAIRENA DEL ALCOR","ESPAÑOLES",1,3,4
" 02","MACARENA","MAIRENA DEL ALCOR","EXTRANJEROS",4,1,5
" 02","MACARENA","MAIRENA DEL ALCOR","TOTAL POBLACION",5,4,9
" 02","MACARENA","MAIRENA DEL ALJARAFE","ESPAÑOLES",20,27,47
" 02","MACARENA","MAIRENA DEL ALJARAFE","EXTRANJEROS",4,4,8
" 02","MACARENA","MAIRENA DEL ALJARAFE","TOTAL POBLACION",24,31,55
" 02","MACARENA","MARCHENA","ESPAÑOLES",0,1,1
" 02","MACARENA","MARCHENA","EXTRANJEROS",0,1,1
" 02","MACARENA","MARCHENA","TOTAL POBLACION",0,2,2
" 02","MACARENA","MONTELLANO","ESPAÑOLES",0,1,1
" 02","MACARENA","MONTELLANO","TOTAL POBLACION",0,1,1
" 02","MACARENA","MORON DE LA FRONTERA","ESPAÑOLES",2,2,4
" 02","MACARENA","MORON DE LA FRONTERA","EXTRANJEROS",1,0,1
" 02","MACARENA","MORON DE LA FRONTERA","TOTAL POBLACION",3,2,5
" 02","MACARENA","OLIVARES","ESPAÑOLES",5,8,13
" 02","MACARENA","OLIVARES","EXTRANJEROS",0,1,1
" 02","MACARENA","OLIVARES","TOTAL POBLACION",5,9,14
" 02","MACARENA","OSUNA","ESPAÑOLES",1,2,3
" 02","MACARENA","OSUNA","TOTAL POBLACION",1,2,3
" 02","MACARENA","PALACIOS Y VILLAFRANCA (LOS)","ESPAÑOLES",3,1,4
" 02","MACARENA","PALACIOS Y VILLAFRANCA (LOS)","EXTRANJEROS",0,1,1
" 02","MACARENA","PALACIOS Y VILLAFRANCA (LOS)","TOTAL POBLACION",3,2,5
" 02","MACARENA","PALMAR DE TROYA (EL)","ESPAÑOLES",1,0,1
" 02","MACARENA","PALMAR DE TROYA (EL)","TOTAL POBLACION",1,0,1
" 02","MACARENA","PALOMARES DEL RIO","ESPAÑOLES",5,5,10
" 02","MACARENA","PALOMARES DEL RIO","TOTAL POBLACION",5,5,10
" 02","MACARENA","PEÑAFLOR","ESPAÑOLES",1,1,2
" 02","MACARENA","PEÑAFLOR","TOTAL POBLACION",1,1,2
" 02","MACARENA","PILAS","ESPAÑOLES",6,6,12
" 02","MACARENA","PILAS","EXTRANJEROS",1,1,2
" 02","MACARENA","PILAS","TOTAL POBLACION",7,7,14
" 02","MACARENA","PUEBLA DE CAZALLA (LA)","ESPAÑOLES",0,1,1
" 02","MACARENA","PUEBLA DE CAZALLA (LA)","TOTAL POBLACION",0,1,1
" 02","MACARENA","PUEBLA DE LOS INFANTES (LA)","ESPAÑOLES",4,1,5
" 02","MACARENA","PUEBLA DE LOS INFANTES (LA)","TOTAL POBLACION",4,1,5
" 02","MACARENA","PUEBLA DEL RIO (LA)","ESPAÑOLES",1,2,3
" 02","MACARENA","PUEBLA DEL RIO (LA)","EXTRANJEROS",1,1,2
" 02","MACARENA","PUEBLA DEL RIO (LA)","TOTAL POBLACION",2,3,5
" 02","MACARENA","REAL DE LA JARA (EL)","ESPAÑOLES",1,2,3
" 02","MACARENA","REAL DE LA JARA (EL)","TOTAL POBLACION",1,2,3
" 02","MACARENA","RINCONADA (LA)","ESPAÑOLES",44,37,81
" 02","MACARENA","RINCONADA (LA)","EXTRANJEROS",0,3,3
" 02","MACARENA","RINCONADA (LA)","TOTAL POBLACION",44,40,84
" 02","MACARENA","RONQUILLO (EL)","ESPAÑOLES",3,3,6
" 02","MACARENA","RONQUILLO (EL)","TOTAL POBLACION",3,3,6
" 02","MACARENA","SALTERAS","ESPAÑOLES",4,3,7
" 02","MACARENA","SALTERAS","EXTRANJEROS",0,1,1
" 02","MACARENA","SALTERAS","TOTAL POBLACION",4,4,8
" 02","MACARENA","SAN JUAN DE AZNALFARACHE","ESPAÑOLES",11,12,23
" 02","MACARENA","SAN JUAN DE AZNALFARACHE","EXTRANJEROS",5,7,12
" 02","MACARENA","SAN JUAN DE AZNALFARACHE","TOTAL POBLACION",16,19,35
" 02","MACARENA","SAN NICOLAS DEL PUERTO","ESPAÑOLES",1,0,1
" 02","MACARENA","SAN NICOLAS DEL PUERTO","TOTAL POBLACION",1,0,1
" 02","MACARENA","SANLUCAR LA MAYOR","ESPAÑOLES",4,2,6
" 02","MACARENA","SANLUCAR LA MAYOR","EXTRANJEROS",0,1,1
" 02","MACARENA","SANLUCAR LA MAYOR","TOTAL POBLACION",4,3,7
" 02","MACARENA","SANTIPONCE","ESPAÑOLES",7,9,16
" 02","MACARENA","SANTIPONCE","TOTAL POBLACION",7,9,16
" 02","MACARENA","TOCINA","ESPAÑOLES",0,3,3
" 02","MACARENA","TOCINA","EXTRANJEROS",1,1,2
" 02","MACARENA","TOCINA","TOTAL POBLACION",1,4,5
" 02","MACARENA","TOMARES","ESPAÑOLES",8,15,23
" 02","MACARENA","TOMARES","EXTRANJEROS",0,1,1
" 02","MACARENA","TOMARES","TOTAL POBLACION",8,16,24
" 02","MACARENA","UMBRETE","ESPAÑOLES",2,2,4
" 02","MACARENA","UMBRETE","EXTRANJEROS",2,2,4
" 02","MACARENA","UMBRETE","TOTAL POBLACION",4,4,8
" 02","MACARENA","UTRERA","ESPAÑOLES",6,4,10
" 02","MACARENA","UTRERA","EXTRANJEROS",1,0,1
" 02","MACARENA","UTRERA","TOTAL POBLACION",7,4,11
" 02","MACARENA","VALENCINA DE LA CONCEPCION","ESPAÑOLES",1,1,2
" 02","MACARENA","VALENCINA DE LA CONCEPCION","EXTRANJEROS",1,0,1
" 02","MACARENA","VALENCINA DE LA CONCEPCION","TOTAL POBLACION",2,1,3
" 02","MACARENA","VILLAMANRIQUE DE LA CONDESA","ESPAÑOLES",1,4,5
" 02","MACARENA","VILLAMANRIQUE DE LA CONDESA","TOTAL POBLACION",1,4,5
" 02","MACARENA","VILLANUEVA DEL ARISCAL","ESPAÑOLES",1,4,5
" 02","MACARENA","VILLANUEVA DEL ARISCAL","TOTAL POBLACION",1,4,5
" 02","MACARENA","VILLANUEVA DEL RIO Y MINAS","ESPAÑOLES",2,3,5
" 02","MACARENA","VILLANUEVA DEL RIO Y MINAS","EXTRANJEROS",1,1,2
" 02","MACARENA","VILLANUEVA DEL RIO Y MINAS","TOTAL POBLACION",3,4,7
" 02","MACARENA","VILLAVERDE DEL RIO","ESPAÑOLES",3,5,8
" 02","MACARENA","VILLAVERDE DEL RIO","EXTRANJEROS",1,0,1
" 02","MACARENA","VILLAVERDE DEL RIO","TOTAL POBLACION",4,5,9
" 02","MACARENA","VISO DEL ALCOR (EL)","ESPAÑOLES",0,2,2
" 02","MACARENA","VISO DEL ALCOR (EL)","EXTRANJEROS",1,0,1
" 02","MACARENA","VISO DEL ALCOR (EL)","TOTAL POBLACION",1,2,3
" 03","NERVION","- FUERA DE LA PROVINCIA DE SEVILLA","ESPAÑOLES",306,301,607
" 03","NERVION","- FUERA DE LA PROVINCIA DE SEVILLA","EXTRANJEROS",35,50,85
" 03","NERVION","- FUERA DE LA PROVINCIA DE SEVILLA","TOTAL POBLACION",341,351,692
" 03","NERVION","- PROVINCIA DE SEVILLA","ESPAÑOLES",209,232,441
" 03","NERVION","- PROVINCIA DE SEVILLA","EXTRANJEROS",13,21,34
" 03","NERVION","- PROVINCIA DE SEVILLA","TOTAL POBLACION",222,253,475
" 03","NERVION","ALCALA DE GUADAIRA","ESPAÑOLES",11,20,31
" 03","NERVION","ALCALA DE GUADAIRA","EXTRANJEROS",4,1,5
" 03","NERVION","ALCALA DE GUADAIRA","TOTAL POBLACION",15,21,36
" 03","NERVION","ALCALA DEL RIO","ESPAÑOLES",5,3,8
" 03","NERVION","ALCALA DEL RIO","TOTAL POBLACION",5,3,8
" 03","NERVION","ALCOLEA DEL RIO","ESPAÑOLES",2,2,4
" 03","NERVION","ALCOLEA DEL RIO","TOTAL POBLACION",2,2,4
" 03","NERVION","ALGABA (LA)","ESPAÑOLES",0,1,1
" 03","NERVION","ALGABA (LA)","EXTRANJEROS",0,2,2
" 03","NERVION","ALGABA (LA)","TOTAL POBLACION",0,3,3
" 03","NERVION","ALMENSILLA","ESPAÑOLES",1,1,2
" 03","NERVION","ALMENSILLA","TOTAL POBLACION",1,1,2
" 03","NERVION","ARAHAL (EL)","ESPAÑOLES",0,1,1
" 03","NERVION","ARAHAL (EL)","TOTAL POBLACION",0,1,1
" 03","NERVION","AZNALCOLLAR","ESPAÑOLES",0,1,1
" 03","NERVION","AZNALCOLLAR","TOTAL POBLACION",0,1,1
" 03","NERVION","BADOLATOSA","ESPAÑOLES",0,1,1
" 03","NERVION","BADOLATOSA","EXTRANJEROS",1,0,1
" 03","NERVION","BADOLATOSA","TOTAL POBLACION",1,1,2
" 03","NERVION","BENACAZON","ESPAÑOLES",1,1,2
" 03","NERVION","BENACAZON","TOTAL POBLACION",1,1,2
" 03","NERVION","BOLLULLOS DE LA MITACION","ESPAÑOLES",6,8,14
" 03","NERVION","BOLLULLOS DE LA MITACION","EXTRANJEROS",1,1,2
" 03","NERVION","BOLLULLOS DE LA MITACION","TOTAL POBLACION",7,9,16
" 03","NERVION","BORMUJOS","ESPAÑOLES",14,7,21
" 03","NERVION","BORMUJOS","TOTAL POBLACION",14,7,21
" 03","NERVION","BURGUILLOS","ESPAÑOLES",2,0,2
" 03","NERVION","BURGUILLOS","EXTRANJEROS",1,1,2
" 03","NERVION","BURGUILLOS","TOTAL POBLACION",3,1,4
" 03","NERVION","CAMAS","ESPAÑOLES",2,1,3
" 03","NERVION","CAMAS","EXTRANJEROS",0,1,1
" 03","NERVION","CAMAS","TOTAL POBLACION",2,2,4
" 03","NERVION","CAMPANA (LA)","ESPAÑOLES",1,4,5
" 03","NERVION","CAMPANA (LA)","TOTAL POBLACION",1,4,5
" 03","NERVION","CANTILLANA","ESPAÑOLES",1,3,4
" 03","NERVION","CANTILLANA","TOTAL POBLACION",1,3,4
" 03","NERVION","CARMONA","ESPAÑOLES",9,4,13
" 03","NERVION","CARMONA","TOTAL POBLACION",9,4,13
" 03","NERVION","CASTILBLANCO DE LOS ARROYOS","ESPAÑOLES",2,0,2
" 03","NERVION","CASTILBLANCO DE LOS ARROYOS","TOTAL POBLACION",2,0,2
" 03","NERVION","CASTILLEJA DE GUZMAN","ESPAÑOLES",3,1,4
" 03","NERVION","CASTILLEJA DE GUZMAN","TOTAL POBLACION",3,1,4
" 03","NERVION","CASTILLEJA DE LA CUESTA","ESPAÑOLES",1,4,5
" 03","NERVION","CASTILLEJA DE LA CUESTA","EXTRANJEROS",1,0,1
" 03","NERVION","CASTILLEJA DE LA CUESTA","TOTAL POBLACION",2,4,6
" 03","NERVION","CASTILLEJA DEL CAMPO","ESPAÑOLES",1,0,1
" 03","NERVION","CASTILLEJA DEL CAMPO","TOTAL POBLACION",1,0,1
" 03","NERVION","CORIA DEL RIO","ESPAÑOLES",5,3,8
" 03","NERVION","CORIA DEL RIO","TOTAL POBLACION",5,3,8
" 03","NERVION","CORRALES (LOS)","ESPAÑOLES",0,1,1
" 03","NERVION","CORRALES (LOS)","TOTAL POBLACION",0,1,1
" 03","NERVION","DOS HERMANAS","ESPAÑOLES",41,40,81
" 03","NERVION","DOS HERMANAS","EXTRANJEROS",2,4,6
" 03","NERVION","DOS HERMANAS","TOTAL POBLACION",43,44,87
" 03","NERVION","ECIJA","ESPAÑOLES",1,1,2
" 03","NERVION","ECIJA","TOTAL POBLACION",1,1,2
" 03","NERVION","ESPARTINAS","ESPAÑOLES",4,12,16
" 03","NERVION","ESPARTINAS","TOTAL POBLACION",4,12,16
" 03","NERVION","FUENTES DE ANDALUCIA","ESPAÑOLES",1,2,3
" 03","NERVION","FUENTES DE ANDALUCIA","TOTAL POBLACION",1,2,3
" 03","NERVION","GELVES","ESPAÑOLES",4,2,6
" 03","NERVION","GELVES","TOTAL POBLACION",4,2,6
" 03","NERVION","GERENA","ESPAÑOLES",2,2,4
" 03","NERVION","GERENA","TOTAL POBLACION",2,2,4
" 03","NERVION","GINES","ESPAÑOLES",4,4,8
" 03","NERVION","GINES","TOTAL POBLACION",4,4,8
" 03","NERVION","GUADALCANAL","ESPAÑOLES",1,1,2
" 03","NERVION","GUADALCANAL","TOTAL POBLACION",1,1,2
" 03","NERVION","GUILLENA","ESPAÑOLES",5,5,10
" 03","NERVION","GUILLENA","TOTAL POBLACION",5,5,10
" 03","NERVION","ISLA MAYOR","ESPAÑOLES",1,1,2
" 03","NERVION","ISLA MAYOR","TOTAL POBLACION",1,1,2
" 03","NERVION","LORA DEL RIO","ESPAÑOLES",1,1,2
" 03","NERVION","LORA DEL RIO","TOTAL POBLACION",1,1,2
" 03","NERVION","MADROÑO (EL)","ESPAÑOLES",0,1,1
" 03","NERVION","MADROÑO (EL)","TOTAL POBLACION",0,1,1
" 03","NERVION","MAIRENA DEL ALCOR","ESPAÑOLES",5,3,8
" 03","NERVION","MAIRENA DEL ALCOR","TOTAL POBLACION",5,3,8
" 03","NERVION","MAIRENA DEL ALJARAFE","ESPAÑOLES",17,19,36
" 03","NERVION","MAIRENA DEL ALJARAFE","EXTRANJEROS",1,4,5
" 03","NERVION","MAIRENA DEL ALJARAFE","TOTAL POBLACION",18,23,41
" 03","NERVION","MARCHENA","ESPAÑOLES",3,3,6
" 03","NERVION","MARCHENA","TOTAL POBLACION",3,3,6
" 03","NERVION","MOLARES (LOS)","ESPAÑOLES",0,1,1
" 03","NERVION","MOLARES (LOS)","TOTAL POBLACION",0,1,1
" 03","NERVION","MORON DE LA FRONTERA","EXTRANJEROS",0,1,1
" 03","NERVION","MORON DE LA FRONTERA","TOTAL POBLACION",0,1,1
" 03","NERVION","OLIVARES","ESPAÑOLES",0,3,3
" 03","NERVION","OLIVARES","TOTAL POBLACION",0,3,3
" 03","NERVION","OSUNA","ESPAÑOLES",2,1,3
" 03","NERVION","OSUNA","TOTAL POBLACION",2,1,3
" 03","NERVION","PALACIOS Y VILLAFRANCA (LOS)","ESPAÑOLES",0,1,1
" 03","NERVION","PALACIOS Y VILLAFRANCA (LOS)","TOTAL POBLACION",0,1,1
" 03","NERVION","PARADAS","ESPAÑOLES",3,3,6
" 03","NERVION","PARADAS","TOTAL POBLACION",3,3,6
" 03","NERVION","PILAS","ESPAÑOLES",0,1,1
" 03","NERVION","PILAS","TOTAL POBLACION",0,1,1
" 03","NERVION","PUEBLA DE LOS INFANTES (LA)","ESPAÑOLES",0,1,1
" 03","NERVION","PUEBLA DE LOS INFANTES (LA)","TOTAL POBLACION",0,1,1
" 03","NERVION","PUEBLA DEL RIO (LA)","ESPAÑOLES",2,1,3
" 03","NERVION","PUEBLA DEL RIO (LA)","EXTRANJEROS",1,0,1
" 03","NERVION","PUEBLA DEL RIO (LA)","TOTAL POBLACION",3,1,4
" 03","NERVION","RINCONADA (LA)","ESPAÑOLES",9,12,21
" 03","NERVION","RINCONADA (LA)","EXTRANJEROS",0,3,3
" 03","NERVION","RINCONADA (LA)","TOTAL POBLACION",9,15,24
" 03","NERVION","RONQUILLO (EL)","ESPAÑOLES",1,2,3
" 03","NERVION","RONQUILLO (EL)","TOTAL POBLACION",1,2,3
" 03","NERVION","SALTERAS","ESPAÑOLES",4,0,4
" 03","NERVION","SALTERAS","TOTAL POBLACION",4,0,4
" 03","NERVION","SAN JUAN DE AZNALFARACHE","ESPAÑOLES",11,11,22
" 03","NERVION","SAN JUAN DE AZNALFARACHE","EXTRANJEROS",0,2,2
" 03","NERVION","SAN JUAN DE AZNALFARACHE","TOTAL POBLACION",11,13,24
" 03","NERVION","SANTIPONCE","ESPAÑOLES",2,3,5
" 03","NERVION","SANTIPONCE","TOTAL POBLACION",2,3,5
" 03","NERVION","SAUCEJO (EL)","ESPAÑOLES",1,1,2
" 03","NERVION","SAUCEJO (EL)","TOTAL POBLACION",1,1,2
" 03","NERVION","TOCINA","ESPAÑOLES",0,2,2
" 03","NERVION","TOCINA","TOTAL POBLACION",0,2,2
" 03","NERVION","TOMARES","ESPAÑOLES",10,12,22
" 03","NERVION","TOMARES","EXTRANJEROS",1,0,1
" 03","NERVION","TOMARES","TOTAL POBLACION",11,12,23
" 03","NERVION","UMBRETE","ESPAÑOLES",1,2,3
" 03","NERVION","UMBRETE","TOTAL POBLACION",1,2,3
" 03","NERVION","UTRERA","ESPAÑOLES",3,5,8
" 03","NERVION","UTRERA","EXTRANJEROS",0,1,1
" 03","NERVION","UTRERA","TOTAL POBLACION",3,6,9
" 03","NERVION","VALENCINA DE LA CONCEPCION","ESPAÑOLES",0,2,2
" 03","NERVION","VALENCINA DE LA CONCEPCION","TOTAL POBLACION",0,2,2
" 03","NERVION","VILLAMANRIQUE DE LA CONDESA","ESPAÑOLES",1,0,1
" 03","NERVION","VILLAMANRIQUE DE LA CONDESA","TOTAL POBLACION",1,0,1
" 03","NERVION","VILLANUEVA DEL ARISCAL","ESPAÑOLES",1,2,3
" 03","NERVION","VILLANUEVA DEL ARISCAL","TOTAL POBLACION",1,2,3
" 03","NERVION","VILLAVERDE DEL RIO","ESPAÑOLES",1,0,1
" 03","NERVION","VILLAVERDE DEL RIO","TOTAL POBLACION",1,0,1
" 03","NERVION","VISO DEL ALCOR (EL)","ESPAÑOLES",0,2,2
" 03","NERVION","VISO DEL ALCOR (EL)","TOTAL POBLACION",0,2,2
" 04","CERRO-AMATE","- FUERA DE LA PROVINCIA DE SEVILLA","ESPAÑOLES",334,333,667
" 04","CERRO-AMATE","- FUERA DE LA PROVINCIA DE SEVILLA","EXTRANJEROS",165,182,347
" 04","CERRO-AMATE","- FUERA DE LA PROVINCIA DE SEVILLA","NO CONSTA",1,1,2
" 04","CERRO-AMATE","- FUERA DE LA PROVINCIA DE SEVILLA","TOTAL POBLACION",500,516,1016
" 04","CERRO-AMATE","- PROVINCIA DE SEVILLA","ESPAÑOLES",481,468,949
" 04","CERRO-AMATE","- PROVINCIA DE SEVILLA","EXTRANJEROS",47,72,119
" 04","CERRO-AMATE","- PROVINCIA DE SEVILLA","TOTAL POBLACION",528,540,1068
" 04","CERRO-AMATE","ALANIS","ESPAÑOLES",0,1,1
" 04","CERRO-AMATE","ALANIS","EXTRANJEROS",0,1,1
" 04","CERRO-AMATE","ALANIS","TOTAL POBLACION",0,2,2
" 04","CERRO-AMATE","ALCALA DE GUADAIRA","ESPAÑOLES",65,58,123
" 04","CERRO-AMATE","ALCALA DE GUADAIRA","EXTRANJEROS",3,3,6
" 04","CERRO-AMATE","ALCALA DE GUADAIRA","TOTAL POBLACION",68,61,129
" 04","CERRO-AMATE","ALCALA DEL RIO","ESPAÑOLES",3,6,9
" 04","CERRO-AMATE","ALCALA DEL RIO","EXTRANJEROS",0,1,1
" 04","CERRO-AMATE","ALCALA DEL RIO","TOTAL POBLACION",3,7,10
" 04","CERRO-AMATE","ALCOLEA DEL RIO","ESPAÑOLES",1,0,1
" 04","CERRO-AMATE","ALCOLEA DEL RIO","EXTRANJEROS",0,1,1
" 04","CERRO-AMATE","ALCOLEA DEL RIO","TOTAL POBLACION",1,1,2
" 04","CERRO-AMATE","ALGABA (LA)","ESPAÑOLES",7,6,13
" 04","CERRO-AMATE","ALGABA (LA)","EXTRANJEROS",1,0,1
" 04","CERRO-AMATE","ALGABA (LA)","TOTAL POBLACION",8,6,14
" 04","CERRO-AMATE","ALMADEN DE LA PLATA","ESPAÑOLES",1,1,2
" 04","CERRO-AMATE","ALMADEN DE LA PLATA","TOTAL POBLACION",1,1,2
" 04","CERRO-AMATE","ALMENSILLA","ESPAÑOLES",3,0,3
" 04","CERRO-AMATE","ALMENSILLA","TOTAL POBLACION",3,0,3
" 04","CERRO-AMATE","ARAHAL (EL)","ESPAÑOLES",4,3,7
" 04","CERRO-AMATE","ARAHAL (EL)","TOTAL POBLACION",4,3,7
" 04","CERRO-AMATE","AZNALCAZAR","EXTRANJEROS",0,1,1
" 04","CERRO-AMATE","AZNALCAZAR","TOTAL POBLACION",0,1,1
" 04","CERRO-AMATE","BENACAZON","ESPAÑOLES",3,2,5
" 04","CERRO-AMATE","BENACAZON","EXTRANJEROS",0,1,1
" 04","CERRO-AMATE","BENACAZON","TOTAL POBLACION",3,3,6
" 04","CERRO-AMATE","BOLLULLOS DE LA MITACION","ESPAÑOLES",5,6,11
" 04","CERRO-AMATE","BOLLULLOS DE LA MITACION","EXTRANJEROS",0,1,1
" 04","CERRO-AMATE","BOLLULLOS DE LA MITACION","TOTAL POBLACION",5,7,12
" 04","CERRO-AMATE","BORMUJOS","ESPAÑOLES",8,8,16
" 04","CERRO-AMATE","BORMUJOS","EXTRANJEROS",4,1,5
" 04","CERRO-AMATE","BORMUJOS","TOTAL POBLACION",12,9,21
" 04","CERRO-AMATE","BRENES","ESPAÑOLES",4,3,7
" 04","CERRO-AMATE","BRENES","EXTRANJEROS",0,2,2
" 04","CERRO-AMATE","BRENES","TOTAL POBLACION",4,5,9
" 04","CERRO-AMATE","BURGUILLOS","ESPAÑOLES",5,6,11
" 04","CERRO-AMATE","BURGUILLOS","EXTRANJEROS",2,0,2
" 04","CERRO-AMATE","BURGUILLOS","TOTAL POBLACION",7,6,13
" 04","CERRO-AMATE","CABEZAS DE SAN JUAN (LAS)","ESPAÑOLES",1,0,1
" 04","CERRO-AMATE","CABEZAS DE SAN JUAN (LAS)","TOTAL POBLACION",1,0,1
" 04","CERRO-AMATE","CAMAS","ESPAÑOLES",19,10,29
" 04","CERRO-AMATE","CAMAS","EXTRANJEROS",4,3,7
" 04","CERRO-AMATE","CAMAS","TOTAL POBLACION",23,13,36
" 04","CERRO-AMATE","CAMPANA (LA)","ESPAÑOLES",1,0,1
" 04","CERRO-AMATE","CAMPANA (LA)","TOTAL POBLACION",1,0,1
" 04","CERRO-AMATE","CANTILLANA","ESPAÑOLES",3,1,4
" 04","CERRO-AMATE","CANTILLANA","TOTAL POBLACION",3,1,4
" 04","CERRO-AMATE","CARMONA","ESPAÑOLES",26,20,46
" 04","CERRO-AMATE","CARMONA","EXTRANJEROS",1,1,2
" 04","CERRO-AMATE","CARMONA","TOTAL POBLACION",27,21,48
" 04","CERRO-AMATE","CARRION DE LOS CESPEDES","ESPAÑOLES",1,0,1
" 04","CERRO-AMATE","CARRION DE LOS CESPEDES","EXTRANJEROS",1,0,1
" 04","CERRO-AMATE","CARRION DE LOS CESPEDES","TOTAL POBLACION",2,0,2
" 04","CERRO-AMATE","CASTILBLANCO DE LOS ARROYOS","ESPAÑOLES",4,6,10
" 04","CERRO-AMATE","CASTILBLANCO DE LOS ARROYOS","EXTRANJEROS",1,0,1
" 04","CERRO-AMATE","CASTILBLANCO DE LOS ARROYOS","TOTAL POBLACION",5,6,11
" 04","CERRO-AMATE","CASTILLEJA DE GUZMAN","ESPAÑOLES",0,1,1
" 04","CERRO-AMATE","CASTILLEJA DE GUZMAN","TOTAL POBLACION",0,1,1
" 04","CERRO-AMATE","CASTILLEJA DE LA CUESTA","ESPAÑOLES",6,4,10
" 04","CERRO-AMATE","CASTILLEJA DE LA CUESTA","EXTRANJEROS",1,0,1
" 04","CERRO-AMATE","CASTILLEJA DE LA CUESTA","TOTAL POBLACION",7,4,11
" 04","CERRO-AMATE","CASTILLO DE LAS GUARDAS (EL)","ESPAÑOLES",2,1,3
" 04","CERRO-AMATE","CASTILLO DE LAS GUARDAS (EL)","TOTAL POBLACION",2,1,3
" 04","CERRO-AMATE","CAZALLA DE LA SIERRA","ESPAÑOLES",1,0,1
" 04","CERRO-AMATE","CAZALLA DE LA SIERRA","TOTAL POBLACION",1,0,1
" 04","CERRO-AMATE","CONSTANTINA","ESPAÑOLES",2,2,4
" 04","CERRO-AMATE","CONSTANTINA","EXTRANJEROS",0,1,1
" 04","CERRO-AMATE","CONSTANTINA","TOTAL POBLACION",2,3,5
" 04","CERRO-AMATE","CORIA DEL RIO","ESPAÑOLES",13,7,20
" 04","CERRO-AMATE","CORIA DEL RIO","EXTRANJEROS",1,5,6
" 04","CERRO-AMATE","CORIA DEL RIO","TOTAL POBLACION",14,12,26
" 04","CERRO-AMATE","CORONIL (EL)","ESPAÑOLES",0,1,1
" 04","CERRO-AMATE","CORONIL (EL)","EXTRANJEROS",0,1,1
" 04","CERRO-AMATE","CORONIL (EL)","TOTAL POBLACION",0,2,2
" 04","CERRO-AMATE","DOS HERMANAS","ESPAÑOLES",90,99,189
" 04","CERRO-AMATE","DOS HERMANAS","EXTRANJEROS",8,10,18
" 04","CERRO-AMATE","DOS HERMANAS","TOTAL POBLACION",98,109,207
" 04","CERRO-AMATE","ECIJA","ESPAÑOLES",4,2,6
" 04","CERRO-AMATE","ECIJA","EXTRANJEROS",0,1,1
" 04","CERRO-AMATE","ECIJA","TOTAL POBLACION",4,3,7
" 04","CERRO-AMATE","ESPARTINAS","ESPAÑOLES",2,7,9
" 04","CERRO-AMATE","ESPARTINAS","EXTRANJEROS",2,1,3
" 04","CERRO-AMATE","ESPARTINAS","TOTAL POBLACION",4,8,12
" 04","CERRO-AMATE","FUENTES DE ANDALUCIA","ESPAÑOLES",2,1,3
" 04","CERRO-AMATE","FUENTES DE ANDALUCIA","TOTAL POBLACION",2,1,3
" 04","CERRO-AMATE","GARROBO (EL)","ESPAÑOLES",1,2,3
" 04","CERRO-AMATE","GARROBO (EL)","TOTAL POBLACION",1,2,3
" 04","CERRO-AMATE","GELVES","ESPAÑOLES",5,5,10
" 04","CERRO-AMATE","GELVES","TOTAL POBLACION",5,5,10
" 04","CERRO-AMATE","GERENA","ESPAÑOLES",4,6,10
" 04","CERRO-AMATE","GERENA","EXTRANJEROS",1,1,2
" 04","CERRO-AMATE","GERENA","TOTAL POBLACION",5,7,12
" 04","CERRO-AMATE","GINES","ESPAÑOLES",4,5,9
" 04","CERRO-AMATE","GINES","TOTAL POBLACION",4,5,9
" 04","CERRO-AMATE","GUADALCANAL","ESPAÑOLES",1,3,4
" 04","CERRO-AMATE","GUADALCANAL","TOTAL POBLACION",1,3,4
" 04","CERRO-AMATE","GUILLENA","ESPAÑOLES",7,4,11
" 04","CERRO-AMATE","GUILLENA","EXTRANJEROS",0,1,1
" 04","CERRO-AMATE","GUILLENA","TOTAL POBLACION",7,5,12
" 04","CERRO-AMATE","HUEVAR DEL ALJARAFE","ESPAÑOLES",1,1,2
" 04","CERRO-AMATE","HUEVAR DEL ALJARAFE","TOTAL POBLACION",1,1,2
" 04","CERRO-AMATE","ISLA MAYOR","ESPAÑOLES",0,1,1
" 04","CERRO-AMATE","ISLA MAYOR","TOTAL POBLACION",0,1,1
" 04","CERRO-AMATE","LEBRIJA","ESPAÑOLES",2,1,3
" 04","CERRO-AMATE","LEBRIJA","TOTAL POBLACION",2,1,3
" 04","CERRO-AMATE","LUISIANA (LA)","ESPAÑOLES",1,0,1
" 04","CERRO-AMATE","LUISIANA (LA)","TOTAL POBLACION",1,0,1
" 04","CERRO-AMATE","MAIRENA DEL ALCOR","ESPAÑOLES",12,14,26
" 04","CERRO-AMATE","MAIRENA DEL ALCOR","EXTRANJEROS",3,2,5
" 04","CERRO-AMATE","MAIRENA DEL ALCOR","TOTAL POBLACION",15,16,31
" 04","CERRO-AMATE","MAIRENA DEL ALJARAFE","ESPAÑOLES",33,29,62
" 04","CERRO-AMATE","MAIRENA DEL ALJARAFE","EXTRANJEROS",0,9,9
" 04","CERRO-AMATE","MAIRENA DEL ALJARAFE","TOTAL POBLACION",33,38,71
" 04","CERRO-AMATE","MARCHENA","ESPAÑOLES",1,3,4
" 04","CERRO-AMATE","MARCHENA","TOTAL POBLACION",1,3,4
" 04","CERRO-AMATE","MARTIN DE LA JARA","ESPAÑOLES",0,1,1
" 04","CERRO-AMATE","MARTIN DE LA JARA","TOTAL POBLACION",0,1,1
" 04","CERRO-AMATE","MONTELLANO","ESPAÑOLES",2,1,3
" 04","CERRO-AMATE","MONTELLANO","TOTAL POBLACION",2,1,3
" 04","CERRO-AMATE","MORON DE LA FRONTERA","ESPAÑOLES",8,6,14
" 04","CERRO-AMATE","MORON DE LA FRONTERA","TOTAL POBLACION",8,6,14
" 04","CERRO-AMATE","NAVAS DE LA CONCEPCION (LAS)","ESPAÑOLES",2,0,2
" 04","CERRO-AMATE","NAVAS DE LA CONCEPCION (LAS)","TOTAL POBLACION",2,0,2
" 04","CERRO-AMATE","OLIVARES","ESPAÑOLES",2,3,5
" 04","CERRO-AMATE","OLIVARES","EXTRANJEROS",1,0,1
" 04","CERRO-AMATE","OLIVARES","TOTAL POBLACION",3,3,6
" 04","CERRO-AMATE","OSUNA","ESPAÑOLES",0,4,4
" 04","CERRO-AMATE","OSUNA","TOTAL POBLACION",0,4,4
" 04","CERRO-AMATE","PALACIOS Y VILLAFRANCA (LOS)","ESPAÑOLES",3,2,5
" 04","CERRO-AMATE","PALACIOS Y VILLAFRANCA (LOS)","EXTRANJEROS",0,1,1
" 04","CERRO-AMATE","PALACIOS Y VILLAFRANCA (LOS)","TOTAL POBLACION",3,3,6
" 04","CERRO-AMATE","PALOMARES DEL RIO","ESPAÑOLES",3,3,6
" 04","CERRO-AMATE","PALOMARES DEL RIO","TOTAL POBLACION",3,3,6
" 04","CERRO-AMATE","PARADAS","ESPAÑOLES",1,2,3
" 04","CERRO-AMATE","PARADAS","TOTAL POBLACION",1,2,3
" 04","CERRO-AMATE","PEÑAFLOR","ESPAÑOLES",1,2,3
" 04","CERRO-AMATE","PEÑAFLOR","TOTAL POBLACION",1,2,3
" 04","CERRO-AMATE","PILAS","ESPAÑOLES",4,3,7
" 04","CERRO-AMATE","PILAS","EXTRANJEROS",0,1,1
" 04","CERRO-AMATE","PILAS","TOTAL POBLACION",4,4,8
" 04","CERRO-AMATE","PRUNA","ESPAÑOLES",2,1,3
" 04","CERRO-AMATE","PRUNA","TOTAL POBLACION",2,1,3
" 04","CERRO-AMATE","PUEBLA DE CAZALLA (LA)","ESPAÑOLES",0,2,2
" 04","CERRO-AMATE","PUEBLA DE CAZALLA (LA)","TOTAL POBLACION",0,2,2
" 04","CERRO-AMATE","PUEBLA DE LOS INFANTES (LA)","ESPAÑOLES",3,0,3
" 04","CERRO-AMATE","PUEBLA DE LOS INFANTES (LA)","EXTRANJEROS",1,0,1
" 04","CERRO-AMATE","PUEBLA DE LOS INFANTES (LA)","TOTAL POBLACION",4,0,4
" 04","CERRO-AMATE","PUEBLA DEL RIO (LA)","ESPAÑOLES",1,1,2
" 04","CERRO-AMATE","PUEBLA DEL RIO (LA)","TOTAL POBLACION",1,1,2
" 04","CERRO-AMATE","RINCONADA (LA)","ESPAÑOLES",22,20,42
" 04","CERRO-AMATE","RINCONADA (LA)","EXTRANJEROS",1,4,5
" 04","CERRO-AMATE","RINCONADA (LA)","TOTAL POBLACION",23,24,47
" 04","CERRO-AMATE","RONQUILLO (EL)","ESPAÑOLES",2,0,2
" 04","CERRO-AMATE","RONQUILLO (EL)","TOTAL POBLACION",2,0,2
" 04","CERRO-AMATE","SALTERAS","ESPAÑOLES",2,6,8
" 04","CERRO-AMATE","SALTERAS","TOTAL POBLACION",2,6,8
" 04","CERRO-AMATE","SAN JUAN DE AZNALFARACHE","ESPAÑOLES",17,16,33
" 04","CERRO-AMATE","SAN JUAN DE AZNALFARACHE","EXTRANJEROS",7,10,17
" 04","CERRO-AMATE","SAN JUAN DE AZNALFARACHE","TOTAL POBLACION",24,26,50
" 04","CERRO-AMATE","SANLUCAR LA MAYOR","ESPAÑOLES",5,3,8
" 04","CERRO-AMATE","SANLUCAR LA MAYOR","EXTRANJEROS",0,3,3
" 04","CERRO-AMATE","SANLUCAR LA MAYOR","TOTAL POBLACION",5,6,11
" 04","CERRO-AMATE","SANTIPONCE","ESPAÑOLES",4,5,9
" 04","CERRO-AMATE","SANTIPONCE","EXTRANJEROS",1,0,1
" 04","CERRO-AMATE","SANTIPONCE","TOTAL POBLACION",5,5,10
" 04","CERRO-AMATE","SAUCEJO (EL)","ESPAÑOLES",0,1,1
" 04","CERRO-AMATE","SAUCEJO (EL)","TOTAL POBLACION",0,1,1
" 04","CERRO-AMATE","TOCINA","ESPAÑOLES",1,5,6
" 04","CERRO-AMATE","TOCINA","TOTAL POBLACION",1,5,6
" 04","CERRO-AMATE","TOMARES","ESPAÑOLES",5,4,9
" 04","CERRO-AMATE","TOMARES","EXTRANJEROS",0,4,4
" 04","CERRO-AMATE","TOMARES","TOTAL POBLACION",5,8,13
" 04","CERRO-AMATE","UMBRETE","ESPAÑOLES",2,3,5
" 04","CERRO-AMATE","UMBRETE","TOTAL POBLACION",2,3,5
" 04","CERRO-AMATE","UTRERA","ESPAÑOLES",12,18,30
" 04","CERRO-AMATE","UTRERA","EXTRANJEROS",3,1,4
" 04","CERRO-AMATE","UTRERA","TOTAL POBLACION",15,19,34
" 04","CERRO-AMATE","VILLAMANRIQUE DE LA CONDESA","ESPAÑOLES",1,0,1
" 04","CERRO-AMATE","VILLAMANRIQUE DE LA CONDESA","TOTAL POBLACION",1,0,1
" 04","CERRO-AMATE","VILLANUEVA DEL ARISCAL","ESPAÑOLES",9,9,18
" 04","CERRO-AMATE","VILLANUEVA DEL ARISCAL","TOTAL POBLACION",9,9,18
" 04","CERRO-AMATE","VILLANUEVA DEL RIO Y MINAS","ESPAÑOLES",1,1,2
" 04","CERRO-AMATE","VILLANUEVA DEL RIO Y MINAS","TOTAL POBLACION",1,1,2
" 04","CERRO-AMATE","VILLAVERDE DEL RIO","ESPAÑOLES",3,5,8
" 04","CERRO-AMATE","VILLAVERDE DEL RIO","TOTAL POBLACION",3,5,8
" 04","CERRO-AMATE","VISO DEL ALCOR (EL)","ESPAÑOLES",5,5,10
" 04","CERRO-AMATE","VISO DEL ALCOR (EL)","TOTAL POBLACION",5,5,10
" 05","SUR","- FUERA DE LA PROVINCIA DE SEVILLA","ESPAÑOLES",445,393,838
" 05","SUR","- FUERA DE LA PROVINCIA DE SEVILLA","EXTRANJEROS",71,72,143
" 05","SUR","- FUERA DE LA PROVINCIA DE SEVILLA","TOTAL POBLACION",516,465,981
" 05","SUR","- PROVINCIA DE SEVILLA","ESPAÑOLES",371,379,750
" 05","SUR","- PROVINCIA DE SEVILLA","EXTRANJEROS",26,48,74
" 05","SUR","- PROVINCIA DE SEVILLA","NO CONSTA",0,1,1
" 05","SUR","- PROVINCIA DE SEVILLA","TOTAL POBLACION",397,428,825
" 05","SUR","AGUADULCE","ESPAÑOLES",1,1,2
" 05","SUR","AGUADULCE","TOTAL POBLACION",1,1,2
" 05","SUR","ALANIS","ESPAÑOLES",0,1,1
" 05","SUR","ALANIS","TOTAL POBLACION",0,1,1
" 05","SUR","ALBAIDA DEL ALJARAFE","ESPAÑOLES",1,0,1
" 05","SUR","ALBAIDA DEL ALJARAFE","TOTAL POBLACION",1,0,1
" 05","SUR","ALCALA DE GUADAIRA","ESPAÑOLES",35,41,76
" 05","SUR","ALCALA DE GUADAIRA","EXTRANJEROS",4,4,8
" 05","SUR","ALCALA DE GUADAIRA","NO CONSTA",0,1,1
" 05","SUR","ALCALA DE GUADAIRA","TOTAL POBLACION",39,46,85
" 05","SUR","ALCALA DEL RIO","ESPAÑOLES",3,2,5
" 05","SUR","ALCALA DEL RIO","EXTRANJEROS",0,1,1
" 05","SUR","ALCALA DEL RIO","TOTAL POBLACION",3,3,6
" 05","SUR","ALCOLEA DEL RIO","ESPAÑOLES",1,0,1
" 05","SUR","ALCOLEA DEL RIO","TOTAL POBLACION",1,0,1
" 05","SUR","ALGABA (LA)","ESPAÑOLES",5,8,13
" 05","SUR","ALGABA (LA)","TOTAL POBLACION",5,8,13
" 05","SUR","ALMENSILLA","ESPAÑOLES",3,3,6
" 05","SUR","ALMENSILLA","TOTAL POBLACION",3,3,6
" 05","SUR","ARAHAL (EL)","ESPAÑOLES",1,2,3
" 05","SUR","ARAHAL (EL)","TOTAL POBLACION",1,2,3
" 05","SUR","AZNALCAZAR","ESPAÑOLES",2,0,2
" 05","SUR","AZNALCAZAR","EXTRANJEROS",0,1,1
" 05","SUR","AZNALCAZAR","TOTAL POBLACION",2,1,3
" 05","SUR","BENACAZON","ESPAÑOLES",0,1,1
" 05","SUR","BENACAZON","EXTRANJEROS",0,1,1
" 05","SUR","BENACAZON","TOTAL POBLACION",0,2,2
" 05","SUR","BOLLULLOS DE LA MITACION","ESPAÑOLES",5,6,11
" 05","SUR","BOLLULLOS DE LA MITACION","EXTRANJEROS",0,1,1
" 05","SUR","BOLLULLOS DE LA MITACION","TOTAL POBLACION",5,7,12
" 05","SUR","BORMUJOS","ESPAÑOLES",10,6,16
" 05","SUR","BORMUJOS","EXTRANJEROS",1,2,3
" 05","SUR","BORMUJOS","TOTAL POBLACION",11,8,19
" 05","SUR","BRENES","ESPAÑOLES",2,0,2
" 05","SUR","BRENES","TOTAL POBLACION",2,0,2
" 05","SUR","BURGUILLOS","ESPAÑOLES",4,4,8
" 05","SUR","BURGUILLOS","EXTRANJEROS",0,1,1
" 05","SUR","BURGUILLOS","TOTAL POBLACION",4,5,9
" 05","SUR","CABEZAS DE SAN JUAN (LAS)","ESPAÑOLES",1,2,3
" 05","SUR","CABEZAS DE SAN JUAN (LAS)","TOTAL POBLACION",1,2,3
" 05","SUR","CAMAS","ESPAÑOLES",7,15,22
" 05","SUR","CAMAS","EXTRANJEROS",4,3,7
" 05","SUR","CAMAS","TOTAL POBLACION",11,18,29
" 05","SUR","CANTILLANA","ESPAÑOLES",3,1,4
" 05","SUR","CANTILLANA","TOTAL POBLACION",3,1,4
" 05","SUR","CARMONA","ESPAÑOLES",10,11,21
" 05","SUR","CARMONA","EXTRANJEROS",1,0,1
" 05","SUR","CARMONA","TOTAL POBLACION",11,11,22
" 05","SUR","CARRION DE LOS CESPEDES","ESPAÑOLES",2,3,5
" 05","SUR","CARRION DE LOS CESPEDES","TOTAL POBLACION",2,3,5
" 05","SUR","CASARICHE","ESPAÑOLES",3,1,4
" 05","SUR","CASARICHE","TOTAL POBLACION",3,1,4
" 05","SUR","CASTILBLANCO DE LOS ARROYOS","ESPAÑOLES",4,2,6
" 05","SUR","CASTILBLANCO DE LOS ARROYOS","TOTAL POBLACION",4,2,6
" 05","SUR","CASTILLEJA DE GUZMAN","ESPAÑOLES",1,0,1
" 05","SUR","CASTILLEJA DE GUZMAN","TOTAL POBLACION",1,0,1
" 05","SUR","CASTILLEJA DE LA CUESTA","ESPAÑOLES",8,6,14
" 05","SUR","CASTILLEJA DE LA CUESTA","EXTRANJEROS",0,2,2
" 05","SUR","CASTILLEJA DE LA CUESTA","TOTAL POBLACION",8,8,16
" 05","SUR","CONSTANTINA","ESPAÑOLES",1,0,1
" 05","SUR","CONSTANTINA","TOTAL POBLACION",1,0,1
" 05","SUR","CORIA DEL RIO","ESPAÑOLES",8,10,18
" 05","SUR","CORIA DEL RIO","EXTRANJEROS",2,1,3
" 05","SUR","CORIA DEL RIO","TOTAL POBLACION",10,11,21
" 05","SUR","CORONIL (EL)","ESPAÑOLES",1,0,1
" 05","SUR","CORONIL (EL)","EXTRANJEROS",0,1,1
" 05","SUR","CORONIL (EL)","TOTAL POBLACION",1,1,2
" 05","SUR","CORRALES (LOS)","ESPAÑOLES",0,1,1
" 05","SUR","CORRALES (LOS)","TOTAL POBLACION",0,1,1
" 05","SUR","DOS HERMANAS","ESPAÑOLES",86,91,177
" 05","SUR","DOS HERMANAS","EXTRANJEROS",2,11,13
" 05","SUR","DOS HERMANAS","TOTAL POBLACION",88,102,190
" 05","SUR","ECIJA","ESPAÑOLES",0,2,2
" 05","SUR","ECIJA","TOTAL POBLACION",0,2,2
" 05","SUR","ESPARTINAS","ESPAÑOLES",7,5,12
" 05","SUR","ESPARTINAS","TOTAL POBLACION",7,5,12
" 05","SUR","FUENTES DE ANDALUCIA","ESPAÑOLES",3,1,4
" 05","SUR","FUENTES DE ANDALUCIA","TOTAL POBLACION",3,1,4
" 05","SUR","GELVES","ESPAÑOLES",11,15,26
" 05","SUR","GELVES","EXTRANJEROS",0,1,1
" 05","SUR","GELVES","TOTAL POBLACION",11,16,27
" 05","SUR","GERENA","ESPAÑOLES",1,2,3
" 05","SUR","GERENA","EXTRANJEROS",0,1,1
" 05","SUR","GERENA","TOTAL POBLACION",1,3,4
" 05","SUR","GINES","ESPAÑOLES",2,1,3
" 05","SUR","GINES","EXTRANJEROS",1,1,2
" 05","SUR","GINES","TOTAL POBLACION",3,2,5
" 05","SUR","GUILLENA","ESPAÑOLES",1,3,4
" 05","SUR","GUILLENA","EXTRANJEROS",0,2,2
" 05","SUR","GUILLENA","TOTAL POBLACION",1,5,6
" 05","SUR","HUEVAR DEL ALJARAFE","ESPAÑOLES",4,5,9
" 05","SUR","HUEVAR DEL ALJARAFE","TOTAL POBLACION",4,5,9
" 05","SUR","ISLA MAYOR","ESPAÑOLES",0,1,1
" 05","SUR","ISLA MAYOR","TOTAL POBLACION",0,1,1
" 05","SUR","LEBRIJA","ESPAÑOLES",2,3,5
" 05","SUR","LEBRIJA","TOTAL POBLACION",2,3,5
" 05","SUR","LORA DEL RIO","ESPAÑOLES",0,1,1
" 05","SUR","LORA DEL RIO","TOTAL POBLACION",0,1,1
" 05","SUR","MAIRENA DEL ALCOR","ESPAÑOLES",14,13,27
" 05","SUR","MAIRENA DEL ALCOR","EXTRANJEROS",2,0,2
" 05","SUR","MAIRENA DEL ALCOR","TOTAL POBLACION",16,13,29
" 05","SUR","MAIRENA DEL ALJARAFE","ESPAÑOLES",34,24,58
" 05","SUR","MAIRENA DEL ALJARAFE","EXTRANJEROS",1,3,4
" 05","SUR","MAIRENA DEL ALJARAFE","TOTAL POBLACION",35,27,62
" 05","SUR","MARCHENA","ESPAÑOLES",1,2,3
" 05","SUR","MARCHENA","EXTRANJEROS",0,1,1
" 05","SUR","MARCHENA","TOTAL POBLACION",1,3,4
" 05","SUR","MONTELLANO","ESPAÑOLES",1,0,1
" 05","SUR","MONTELLANO","TOTAL POBLACION",1,0,1
" 05","SUR","MORON DE LA FRONTERA","ESPAÑOLES",0,2,2
" 05","SUR","MORON DE LA FRONTERA","EXTRANJEROS",1,0,1
" 05","SUR","MORON DE LA FRONTERA","TOTAL POBLACION",1,2,3
" 05","SUR","OLIVARES","ESPAÑOLES",2,0,2
" 05","SUR","OLIVARES","TOTAL POBLACION",2,0,2
" 05","SUR","OSUNA","ESPAÑOLES",1,1,2
" 05","SUR","OSUNA","TOTAL POBLACION",1,1,2
" 05","SUR","PALACIOS Y VILLAFRANCA (LOS)","ESPAÑOLES",1,3,4
" 05","SUR","PALACIOS Y VILLAFRANCA (LOS)","EXTRANJEROS",0,1,1
" 05","SUR","PALACIOS Y VILLAFRANCA (LOS)","TOTAL POBLACION",1,4,5
" 05","SUR","PALOMARES DEL RIO","ESPAÑOLES",3,4,7
" 05","SUR","PALOMARES DEL RIO","TOTAL POBLACION",3,4,7
" 05","SUR","PEDRERA","ESPAÑOLES",0,1,1
" 05","SUR","PEDRERA","TOTAL POBLACION",0,1,1
" 05","SUR","PEÑAFLOR","ESPAÑOLES",1,1,2
" 05","SUR","PEÑAFLOR","TOTAL POBLACION",1,1,2
" 05","SUR","PILAS","ESPAÑOLES",1,0,1
" 05","SUR","PILAS","TOTAL POBLACION",1,0,1
" 05","SUR","PUEBLA DEL RIO (LA)","ESPAÑOLES",1,3,4
" 05","SUR","PUEBLA DEL RIO (LA)","TOTAL POBLACION",1,3,4
" 05","SUR","REAL DE LA JARA (EL)","ESPAÑOLES",1,0,1
" 05","SUR","REAL DE LA JARA (EL)","TOTAL POBLACION",1,0,1
" 05","SUR","RINCONADA (LA)","ESPAÑOLES",14,4,18
" 05","SUR","RINCONADA (LA)","TOTAL POBLACION",14,4,18
" 05","SUR","RONQUILLO (EL)","ESPAÑOLES",0,1,1
" 05","SUR","RONQUILLO (EL)","EXTRANJEROS",0,2,2
" 05","SUR","RONQUILLO (EL)","TOTAL POBLACION",0,3,3
" 05","SUR","RUBIO (EL)","ESPAÑOLES",0,2,2
" 05","SUR","RUBIO (EL)","TOTAL POBLACION",0,2,2
" 05","SUR","SAN JUAN DE AZNALFARACHE","ESPAÑOLES",16,15,31
" 05","SUR","SAN JUAN DE AZNALFARACHE","EXTRANJEROS",2,4,6
" 05","SUR","SAN JUAN DE AZNALFARACHE","TOTAL POBLACION",18,19,37
" 05","SUR","SANLUCAR LA MAYOR","ESPAÑOLES",8,5,13
" 05","SUR","SANLUCAR LA MAYOR","EXTRANJEROS",2,0,2
" 05","SUR","SANLUCAR LA MAYOR","TOTAL POBLACION",10,5,15
" 05","SUR","SANTIPONCE","ESPAÑOLES",2,3,5
" 05","SUR","SANTIPONCE","TOTAL POBLACION",2,3,5
" 05","SUR","TOCINA","ESPAÑOLES",1,1,2
" 05","SUR","TOCINA","TOTAL POBLACION",1,1,2
" 05","SUR","TOMARES","ESPAÑOLES",14,6,20
" 05","SUR","TOMARES","TOTAL POBLACION",14,6,20
" 05","SUR","UMBRETE","ESPAÑOLES",3,2,5
" 05","SUR","UMBRETE","TOTAL POBLACION",3,2,5
" 05","SUR","UTRERA","ESPAÑOLES",10,18,28
" 05","SUR","UTRERA","EXTRANJEROS",3,3,6
" 05","SUR","UTRERA","TOTAL POBLACION",13,21,34
" 05","SUR","VALENCINA DE LA CONCEPCION","ESPAÑOLES",2,3,5
" 05","SUR","VALENCINA DE LA CONCEPCION","TOTAL POBLACION",2,3,5
" 05","SUR","VILLAMANRIQUE DE LA CONDESA","ESPAÑOLES",0,2,2
" 05","SUR","VILLAMANRIQUE DE LA CONDESA","TOTAL POBLACION",0,2,2
" 05","SUR","VILLANUEVA DEL ARISCAL","ESPAÑOLES",1,3,4
" 05","SUR","VILLANUEVA DEL ARISCAL","TOTAL POBLACION",1,3,4
" 05","SUR","VISO DEL ALCOR (EL)","ESPAÑOLES",0,3,3
" 05","SUR","VISO DEL ALCOR (EL)","TOTAL POBLACION",0,3,3
" 06","TRIANA","- FUERA DE LA PROVINCIA DE SEVILLA","ESPAÑOLES",238,279,517
" 06","TRIANA","- FUERA DE LA PROVINCIA DE SEVILLA","EXTRANJEROS",35,48,83
" 06","TRIANA","- FUERA DE LA PROVINCIA DE SEVILLA","TOTAL POBLACION",273,327,600
" 06","TRIANA","- PROVINCIA DE SEVILLA","ESPAÑOLES",344,352,696
" 06","TRIANA","- PROVINCIA DE SEVILLA","EXTRANJEROS",33,36,69
" 06","TRIANA","- PROVINCIA DE SEVILLA","NO CONSTA",0,1,1
" 06","TRIANA","- PROVINCIA DE SEVILLA","TOTAL POBLACION",377,389,766
" 06","TRIANA","ALBAIDA DEL ALJARAFE","ESPAÑOLES",2,0,2
" 06","TRIANA","ALBAIDA DEL ALJARAFE","TOTAL POBLACION",2,0,2
" 06","TRIANA","ALCALA DE GUADAIRA","ESPAÑOLES",13,12,25
" 06","TRIANA","ALCALA DE GUADAIRA","EXTRANJEROS",2,2,4
" 06","TRIANA","ALCALA DE GUADAIRA","TOTAL POBLACION",15,14,29
" 06","TRIANA","ALCALA DEL RIO","ESPAÑOLES",0,2,2
" 06","TRIANA","ALCALA DEL RIO","TOTAL POBLACION",0,2,2
" 06","TRIANA","ALGABA (LA)","ESPAÑOLES",4,7,11
" 06","TRIANA","ALGABA (LA)","EXTRANJEROS",1,0,1
" 06","TRIANA","ALGABA (LA)","TOTAL POBLACION",5,7,12
" 06","TRIANA","ALMADEN DE LA PLATA","ESPAÑOLES",1,1,2
" 06","TRIANA","ALMADEN DE LA PLATA","TOTAL POBLACION",1,1,2
" 06","TRIANA","ALMENSILLA","ESPAÑOLES",2,5,7
" 06","TRIANA","ALMENSILLA","EXTRANJEROS",0,1,1
" 06","TRIANA","ALMENSILLA","TOTAL POBLACION",2,6,8
" 06","TRIANA","AZNALCAZAR","ESPAÑOLES",0,1,1
" 06","TRIANA","AZNALCAZAR","EXTRANJEROS",2,1,3
" 06","TRIANA","AZNALCAZAR","TOTAL POBLACION",2,2,4
" 06","TRIANA","AZNALCOLLAR","ESPAÑOLES",0,1,1
" 06","TRIANA","AZNALCOLLAR","TOTAL POBLACION",0,1,1
" 06","TRIANA","BENACAZON","ESPAÑOLES",1,2,3
" 06","TRIANA","BENACAZON","TOTAL POBLACION",1,2,3
" 06","TRIANA","BOLLULLOS DE LA MITACION","ESPAÑOLES",7,7,14
" 06","TRIANA","BOLLULLOS DE LA MITACION","EXTRANJEROS",1,1,2
" 06","TRIANA","BOLLULLOS DE LA MITACION","TOTAL POBLACION",8,8,16
" 06","TRIANA","BORMUJOS","ESPAÑOLES",11,18,29
" 06","TRIANA","BORMUJOS","EXTRANJEROS",1,2,3
" 06","TRIANA","BORMUJOS","TOTAL POBLACION",12,20,32
" 06","TRIANA","BRENES","ESPAÑOLES",2,3,5
" 06","TRIANA","BRENES","TOTAL POBLACION",2,3,5
" 06","TRIANA","BURGUILLOS","ESPAÑOLES",2,0,2
" 06","TRIANA","BURGUILLOS","TOTAL POBLACION",2,0,2
" 06","TRIANA","CAMAS","ESPAÑOLES",37,34,71
" 06","TRIANA","CAMAS","EXTRANJEROS",3,7,10
" 06","TRIANA","CAMAS","TOTAL POBLACION",40,41,81
" 06","TRIANA","CANTILLANA","ESPAÑOLES",0,1,1
" 06","TRIANA","CANTILLANA","TOTAL POBLACION",0,1,1
" 06","TRIANA","CARMONA","ESPAÑOLES",1,5,6
" 06","TRIANA","CARMONA","TOTAL POBLACION",1,5,6
" 06","TRIANA","CARRION DE LOS CESPEDES","ESPAÑOLES",1,1,2
" 06","TRIANA","CARRION DE LOS CESPEDES","TOTAL POBLACION",1,1,2
" 06","TRIANA","CASTILBLANCO DE LOS ARROYOS","ESPAÑOLES",6,3,9
" 06","TRIANA","CASTILBLANCO DE LOS ARROYOS","TOTAL POBLACION",6,3,9
" 06","TRIANA","CASTILLEJA DE GUZMAN","ESPAÑOLES",2,6,8
" 06","TRIANA","CASTILLEJA DE GUZMAN","TOTAL POBLACION",2,6,8
" 06","TRIANA","CASTILLEJA DE LA CUESTA","ESPAÑOLES",15,20,35
" 06","TRIANA","CASTILLEJA DE LA CUESTA","EXTRANJEROS",2,0,2
" 06","TRIANA","CASTILLEJA DE LA CUESTA","TOTAL POBLACION",17,20,37
" 06","TRIANA","CAZALLA DE LA SIERRA","ESPAÑOLES",1,0,1
" 06","TRIANA","CAZALLA DE LA SIERRA","TOTAL POBLACION",1,0,1
" 06","TRIANA","CONSTANTINA","ESPAÑOLES",1,1,2
" 06","TRIANA","CONSTANTINA","TOTAL POBLACION",1,1,2
" 06","TRIANA","CORIA DEL RIO","ESPAÑOLES",7,7,14
" 06","TRIANA","CORIA DEL RIO","EXTRANJEROS",1,0,1
" 06","TRIANA","CORIA DEL RIO","TOTAL POBLACION",8,7,15
" 06","TRIANA","CORRALES (LOS)","ESPAÑOLES",1,0,1
" 06","TRIANA","CORRALES (LOS)","TOTAL POBLACION",1,0,1
" 06","TRIANA","DOS HERMANAS","ESPAÑOLES",18,28,46
" 06","TRIANA","DOS HERMANAS","EXTRANJEROS",1,1,2
" 06","TRIANA","DOS HERMANAS","TOTAL POBLACION",19,29,48
" 06","TRIANA","ECIJA","ESPAÑOLES",2,2,4
" 06","TRIANA","ECIJA","TOTAL POBLACION",2,2,4
" 06","TRIANA","ESPARTINAS","ESPAÑOLES",13,13,26
" 06","TRIANA","ESPARTINAS","EXTRANJEROS",1,1,2
" 06","TRIANA","ESPARTINAS","TOTAL POBLACION",14,14,28
" 06","TRIANA","ESTEPA","ESPAÑOLES",1,0,1
" 06","TRIANA","ESTEPA","TOTAL POBLACION",1,0,1
" 06","TRIANA","GARROBO (EL)","ESPAÑOLES",1,1,2
" 06","TRIANA","GARROBO (EL)","TOTAL POBLACION",1,1,2
" 06","TRIANA","GELVES","ESPAÑOLES",19,15,34
" 06","TRIANA","GELVES","EXTRANJEROS",0,1,1
" 06","TRIANA","GELVES","TOTAL POBLACION",19,16,35
" 06","TRIANA","GERENA","ESPAÑOLES",2,2,4
" 06","TRIANA","GERENA","TOTAL POBLACION",2,2,4
" 06","TRIANA","GINES","ESPAÑOLES",12,6,18
" 06","TRIANA","GINES","TOTAL POBLACION",12,6,18
" 06","TRIANA","GUILLENA","ESPAÑOLES",6,6,12
" 06","TRIANA","GUILLENA","EXTRANJEROS",1,0,1
" 06","TRIANA","GUILLENA","TOTAL POBLACION",7,6,13
" 06","TRIANA","HUEVAR DEL ALJARAFE","ESPAÑOLES",1,2,3
" 06","TRIANA","HUEVAR DEL ALJARAFE","TOTAL POBLACION",1,2,3
" 06","TRIANA","LEBRIJA","ESPAÑOLES",1,0,1
" 06","TRIANA","LEBRIJA","EXTRANJEROS",1,0,1
" 06","TRIANA","LEBRIJA","TOTAL POBLACION",2,0,2
" 06","TRIANA","LORA DEL RIO","ESPAÑOLES",1,2,3
" 06","TRIANA","LORA DEL RIO","TOTAL POBLACION",1,2,3
" 06","TRIANA","MAIRENA DEL ALCOR","ESPAÑOLES",1,0,1
" 06","TRIANA","MAIRENA DEL ALCOR","EXTRANJEROS",1,0,1
" 06","TRIANA","MAIRENA DEL ALCOR","TOTAL POBLACION",2,0,2
" 06","TRIANA","MAIRENA DEL ALJARAFE","ESPAÑOLES",39,35,74
" 06","TRIANA","MAIRENA DEL ALJARAFE","EXTRANJEROS",3,6,9
" 06","TRIANA","MAIRENA DEL ALJARAFE","NO CONSTA",0,1,1
" 06","TRIANA","MAIRENA DEL ALJARAFE","TOTAL POBLACION",42,42,84
" 06","TRIANA","MARCHENA","ESPAÑOLES",3,0,3
" 06","TRIANA","MARCHENA","TOTAL POBLACION",3,0,3
" 06","TRIANA","MORON DE LA FRONTERA","ESPAÑOLES",5,1,6
" 06","TRIANA","MORON DE LA FRONTERA","TOTAL POBLACION",5,1,6
" 06","TRIANA","OLIVARES","ESPAÑOLES",1,2,3
" 06","TRIANA","OLIVARES","EXTRANJEROS",0,1,1
" 06","TRIANA","OLIVARES","TOTAL POBLACION",1,3,4
" 06","TRIANA","OSUNA","ESPAÑOLES",1,1,2
" 06","TRIANA","OSUNA","TOTAL POBLACION",1,1,2
" 06","TRIANA","PALACIOS Y VILLAFRANCA (LOS)","ESPAÑOLES",3,4,7
" 06","TRIANA","PALACIOS Y VILLAFRANCA (LOS)","TOTAL POBLACION",3,4,7
" 06","TRIANA","PALOMARES DEL RIO","ESPAÑOLES",6,6,12
" 06","TRIANA","PALOMARES DEL RIO","EXTRANJEROS",1,1,2
" 06","TRIANA","PALOMARES DEL RIO","TOTAL POBLACION",7,7,14
" 06","TRIANA","PEDROSO (EL)","ESPAÑOLES",1,0,1
" 06","TRIANA","PEDROSO (EL)","TOTAL POBLACION",1,0,1
" 06","TRIANA","PILAS","ESPAÑOLES",3,4,7
" 06","TRIANA","PILAS","EXTRANJEROS",1,0,1
" 06","TRIANA","PILAS","TOTAL POBLACION",4,4,8
" 06","TRIANA","PUEBLA DEL RIO (LA)","ESPAÑOLES",1,0,1
" 06","TRIANA","PUEBLA DEL RIO (LA)","TOTAL POBLACION",1,0,1
" 06","TRIANA","RINCONADA (LA)","ESPAÑOLES",7,2,9
" 06","TRIANA","RINCONADA (LA)","TOTAL POBLACION",7,2,9
" 06","TRIANA","RONQUILLO (EL)","ESPAÑOLES",1,1,2
" 06","TRIANA","RONQUILLO (EL)","TOTAL POBLACION",1,1,2
" 06","TRIANA","SALTERAS","ESPAÑOLES",2,4,6
" 06","TRIANA","SALTERAS","TOTAL POBLACION",2,4,6
" 06","TRIANA","SAN JUAN DE AZNALFARACHE","ESPAÑOLES",22,17,39
" 06","TRIANA","SAN JUAN DE AZNALFARACHE","EXTRANJEROS",5,4,9
" 06","TRIANA","SAN JUAN DE AZNALFARACHE","TOTAL POBLACION",27,21,48
" 06","TRIANA","SAN NICOLAS DEL PUERTO","ESPAÑOLES",1,2,3
" 06","TRIANA","SAN NICOLAS DEL PUERTO","TOTAL POBLACION",1,2,3
" 06","TRIANA","SANLUCAR LA MAYOR","ESPAÑOLES",4,7,11
" 06","TRIANA","SANLUCAR LA MAYOR","EXTRANJEROS",1,1,2
" 06","TRIANA","SANLUCAR LA MAYOR","TOTAL POBLACION",5,8,13
" 06","TRIANA","SANTIPONCE","ESPAÑOLES",3,4,7
" 06","TRIANA","SANTIPONCE","EXTRANJEROS",1,0,1
" 06","TRIANA","SANTIPONCE","TOTAL POBLACION",4,4,8
" 06","TRIANA","TOCINA","ESPAÑOLES",1,1,2
" 06","TRIANA","TOCINA","TOTAL POBLACION",1,1,2
" 06","TRIANA","TOMARES","ESPAÑOLES",22,17,39
" 06","TRIANA","TOMARES","EXTRANJEROS",1,2,3
" 06","TRIANA","TOMARES","TOTAL POBLACION",23,19,42
" 06","TRIANA","UMBRETE","ESPAÑOLES",5,8,13
" 06","TRIANA","UMBRETE","TOTAL POBLACION",5,8,13
" 06","TRIANA","UTRERA","ESPAÑOLES",2,5,7
" 06","TRIANA","UTRERA","EXTRANJEROS",2,4,6
" 06","TRIANA","UTRERA","TOTAL POBLACION",4,9,13
" 06","TRIANA","VALENCINA DE LA CONCEPCION","ESPAÑOLES",10,6,16
" 06","TRIANA","VALENCINA DE LA CONCEPCION","TOTAL POBLACION",10,6,16
" 06","TRIANA","VILLAMANRIQUE DE LA CONDESA","ESPAÑOLES",2,1,3
" 06","TRIANA","VILLAMANRIQUE DE LA CONDESA","TOTAL POBLACION",2,1,3
" 06","TRIANA","VILLANUEVA DEL ARISCAL","ESPAÑOLES",2,6,8
" 06","TRIANA","VILLANUEVA DEL ARISCAL","TOTAL POBLACION",2,6,8
" 06","TRIANA","VILLANUEVA DEL RIO Y MINAS","ESPAÑOLES",0,3,3
" 06","TRIANA","VILLANUEVA DEL RIO Y MINAS","TOTAL POBLACION",0,3,3
" 06","TRIANA","VILLAVERDE DEL RIO","ESPAÑOLES",1,1,2
" 06","TRIANA","VILLAVERDE DEL RIO","TOTAL POBLACION",1,1,2
" 06","TRIANA","VISO DEL ALCOR (EL)","ESPAÑOLES",1,0,1
" 06","TRIANA","VISO DEL ALCOR (EL)","TOTAL POBLACION",1,0,1
" 07","NORTE","- FUERA DE LA PROVINCIA DE SEVILLA","ESPAÑOLES",258,240,498
" 07","NORTE","- FUERA DE LA PROVINCIA DE SEVILLA","EXTRANJEROS",53,44,97
" 07","NORTE","- FUERA DE LA PROVINCIA DE SEVILLA","TOTAL POBLACION",311,284,595
" 07","NORTE","- PROVINCIA DE SEVILLA","ESPAÑOLES",451,456,907
" 07","NORTE","- PROVINCIA DE SEVILLA","EXTRANJEROS",29,37,66
" 07","NORTE","- PROVINCIA DE SEVILLA","TOTAL POBLACION",480,493,973
" 07","NORTE","ALCALA DE GUADAIRA","ESPAÑOLES",33,18,51
" 07","NORTE","ALCALA DE GUADAIRA","EXTRANJEROS",0,1,1
" 07","NORTE","ALCALA DE GUADAIRA","TOTAL POBLACION",33,19,52
" 07","NORTE","ALCALA DEL RIO","ESPAÑOLES",31,24,55
" 07","NORTE","ALCALA DEL RIO","EXTRANJEROS",2,2,4
" 07","NORTE","ALCALA DEL RIO","TOTAL POBLACION",33,26,59
" 07","NORTE","ALGABA (LA)","ESPAÑOLES",21,33,54
" 07","NORTE","ALGABA (LA)","EXTRANJEROS",2,4,6
" 07","NORTE","ALGABA (LA)","TOTAL POBLACION",23,37,60
" 07","NORTE","ALMADEN DE LA PLATA","ESPAÑOLES",1,1,2
" 07","NORTE","ALMADEN DE LA PLATA","TOTAL POBLACION",1,1,2
" 07","NORTE","ALMENSILLA","ESPAÑOLES",1,7,8
" 07","NORTE","ALMENSILLA","TOTAL POBLACION",1,7,8
" 07","NORTE","AZNALCAZAR","ESPAÑOLES",3,2,5
" 07","NORTE","AZNALCAZAR","TOTAL POBLACION",3,2,5
" 07","NORTE","AZNALCOLLAR","ESPAÑOLES",1,3,4
" 07","NORTE","AZNALCOLLAR","EXTRANJEROS",1,0,1
" 07","NORTE","AZNALCOLLAR","TOTAL POBLACION",2,3,5
" 07","NORTE","BOLLULLOS DE LA MITACION","ESPAÑOLES",7,5,12
" 07","NORTE","BOLLULLOS DE LA MITACION","TOTAL POBLACION",7,5,12
" 07","NORTE","BORMUJOS","ESPAÑOLES",11,11,22
" 07","NORTE","BORMUJOS","EXTRANJEROS",0,2,2
" 07","NORTE","BORMUJOS","TOTAL POBLACION",11,13,24
" 07","NORTE","BRENES","ESPAÑOLES",3,5,8
" 07","NORTE","BRENES","TOTAL POBLACION",3,5,8
" 07","NORTE","BURGUILLOS","ESPAÑOLES",7,13,20
" 07","NORTE","BURGUILLOS","TOTAL POBLACION",7,13,20
" 07","NORTE","CAMAS","ESPAÑOLES",19,24,43
" 07","NORTE","CAMAS","EXTRANJEROS",1,3,4
" 07","NORTE","CAMAS","TOTAL POBLACION",20,27,47
" 07","NORTE","CAMPANA (LA)","ESPAÑOLES",1,0,1
" 07","NORTE","CAMPANA (LA)","TOTAL POBLACION",1,0,1
" 07","NORTE","CANTILLANA","ESPAÑOLES",0,3,3
" 07","NORTE","CANTILLANA","TOTAL POBLACION",0,3,3
" 07","NORTE","CARMONA","ESPAÑOLES",13,15,28
" 07","NORTE","CARMONA","TOTAL POBLACION",13,15,28
" 07","NORTE","CARRION DE LOS CESPEDES","ESPAÑOLES",2,0,2
" 07","NORTE","CARRION DE LOS CESPEDES","TOTAL POBLACION",2,0,2
" 07","NORTE","CASTILBLANCO DE LOS ARROYOS","ESPAÑOLES",2,4,6
" 07","NORTE","CASTILBLANCO DE LOS ARROYOS","TOTAL POBLACION",2,4,6
" 07","NORTE","CASTILLEJA DE GUZMAN","ESPAÑOLES",1,1,2
" 07","NORTE","CASTILLEJA DE GUZMAN","TOTAL POBLACION",1,1,2
" 07","NORTE","CASTILLEJA DE LA CUESTA","ESPAÑOLES",8,11,19
" 07","NORTE","CASTILLEJA DE LA CUESTA","EXTRANJEROS",2,3,5
" 07","NORTE","CASTILLEJA DE LA CUESTA","TOTAL POBLACION",10,14,24
" 07","NORTE","CAZALLA DE LA SIERRA","ESPAÑOLES",1,3,4
" 07","NORTE","CAZALLA DE LA SIERRA","TOTAL POBLACION",1,3,4
" 07","NORTE","CONSTANTINA","ESPAÑOLES",1,0,1
" 07","NORTE","CONSTANTINA","TOTAL POBLACION",1,0,1
" 07","NORTE","CORIA DEL RIO","ESPAÑOLES",12,8,20
" 07","NORTE","CORIA DEL RIO","EXTRANJEROS",1,1,2
" 07","NORTE","CORIA DEL RIO","TOTAL POBLACION",13,9,22
" 07","NORTE","DOS HERMANAS","ESPAÑOLES",41,44,85
" 07","NORTE","DOS HERMANAS","EXTRANJEROS",4,2,6
" 07","NORTE","DOS HERMANAS","TOTAL POBLACION",45,46,91
" 07","NORTE","ECIJA","ESPAÑOLES",2,2,4
" 07","NORTE","ECIJA","TOTAL POBLACION",2,2,4
" 07","NORTE","ESPARTINAS","ESPAÑOLES",8,6,14
" 07","NORTE","ESPARTINAS","TOTAL POBLACION",8,6,14
" 07","NORTE","ESTEPA","ESPAÑOLES",1,0,1
" 07","NORTE","ESTEPA","TOTAL POBLACION",1,0,1
" 07","NORTE","FUENTES DE ANDALUCIA","ESPAÑOLES",2,0,2
" 07","NORTE","FUENTES DE ANDALUCIA","TOTAL POBLACION",2,0,2
" 07","NORTE","GARROBO (EL)","ESPAÑOLES",1,1,2
" 07","NORTE","GARROBO (EL)","TOTAL POBLACION",1,1,2
" 07","NORTE","GELVES","ESPAÑOLES",8,6,14
" 07","NORTE","GELVES","TOTAL POBLACION",8,6,14
" 07","NORTE","GERENA","ESPAÑOLES",6,10,16
" 07","NORTE","GERENA","EXTRANJEROS",1,2,3
" 07","NORTE","GERENA","TOTAL POBLACION",7,12,19
" 07","NORTE","GINES","ESPAÑOLES",3,4,7
" 07","NORTE","GINES","EXTRANJEROS",1,0,1
" 07","NORTE","GINES","TOTAL POBLACION",4,4,8
" 07","NORTE","GUADALCANAL","ESPAÑOLES",2,1,3
" 07","NORTE","GUADALCANAL","TOTAL POBLACION",2,1,3
" 07","NORTE","GUILLENA","ESPAÑOLES",13,13,26
" 07","NORTE","GUILLENA","TOTAL POBLACION",13,13,26
" 07","NORTE","HUEVAR DEL ALJARAFE","ESPAÑOLES",5,2,7
" 07","NORTE","HUEVAR DEL ALJARAFE","EXTRANJEROS",0,1,1
" 07","NORTE","HUEVAR DEL ALJARAFE","TOTAL POBLACION",5,3,8
" 07","NORTE","ISLA MAYOR","ESPAÑOLES",1,1,2
" 07","NORTE","ISLA MAYOR","TOTAL POBLACION",1,1,2
" 07","NORTE","LEBRIJA","ESPAÑOLES",0,2,2
" 07","NORTE","LEBRIJA","EXTRANJEROS",1,0,1
" 07","NORTE","LEBRIJA","TOTAL POBLACION",1,2,3
" 07","NORTE","MAIRENA DEL ALCOR","ESPAÑOLES",4,2,6
" 07","NORTE","MAIRENA DEL ALCOR","TOTAL POBLACION",4,2,6
" 07","NORTE","MAIRENA DEL ALJARAFE","ESPAÑOLES",15,12,27
" 07","NORTE","MAIRENA DEL ALJARAFE","EXTRANJEROS",3,2,5
" 07","NORTE","MAIRENA DEL ALJARAFE","TOTAL POBLACION",18,14,32
" 07","NORTE","MARCHENA","ESPAÑOLES",2,1,3
" 07","NORTE","MARCHENA","TOTAL POBLACION",2,1,3
" 07","NORTE","MONTELLANO","ESPAÑOLES",1,0,1
" 07","NORTE","MONTELLANO","TOTAL POBLACION",1,0,1
" 07","NORTE","MORON DE LA FRONTERA","ESPAÑOLES",1,1,2
" 07","NORTE","MORON DE LA FRONTERA","EXTRANJEROS",0,1,1
" 07","NORTE","MORON DE LA FRONTERA","TOTAL POBLACION",1,2,3
" 07","NORTE","NAVAS DE LA CONCEPCION (LAS)","ESPAÑOLES",1,0,1
" 07","NORTE","NAVAS DE LA CONCEPCION (LAS)","TOTAL POBLACION",1,0,1
" 07","NORTE","OLIVARES","ESPAÑOLES",3,0,3
" 07","NORTE","OLIVARES","TOTAL POBLACION",3,0,3
" 07","NORTE","OSUNA","ESPAÑOLES",3,0,3
" 07","NORTE","OSUNA","TOTAL POBLACION",3,0,3
" 07","NORTE","PALACIOS Y VILLAFRANCA (LOS)","ESPAÑOLES",3,1,4
" 07","NORTE","PALACIOS Y VILLAFRANCA (LOS)","TOTAL POBLACION",3,1,4
" 07","NORTE","PALOMARES DEL RIO","ESPAÑOLES",7,10,17
" 07","NORTE","PALOMARES DEL RIO","EXTRANJEROS",0,1,1
" 07","NORTE","PALOMARES DEL RIO","TOTAL POBLACION",7,11,18
" 07","NORTE","PARADAS","ESPAÑOLES",1,1,2
" 07","NORTE","PARADAS","TOTAL POBLACION",1,1,2
" 07","NORTE","PEDROSO (EL)","ESPAÑOLES",0,4,4
" 07","NORTE","PEDROSO (EL)","TOTAL POBLACION",0,4,4
" 07","NORTE","PEÑAFLOR","ESPAÑOLES",0,2,2
" 07","NORTE","PEÑAFLOR","TOTAL POBLACION",0,2,2
" 07","NORTE","PILAS","ESPAÑOLES",1,3,4
" 07","NORTE","PILAS","EXTRANJEROS",1,0,1
" 07","NORTE","PILAS","TOTAL POBLACION",2,3,5
" 07","NORTE","PUEBLA DE CAZALLA (LA)","ESPAÑOLES",2,2,4
" 07","NORTE","PUEBLA DE CAZALLA (LA)","TOTAL POBLACION",2,2,4
" 07","NORTE","PUEBLA DE LOS INFANTES (LA)","ESPAÑOLES",0,1,1
" 07","NORTE","PUEBLA DE LOS INFANTES (LA)","TOTAL POBLACION",0,1,1
" 07","NORTE","PUEBLA DEL RIO (LA)","ESPAÑOLES",2,0,2
" 07","NORTE","PUEBLA DEL RIO (LA)","TOTAL POBLACION",2,0,2
" 07","NORTE","RINCONADA (LA)","ESPAÑOLES",56,58,114
" 07","NORTE","RINCONADA (LA)","EXTRANJEROS",3,6,9
" 07","NORTE","RINCONADA (LA)","TOTAL POBLACION",59,64,123
" 07","NORTE","RONQUILLO (EL)","ESPAÑOLES",1,0,1
" 07","NORTE","RONQUILLO (EL)","TOTAL POBLACION",1,0,1
" 07","NORTE","SALTERAS","ESPAÑOLES",4,2,6
" 07","NORTE","SALTERAS","TOTAL POBLACION",4,2,6
" 07","NORTE","SAN JUAN DE AZNALFARACHE","ESPAÑOLES",14,11,25
" 07","NORTE","SAN JUAN DE AZNALFARACHE","EXTRANJEROS",3,1,4
" 07","NORTE","SAN JUAN DE AZNALFARACHE","TOTAL POBLACION",17,12,29
" 07","NORTE","SANLUCAR LA MAYOR","ESPAÑOLES",10,7,17
" 07","NORTE","SANLUCAR LA MAYOR","TOTAL POBLACION",10,7,17
" 07","NORTE","SANTIPONCE","ESPAÑOLES",7,12,19
" 07","NORTE","SANTIPONCE","TOTAL POBLACION",7,12,19
" 07","NORTE","TOCINA","ESPAÑOLES",1,1,2
" 07","NORTE","TOCINA","TOTAL POBLACION",1,1,2
" 07","NORTE","TOMARES","ESPAÑOLES",4,7,11
" 07","NORTE","TOMARES","TOTAL POBLACION",4,7,11
" 07","NORTE","UMBRETE","ESPAÑOLES",6,4,10
" 07","NORTE","UMBRETE","TOTAL POBLACION",6,4,10
" 07","NORTE","UTRERA","ESPAÑOLES",6,11,17
" 07","NORTE","UTRERA","EXTRANJEROS",1,2,3
" 07","NORTE","UTRERA","TOTAL POBLACION",7,13,20
" 07","NORTE","VALENCINA DE LA CONCEPCION","ESPAÑOLES",8,3,11
" 07","NORTE","VALENCINA DE LA CONCEPCION","TOTAL POBLACION",8,3,11
" 07","NORTE","VILLAMANRIQUE DE LA CONDESA","ESPAÑOLES",1,0,1
" 07","NORTE","VILLAMANRIQUE DE LA CONDESA","TOTAL POBLACION",1,0,1
" 07","NORTE","VILLANUEVA DEL ARISCAL","ESPAÑOLES",6,12,18
" 07","NORTE","VILLANUEVA DEL ARISCAL","EXTRANJEROS",2,2,4
" 07","NORTE","VILLANUEVA DEL ARISCAL","TOTAL POBLACION",8,14,22
" 07","NORTE","VILLANUEVA DEL RIO Y MINAS","ESPAÑOLES",1,0,1
" 07","NORTE","VILLANUEVA DEL RIO Y MINAS","TOTAL POBLACION",1,0,1
" 07","NORTE","VILLAVERDE DEL RIO","ESPAÑOLES",3,5,8
" 07","NORTE","VILLAVERDE DEL RIO","TOTAL POBLACION",3,5,8
" 07","NORTE","VISO DEL ALCOR (EL)","ESPAÑOLES",5,0,5
" 07","NORTE","VISO DEL ALCOR (EL)","EXTRANJEROS",0,1,1
" 07","NORTE","VISO DEL ALCOR (EL)","TOTAL POBLACION",5,1,6
" 08","S. PABLO-STA. JUSTA","- FUERA DE LA PROVINCIA DE SEVILLA","ESPAÑOLES",298,306,604
" 08","S. PABLO-STA. JUSTA","- FUERA DE LA PROVINCIA DE SEVILLA","EXTRANJEROS",54,47,101
" 08","S. PABLO-STA. JUSTA","- FUERA DE LA PROVINCIA DE SEVILLA","TOTAL POBLACION",352,353,705
" 08","S. PABLO-STA. JUSTA","- PROVINCIA DE SEVILLA","ESPAÑOLES",262,273,535
" 08","S. PABLO-STA. JUSTA","- PROVINCIA DE SEVILLA","EXTRANJEROS",10,15,25
" 08","S. PABLO-STA. JUSTA","- PROVINCIA DE SEVILLA","TOTAL POBLACION",272,288,560
" 08","S. PABLO-STA. JUSTA","ALANIS","ESPAÑOLES",2,0,2
" 08","S. PABLO-STA. JUSTA","ALANIS","TOTAL POBLACION",2,0,2
" 08","S. PABLO-STA. JUSTA","ALCALA DE GUADAIRA","ESPAÑOLES",15,15,30
" 08","S. PABLO-STA. JUSTA","ALCALA DE GUADAIRA","EXTRANJEROS",0,2,2
" 08","S. PABLO-STA. JUSTA","ALCALA DE GUADAIRA","TOTAL POBLACION",15,17,32
" 08","S. PABLO-STA. JUSTA","ALCALA DEL RIO","ESPAÑOLES",14,10,24
" 08","S. PABLO-STA. JUSTA","ALCALA DEL RIO","TOTAL POBLACION",14,10,24
" 08","S. PABLO-STA. JUSTA","ALGABA (LA)","ESPAÑOLES",10,6,16
" 08","S. PABLO-STA. JUSTA","ALGABA (LA)","EXTRANJEROS",1,0,1
" 08","S. PABLO-STA. JUSTA","ALGABA (LA)","TOTAL POBLACION",11,6,17
" 08","S. PABLO-STA. JUSTA","ALMADEN DE LA PLATA","ESPAÑOLES",2,5,7
" 08","S. PABLO-STA. JUSTA","ALMADEN DE LA PLATA","TOTAL POBLACION",2,5,7
" 08","S. PABLO-STA. JUSTA","ARAHAL (EL)","ESPAÑOLES",0,2,2
" 08","S. PABLO-STA. JUSTA","ARAHAL (EL)","TOTAL POBLACION",0,2,2
" 08","S. PABLO-STA. JUSTA","AZNALCAZAR","ESPAÑOLES",0,4,4
" 08","S. PABLO-STA. JUSTA","AZNALCAZAR","TOTAL POBLACION",0,4,4
" 08","S. PABLO-STA. JUSTA","AZNALCOLLAR","ESPAÑOLES",2,1,3
" 08","S. PABLO-STA. JUSTA","AZNALCOLLAR","TOTAL POBLACION",2,1,3
" 08","S. PABLO-STA. JUSTA","BENACAZON","ESPAÑOLES",1,1,2
" 08","S. PABLO-STA. JUSTA","BENACAZON","TOTAL POBLACION",1,1,2
" 08","S. PABLO-STA. JUSTA","BOLLULLOS DE LA MITACION","ESPAÑOLES",2,2,4
" 08","S. PABLO-STA. JUSTA","BOLLULLOS DE LA MITACION","EXTRANJEROS",1,0,1
" 08","S. PABLO-STA. JUSTA","BOLLULLOS DE LA MITACION","TOTAL POBLACION",3,2,5
" 08","S. PABLO-STA. JUSTA","BORMUJOS","ESPAÑOLES",10,5,15
" 08","S. PABLO-STA. JUSTA","BORMUJOS","EXTRANJEROS",0,1,1
" 08","S. PABLO-STA. JUSTA","BORMUJOS","TOTAL POBLACION",10,6,16
" 08","S. PABLO-STA. JUSTA","BRENES","ESPAÑOLES",0,2,2
" 08","S. PABLO-STA. JUSTA","BRENES","TOTAL POBLACION",0,2,2
" 08","S. PABLO-STA. JUSTA","BURGUILLOS","ESPAÑOLES",1,2,3
" 08","S. PABLO-STA. JUSTA","BURGUILLOS","TOTAL POBLACION",1,2,3
" 08","S. PABLO-STA. JUSTA","CAMAS","ESPAÑOLES",12,14,26
" 08","S. PABLO-STA. JUSTA","CAMAS","EXTRANJEROS",1,1,2
" 08","S. PABLO-STA. JUSTA","CAMAS","TOTAL POBLACION",13,15,28
" 08","S. PABLO-STA. JUSTA","CAMPANA (LA)","ESPAÑOLES",1,2,3
" 08","S. PABLO-STA. JUSTA","CAMPANA (LA)","TOTAL POBLACION",1,2,3
" 08","S. PABLO-STA. JUSTA","CANTILLANA","ESPAÑOLES",6,3,9
" 08","S. PABLO-STA. JUSTA","CANTILLANA","TOTAL POBLACION",6,3,9
" 08","S. PABLO-STA. JUSTA","CARMONA","ESPAÑOLES",16,18,34
" 08","S. PABLO-STA. JUSTA","CARMONA","EXTRANJEROS",0,2,2
" 08","S. PABLO-STA. JUSTA","CARMONA","TOTAL POBLACION",16,20,36
" 08","S. PABLO-STA. JUSTA","CARRION DE LOS CESPEDES","ESPAÑOLES",1,0,1
" 08","S. PABLO-STA. JUSTA","CARRION DE LOS CESPEDES","TOTAL POBLACION",1,0,1
" 08","S. PABLO-STA. JUSTA","CASTILBLANCO DE LOS ARROYOS","ESPAÑOLES",5,10,15
" 08","S. PABLO-STA. JUSTA","CASTILBLANCO DE LOS ARROYOS","TOTAL POBLACION",5,10,15
" 08","S. PABLO-STA. JUSTA","CASTILLEJA DE GUZMAN","ESPAÑOLES",0,1,1
" 08","S. PABLO-STA. JUSTA","CASTILLEJA DE GUZMAN","TOTAL POBLACION",0,1,1
" 08","S. PABLO-STA. JUSTA","CASTILLEJA DE LA CUESTA","ESPAÑOLES",9,7,16
" 08","S. PABLO-STA. JUSTA","CASTILLEJA DE LA CUESTA","TOTAL POBLACION",9,7,16
" 08","S. PABLO-STA. JUSTA","CASTILLO DE LAS GUARDAS (EL)","ESPAÑOLES",1,0,1
" 08","S. PABLO-STA. JUSTA","CASTILLO DE LAS GUARDAS (EL)","EXTRANJEROS",1,1,2
" 08","S. PABLO-STA. JUSTA","CASTILLO DE LAS GUARDAS (EL)","TOTAL POBLACION",2,1,3
" 08","S. PABLO-STA. JUSTA","CAZALLA DE LA SIERRA","ESPAÑOLES",2,2,4
" 08","S. PABLO-STA. JUSTA","CAZALLA DE LA SIERRA","TOTAL POBLACION",2,2,4
" 08","S. PABLO-STA. JUSTA","CORIA DEL RIO","ESPAÑOLES",7,4,11
" 08","S. PABLO-STA. JUSTA","CORIA DEL RIO","TOTAL POBLACION",7,4,11
" 08","S. PABLO-STA. JUSTA","CORONIL (EL)","ESPAÑOLES",1,0,1
" 08","S. PABLO-STA. JUSTA","CORONIL (EL)","TOTAL POBLACION",1,0,1
" 08","S. PABLO-STA. JUSTA","CORRALES (LOS)","ESPAÑOLES",1,2,3
" 08","S. PABLO-STA. JUSTA","CORRALES (LOS)","TOTAL POBLACION",1,2,3
" 08","S. PABLO-STA. JUSTA","DOS HERMANAS","ESPAÑOLES",23,26,49
" 08","S. PABLO-STA. JUSTA","DOS HERMANAS","EXTRANJEROS",1,2,3
" 08","S. PABLO-STA. JUSTA","DOS HERMANAS","TOTAL POBLACION",24,28,52
" 08","S. PABLO-STA. JUSTA","ECIJA","ESPAÑOLES",1,1,2
" 08","S. PABLO-STA. JUSTA","ECIJA","EXTRANJEROS",0,1,1
" 08","S. PABLO-STA. JUSTA","ECIJA","TOTAL POBLACION",1,2,3
" 08","S. PABLO-STA. JUSTA","ESPARTINAS","ESPAÑOLES",1,8,9
" 08","S. PABLO-STA. JUSTA","ESPARTINAS","TOTAL POBLACION",1,8,9
" 08","S. PABLO-STA. JUSTA","ESTEPA","ESPAÑOLES",3,2,5
" 08","S. PABLO-STA. JUSTA","ESTEPA","TOTAL POBLACION",3,2,5
" 08","S. PABLO-STA. JUSTA","FUENTES DE ANDALUCIA","ESPAÑOLES",1,0,1
" 08","S. PABLO-STA. JUSTA","FUENTES DE ANDALUCIA","TOTAL POBLACION",1,0,1
" 08","S. PABLO-STA. JUSTA","GARROBO (EL)","EXTRANJEROS",0,1,1
" 08","S. PABLO-STA. JUSTA","GARROBO (EL)","TOTAL POBLACION",0,1,1
" 08","S. PABLO-STA. JUSTA","GELVES","ESPAÑOLES",3,1,4
" 08","S. PABLO-STA. JUSTA","GELVES","TOTAL POBLACION",3,1,4
" 08","S. PABLO-STA. JUSTA","GERENA","ESPAÑOLES",3,4,7
" 08","S. PABLO-STA. JUSTA","GERENA","TOTAL POBLACION",3,4,7
" 08","S. PABLO-STA. JUSTA","GINES","ESPAÑOLES",0,3,3
" 08","S. PABLO-STA. JUSTA","GINES","TOTAL POBLACION",0,3,3
" 08","S. PABLO-STA. JUSTA","GUADALCANAL","ESPAÑOLES",1,1,2
" 08","S. PABLO-STA. JUSTA","GUADALCANAL","TOTAL POBLACION",1,1,2
" 08","S. PABLO-STA. JUSTA","GUILLENA","ESPAÑOLES",6,8,14
" 08","S. PABLO-STA. JUSTA","GUILLENA","EXTRANJEROS",1,0,1
" 08","S. PABLO-STA. JUSTA","GUILLENA","TOTAL POBLACION",7,8,15
" 08","S. PABLO-STA. JUSTA","HUEVAR DEL ALJARAFE","ESPAÑOLES",0,1,1
" 08","S. PABLO-STA. JUSTA","HUEVAR DEL ALJARAFE","TOTAL POBLACION",0,1,1
" 08","S. PABLO-STA. JUSTA","ISLA MAYOR","ESPAÑOLES",1,1,2
" 08","S. PABLO-STA. JUSTA","ISLA MAYOR","EXTRANJEROS",0,1,1
" 08","S. PABLO-STA. JUSTA","ISLA MAYOR","TOTAL POBLACION",1,2,3
" 08","S. PABLO-STA. JUSTA","LEBRIJA","ESPAÑOLES",4,4,8
" 08","S. PABLO-STA. JUSTA","LEBRIJA","TOTAL POBLACION",4,4,8
" 08","S. PABLO-STA. JUSTA","LORA DEL RIO","ESPAÑOLES",4,5,9
" 08","S. PABLO-STA. JUSTA","LORA DEL RIO","TOTAL POBLACION",4,5,9
" 08","S. PABLO-STA. JUSTA","MAIRENA DEL ALCOR","ESPAÑOLES",7,4,11
" 08","S. PABLO-STA. JUSTA","MAIRENA DEL ALCOR","EXTRANJEROS",0,2,2
" 08","S. PABLO-STA. JUSTA","MAIRENA DEL ALCOR","TOTAL POBLACION",7,6,13
" 08","S. PABLO-STA. JUSTA","MAIRENA DEL ALJARAFE","ESPAÑOLES",10,14,24
" 08","S. PABLO-STA. JUSTA","MAIRENA DEL ALJARAFE","EXTRANJEROS",1,0,1
" 08","S. PABLO-STA. JUSTA","MAIRENA DEL ALJARAFE","TOTAL POBLACION",11,14,25
" 08","S. PABLO-STA. JUSTA","MARCHENA","ESPAÑOLES",0,1,1
" 08","S. PABLO-STA. JUSTA","MARCHENA","TOTAL POBLACION",0,1,1
" 08","S. PABLO-STA. JUSTA","MOLARES (LOS)","EXTRANJEROS",1,1,2
" 08","S. PABLO-STA. JUSTA","MOLARES (LOS)","TOTAL POBLACION",1,1,2
" 08","S. PABLO-STA. JUSTA","MONTELLANO","ESPAÑOLES",2,3,5
" 08","S. PABLO-STA. JUSTA","MONTELLANO","TOTAL POBLACION",2,3,5
" 08","S. PABLO-STA. JUSTA","MORON DE LA FRONTERA","ESPAÑOLES",0,2,2
" 08","S. PABLO-STA. JUSTA","MORON DE LA FRONTERA","TOTAL POBLACION",0,2,2
" 08","S. PABLO-STA. JUSTA","NAVAS DE LA CONCEPCION (LAS)","ESPAÑOLES",2,1,3
" 08","S. PABLO-STA. JUSTA","NAVAS DE LA CONCEPCION (LAS)","TOTAL POBLACION",2,1,3
" 08","S. PABLO-STA. JUSTA","OLIVARES","ESPAÑOLES",5,1,6
" 08","S. PABLO-STA. JUSTA","OLIVARES","TOTAL POBLACION",5,1,6
" 08","S. PABLO-STA. JUSTA","PALACIOS Y VILLAFRANCA (LOS)","ESPAÑOLES",5,3,8
" 08","S. PABLO-STA. JUSTA","PALACIOS Y VILLAFRANCA (LOS)","TOTAL POBLACION",5,3,8
" 08","S. PABLO-STA. JUSTA","PALOMARES DEL RIO","ESPAÑOLES",2,4,6
" 08","S. PABLO-STA. JUSTA","PALOMARES DEL RIO","TOTAL POBLACION",2,4,6
" 08","S. PABLO-STA. JUSTA","PEDROSO (EL)","ESPAÑOLES",3,1,4
" 08","S. PABLO-STA. JUSTA","PEDROSO (EL)","TOTAL POBLACION",3,1,4
" 08","S. PABLO-STA. JUSTA","PEÑAFLOR","ESPAÑOLES",1,0,1
" 08","S. PABLO-STA. JUSTA","PEÑAFLOR","TOTAL POBLACION",1,0,1
" 08","S. PABLO-STA. JUSTA","PILAS","ESPAÑOLES",0,2,2
" 08","S. PABLO-STA. JUSTA","PILAS","TOTAL POBLACION",0,2,2
" 08","S. PABLO-STA. JUSTA","PUEBLA DE LOS INFANTES (LA)","ESPAÑOLES",1,1,2
" 08","S. PABLO-STA. JUSTA","PUEBLA DE LOS INFANTES (LA)","TOTAL POBLACION",1,1,2
" 08","S. PABLO-STA. JUSTA","PUEBLA DEL RIO (LA)","ESPAÑOLES",1,0,1
" 08","S. PABLO-STA. JUSTA","PUEBLA DEL RIO (LA)","TOTAL POBLACION",1,0,1
" 08","S. PABLO-STA. JUSTA","REAL DE LA JARA (EL)","ESPAÑOLES",0,1,1
" 08","S. PABLO-STA. JUSTA","REAL DE LA JARA (EL)","TOTAL POBLACION",0,1,1
" 08","S. PABLO-STA. JUSTA","RINCONADA (LA)","ESPAÑOLES",16,18,34
" 08","S. PABLO-STA. JUSTA","RINCONADA (LA)","EXTRANJEROS",1,0,1
" 08","S. PABLO-STA. JUSTA","RINCONADA (LA)","TOTAL POBLACION",17,18,35
" 08","S. PABLO-STA. JUSTA","RONQUILLO (EL)","ESPAÑOLES",2,3,5
" 08","S. PABLO-STA. JUSTA","RONQUILLO (EL)","TOTAL POBLACION",2,3,5
" 08","S. PABLO-STA. JUSTA","SALTERAS","ESPAÑOLES",0,1,1
" 08","S. PABLO-STA. JUSTA","SALTERAS","TOTAL POBLACION",0,1,1
" 08","S. PABLO-STA. JUSTA","SAN JUAN DE AZNALFARACHE","ESPAÑOLES",6,5,11
" 08","S. PABLO-STA. JUSTA","SAN JUAN DE AZNALFARACHE","EXTRANJEROS",1,0,1
" 08","S. PABLO-STA. JUSTA","SAN JUAN DE AZNALFARACHE","TOTAL POBLACION",7,5,12
" 08","S. PABLO-STA. JUSTA","SANLUCAR LA MAYOR","ESPAÑOLES",0,2,2
" 08","S. PABLO-STA. JUSTA","SANLUCAR LA MAYOR","TOTAL POBLACION",0,2,2
" 08","S. PABLO-STA. JUSTA","SANTIPONCE","ESPAÑOLES",2,1,3
" 08","S. PABLO-STA. JUSTA","SANTIPONCE","TOTAL POBLACION",2,1,3
" 08","S. PABLO-STA. JUSTA","TOCINA","ESPAÑOLES",2,0,2
" 08","S. PABLO-STA. JUSTA","TOCINA","TOTAL POBLACION",2,0,2
" 08","S. PABLO-STA. JUSTA","TOMARES","ESPAÑOLES",6,3,9
" 08","S. PABLO-STA. JUSTA","TOMARES","TOTAL POBLACION",6,3,9
" 08","S. PABLO-STA. JUSTA","UMBRETE","ESPAÑOLES",4,4,8
" 08","S. PABLO-STA. JUSTA","UMBRETE","TOTAL POBLACION",4,4,8
" 08","S. PABLO-STA. JUSTA","UTRERA","ESPAÑOLES",3,3,6
" 08","S. PABLO-STA. JUSTA","UTRERA","TOTAL POBLACION",3,3,6
" 08","S. PABLO-STA. JUSTA","VALENCINA DE LA CONCEPCION","ESPAÑOLES",5,1,6
" 08","S. PABLO-STA. JUSTA","VALENCINA DE LA CONCEPCION","TOTAL POBLACION",5,1,6
" 08","S. PABLO-STA. JUSTA","VILLANUEVA DE SAN JUAN","ESPAÑOLES",0,1,1
" 08","S. PABLO-STA. JUSTA","VILLANUEVA DE SAN JUAN","TOTAL POBLACION",0,1,1
" 08","S. PABLO-STA. JUSTA","VILLANUEVA DEL ARISCAL","ESPAÑOLES",0,2,2
" 08","S. PABLO-STA. JUSTA","VILLANUEVA DEL ARISCAL","TOTAL POBLACION",0,2,2
" 08","S. PABLO-STA. JUSTA","VILLANUEVA DEL RIO Y MINAS","ESPAÑOLES",2,2,4
" 08","S. PABLO-STA. JUSTA","VILLANUEVA DEL RIO Y MINAS","TOTAL POBLACION",2,2,4
" 08","S. PABLO-STA. JUSTA","VILLAVERDE DEL RIO","ESPAÑOLES",1,2,3
" 08","S. PABLO-STA. JUSTA","VILLAVERDE DEL RIO","TOTAL POBLACION",1,2,3
" 08","S. PABLO-STA. JUSTA","VISO DEL ALCOR (EL)","ESPAÑOLES",2,4,6
" 08","S. PABLO-STA. JUSTA","VISO DEL ALCOR (EL)","TOTAL POBLACION",2,4,6
" 09","ESTE","- FUERA DE LA PROVINCIA DE SEVILLA","ESPAÑOLES",457,466,923
" 09","ESTE","- FUERA DE LA PROVINCIA DE SEVILLA","EXTRANJEROS",97,87,184
" 09","ESTE","- FUERA DE LA PROVINCIA DE SEVILLA","TOTAL POBLACION",554,553,1107
" 09","ESTE","- PROVINCIA DE SEVILLA","ESPAÑOLES",496,499,995
" 09","ESTE","- PROVINCIA DE SEVILLA","EXTRANJEROS",39,51,90
" 09","ESTE","- PROVINCIA DE SEVILLA","TOTAL POBLACION",535,550,1085
" 09","ESTE","ALANIS","ESPAÑOLES",0,1,1
" 09","ESTE","ALANIS","TOTAL POBLACION",0,1,1
" 09","ESTE","ALBAIDA DEL ALJARAFE","ESPAÑOLES",2,0,2
" 09","ESTE","ALBAIDA DEL ALJARAFE","TOTAL POBLACION",2,0,2
" 09","ESTE","ALCALA DE GUADAIRA","ESPAÑOLES",80,81,161
" 09","ESTE","ALCALA DE GUADAIRA","EXTRANJEROS",6,4,10
" 09","ESTE","ALCALA DE GUADAIRA","TOTAL POBLACION",86,85,171
" 09","ESTE","ALCALA DEL RIO","ESPAÑOLES",13,14,27
" 09","ESTE","ALCALA DEL RIO","TOTAL POBLACION",13,14,27
" 09","ESTE","ALCOLEA DEL RIO","ESPAÑOLES",0,1,1
" 09","ESTE","ALCOLEA DEL RIO","TOTAL POBLACION",0,1,1
" 09","ESTE","ALGABA (LA)","ESPAÑOLES",5,7,12
" 09","ESTE","ALGABA (LA)","TOTAL POBLACION",5,7,12
" 09","ESTE","ALGAMITAS","ESPAÑOLES",0,2,2
" 09","ESTE","ALGAMITAS","TOTAL POBLACION",0,2,2
" 09","ESTE","ALMENSILLA","ESPAÑOLES",6,3,9
" 09","ESTE","ALMENSILLA","TOTAL POBLACION",6,3,9
" 09","ESTE","ARAHAL (EL)","ESPAÑOLES",2,0,2
" 09","ESTE","ARAHAL (EL)","EXTRANJEROS",1,1,2
" 09","ESTE","ARAHAL (EL)","TOTAL POBLACION",3,1,4
" 09","ESTE","AZNALCAZAR","ESPAÑOLES",1,1,2
" 09","ESTE","AZNALCAZAR","TOTAL POBLACION",1,1,2
" 09","ESTE","BENACAZON","ESPAÑOLES",5,5,10
" 09","ESTE","BENACAZON","EXTRANJEROS",0,1,1
" 09","ESTE","BENACAZON","TOTAL POBLACION",5,6,11
" 09","ESTE","BOLLULLOS DE LA MITACION","ESPAÑOLES",3,1,4
" 09","ESTE","BOLLULLOS DE LA MITACION","EXTRANJEROS",0,1,1
" 09","ESTE","BOLLULLOS DE LA MITACION","TOTAL POBLACION",3,2,5
" 09","ESTE","BORMUJOS","ESPAÑOLES",15,9,24
" 09","ESTE","BORMUJOS","EXTRANJEROS",1,1,2
" 09","ESTE","BORMUJOS","TOTAL POBLACION",16,10,26
" 09","ESTE","BRENES","ESPAÑOLES",10,5,15
" 09","ESTE","BRENES","EXTRANJEROS",4,7,11
" 09","ESTE","BRENES","TOTAL POBLACION",14,12,26
" 09","ESTE","BURGUILLOS","ESPAÑOLES",2,0,2
" 09","ESTE","BURGUILLOS","TOTAL POBLACION",2,0,2
" 09","ESTE","CAMAS","ESPAÑOLES",12,12,24
" 09","ESTE","CAMAS","EXTRANJEROS",4,4,8
" 09","ESTE","CAMAS","TOTAL POBLACION",16,16,32
" 09","ESTE","CAMPANA (LA)","ESPAÑOLES",3,0,3
" 09","ESTE","CAMPANA (LA)","TOTAL POBLACION",3,0,3
" 09","ESTE","CANTILLANA","ESPAÑOLES",3,3,6
" 09","ESTE","CANTILLANA","EXTRANJEROS",0,1,1
" 09","ESTE","CANTILLANA","TOTAL POBLACION",3,4,7
" 09","ESTE","CARMONA","ESPAÑOLES",24,24,48
" 09","ESTE","CARMONA","TOTAL POBLACION",24,24,48
" 09","ESTE","CARRION DE LOS CESPEDES","ESPAÑOLES",2,1,3
" 09","ESTE","CARRION DE LOS CESPEDES","TOTAL POBLACION",2,1,3
" 09","ESTE","CASTILBLANCO DE LOS ARROYOS","ESPAÑOLES",5,5,10
" 09","ESTE","CASTILBLANCO DE LOS ARROYOS","EXTRANJEROS",0,1,1
" 09","ESTE","CASTILBLANCO DE LOS ARROYOS","TOTAL POBLACION",5,6,11
" 09","ESTE","CASTILLEJA DE GUZMAN","ESPAÑOLES",2,0,2
" 09","ESTE","CASTILLEJA DE GUZMAN","TOTAL POBLACION",2,0,2
" 09","ESTE","CASTILLEJA DE LA CUESTA","ESPAÑOLES",5,9,14
" 09","ESTE","CASTILLEJA DE LA CUESTA","TOTAL POBLACION",5,9,14
" 09","ESTE","CAZALLA DE LA SIERRA","ESPAÑOLES",2,1,3
" 09","ESTE","CAZALLA DE LA SIERRA","TOTAL POBLACION",2,1,3
" 09","ESTE","CONSTANTINA","ESPAÑOLES",0,1,1
" 09","ESTE","CONSTANTINA","TOTAL POBLACION",0,1,1
" 09","ESTE","CORIA DEL RIO","ESPAÑOLES",10,8,18
" 09","ESTE","CORIA DEL RIO","TOTAL POBLACION",10,8,18
" 09","ESTE","CORIPE","ESPAÑOLES",1,1,2
" 09","ESTE","CORIPE","TOTAL POBLACION",1,1,2
" 09","ESTE","CORONIL (EL)","ESPAÑOLES",1,0,1
" 09","ESTE","CORONIL (EL)","EXTRANJEROS",0,1,1
" 09","ESTE","CORONIL (EL)","TOTAL POBLACION",1,1,2
" 09","ESTE","DOS HERMANAS","ESPAÑOLES",80,78,158
" 09","ESTE","DOS HERMANAS","EXTRANJEROS",5,6,11
" 09","ESTE","DOS HERMANAS","TOTAL POBLACION",85,84,169
" 09","ESTE","ECIJA","ESPAÑOLES",5,2,7
" 09","ESTE","ECIJA","TOTAL POBLACION",5,2,7
" 09","ESTE","ESPARTINAS","ESPAÑOLES",4,6,10
" 09","ESTE","ESPARTINAS","EXTRANJEROS",1,1,2
" 09","ESTE","ESPARTINAS","TOTAL POBLACION",5,7,12
" 09","ESTE","ESTEPA","ESPAÑOLES",1,1,2
" 09","ESTE","ESTEPA","TOTAL POBLACION",1,1,2
" 09","ESTE","FUENTES DE ANDALUCIA","ESPAÑOLES",0,1,1
" 09","ESTE","FUENTES DE ANDALUCIA","TOTAL POBLACION",0,1,1
" 09","ESTE","GARROBO (EL)","EXTRANJEROS",1,2,3
" 09","ESTE","GARROBO (EL)","TOTAL POBLACION",1,2,3
" 09","ESTE","GELVES","ESPAÑOLES",7,7,14
" 09","ESTE","GELVES","TOTAL POBLACION",7,7,14
" 09","ESTE","GERENA","ESPAÑOLES",3,0,3
" 09","ESTE","GERENA","TOTAL POBLACION",3,0,3
" 09","ESTE","GILENA","ESPAÑOLES",2,2,4
" 09","ESTE","GILENA","TOTAL POBLACION",2,2,4
" 09","ESTE","GINES","ESPAÑOLES",3,8,11
" 09","ESTE","GINES","TOTAL POBLACION",3,8,11
" 09","ESTE","GUADALCANAL","ESPAÑOLES",3,1,4
" 09","ESTE","GUADALCANAL","TOTAL POBLACION",3,1,4
" 09","ESTE","GUILLENA","ESPAÑOLES",1,5,6
" 09","ESTE","GUILLENA","EXTRANJEROS",0,1,1
" 09","ESTE","GUILLENA","TOTAL POBLACION",1,6,7
" 09","ESTE","HERRERA","ESPAÑOLES",1,0,1
" 09","ESTE","HERRERA","TOTAL POBLACION",1,0,1
" 09","ESTE","HUEVAR DEL ALJARAFE","ESPAÑOLES",9,5,14
" 09","ESTE","HUEVAR DEL ALJARAFE","EXTRANJEROS",0,1,1
" 09","ESTE","HUEVAR DEL ALJARAFE","TOTAL POBLACION",9,6,15
" 09","ESTE","ISLA MAYOR","ESPAÑOLES",0,1,1
" 09","ESTE","ISLA MAYOR","TOTAL POBLACION",0,1,1
" 09","ESTE","LANTEJUELA (LA)","ESPAÑOLES",1,1,2
" 09","ESTE","LANTEJUELA (LA)","TOTAL POBLACION",1,1,2
" 09","ESTE","LEBRIJA","ESPAÑOLES",1,2,3
" 09","ESTE","LEBRIJA","TOTAL POBLACION",1,2,3
" 09","ESTE","LORA DEL RIO","ESPAÑOLES",3,5,8
" 09","ESTE","LORA DEL RIO","EXTRANJEROS",0,1,1
" 09","ESTE","LORA DEL RIO","TOTAL POBLACION",3,6,9
" 09","ESTE","MAIRENA DEL ALCOR","ESPAÑOLES",29,30,59
" 09","ESTE","MAIRENA DEL ALCOR","EXTRANJEROS",1,1,2
" 09","ESTE","MAIRENA DEL ALCOR","TOTAL POBLACION",30,31,61
" 09","ESTE","MAIRENA DEL ALJARAFE","ESPAÑOLES",25,21,46
" 09","ESTE","MAIRENA DEL ALJARAFE","EXTRANJEROS",4,4,8
" 09","ESTE","MAIRENA DEL ALJARAFE","TOTAL POBLACION",29,25,54
" 09","ESTE","MONTELLANO","ESPAÑOLES",0,1,1
" 09","ESTE","MONTELLANO","TOTAL POBLACION",0,1,1
" 09","ESTE","MORON DE LA FRONTERA","ESPAÑOLES",2,4,6
" 09","ESTE","MORON DE LA FRONTERA","TOTAL POBLACION",2,4,6
" 09","ESTE","NAVAS DE LA CONCEPCION (LAS)","ESPAÑOLES",1,0,1
" 09","ESTE","NAVAS DE LA CONCEPCION (LAS)","TOTAL POBLACION",1,0,1
" 09","ESTE","OLIVARES","ESPAÑOLES",4,6,10
" 09","ESTE","OLIVARES","TOTAL POBLACION",4,6,10
" 09","ESTE","OSUNA","ESPAÑOLES",1,2,3
" 09","ESTE","OSUNA","EXTRANJEROS",1,0,1
" 09","ESTE","OSUNA","TOTAL POBLACION",2,2,4
" 09","ESTE","PALACIOS Y VILLAFRANCA (LOS)","ESPAÑOLES",2,7,9
" 09","ESTE","PALACIOS Y VILLAFRANCA (LOS)","EXTRANJEROS",0,1,1
" 09","ESTE","PALACIOS Y VILLAFRANCA (LOS)","TOTAL POBLACION",2,8,10
" 09","ESTE","PALOMARES DEL RIO","ESPAÑOLES",3,5,8
" 09","ESTE","PALOMARES DEL RIO","EXTRANJEROS",2,6,8
" 09","ESTE","PALOMARES DEL RIO","TOTAL POBLACION",5,11,16
" 09","ESTE","PARADAS","ESPAÑOLES",1,2,3
" 09","ESTE","PARADAS","TOTAL POBLACION",1,2,3
" 09","ESTE","PEDROSO (EL)","ESPAÑOLES",2,2,4
" 09","ESTE","PEDROSO (EL)","TOTAL POBLACION",2,2,4
" 09","ESTE","PEÑAFLOR","ESPAÑOLES",1,2,3
" 09","ESTE","PEÑAFLOR","TOTAL POBLACION",1,2,3
" 09","ESTE","PILAS","ESPAÑOLES",2,1,3
" 09","ESTE","PILAS","TOTAL POBLACION",2,1,3
" 09","ESTE","PUEBLA DEL RIO (LA)","ESPAÑOLES",2,1,3
" 09","ESTE","PUEBLA DEL RIO (LA)","EXTRANJEROS",1,0,1
" 09","ESTE","PUEBLA DEL RIO (LA)","TOTAL POBLACION",3,1,4
" 09","ESTE","RINCONADA (LA)","ESPAÑOLES",23,31,54
" 09","ESTE","RINCONADA (LA)","EXTRANJEROS",1,2,3
" 09","ESTE","RINCONADA (LA)","TOTAL POBLACION",24,33,57
" 09","ESTE","RONQUILLO (EL)","ESPAÑOLES",1,5,6
" 09","ESTE","RONQUILLO (EL)","TOTAL POBLACION",1,5,6
" 09","ESTE","SALTERAS","ESPAÑOLES",5,5,10
" 09","ESTE","SALTERAS","EXTRANJEROS",0,1,1
" 09","ESTE","SALTERAS","TOTAL POBLACION",5,6,11
" 09","ESTE","SAN JUAN DE AZNALFARACHE","ESPAÑOLES",21,15,36
" 09","ESTE","SAN JUAN DE AZNALFARACHE","TOTAL POBLACION",21,15,36
" 09","ESTE","SANLUCAR LA MAYOR","ESPAÑOLES",0,1,1
" 09","ESTE","SANLUCAR LA MAYOR","TOTAL POBLACION",0,1,1
" 09","ESTE","SANTIPONCE","ESPAÑOLES",7,5,12
" 09","ESTE","SANTIPONCE","EXTRANJEROS",0,1,1
" 09","ESTE","SANTIPONCE","TOTAL POBLACION",7,6,13
" 09","ESTE","TOCINA","ESPAÑOLES",1,3,4
" 09","ESTE","TOCINA","TOTAL POBLACION",1,3,4
" 09","ESTE","TOMARES","ESPAÑOLES",5,6,11
" 09","ESTE","TOMARES","TOTAL POBLACION",5,6,11
" 09","ESTE","UMBRETE","ESPAÑOLES",2,6,8
" 09","ESTE","UMBRETE","EXTRANJEROS",0,1,1
" 09","ESTE","UMBRETE","TOTAL POBLACION",2,7,9
" 09","ESTE","UTRERA","ESPAÑOLES",4,11,15
" 09","ESTE","UTRERA","EXTRANJEROS",3,0,3
" 09","ESTE","UTRERA","TOTAL POBLACION",7,11,18
" 09","ESTE","VALENCINA DE LA CONCEPCION","ESPAÑOLES",2,2,4
" 09","ESTE","VALENCINA DE LA CONCEPCION","EXTRANJEROS",1,0,1
" 09","ESTE","VALENCINA DE LA CONCEPCION","TOTAL POBLACION",3,2,5
" 09","ESTE","VILLANUEVA DEL ARISCAL","ESPAÑOLES",2,0,2
" 09","ESTE","VILLANUEVA DEL ARISCAL","EXTRANJEROS",1,0,1
" 09","ESTE","VILLANUEVA DEL ARISCAL","TOTAL POBLACION",3,0,3
" 09","ESTE","VILLANUEVA DEL RIO Y MINAS","ESPAÑOLES",2,1,3
" 09","ESTE","VILLANUEVA DEL RIO Y MINAS","TOTAL POBLACION",2,1,3
" 09","ESTE","VILLAVERDE DEL RIO","ESPAÑOLES",1,0,1
" 09","ESTE","VILLAVERDE DEL RIO","TOTAL POBLACION",1,0,1
" 09","ESTE","VISO DEL ALCOR (EL)","ESPAÑOLES",7,4,11
" 09","ESTE","VISO DEL ALCOR (EL)","EXTRANJEROS",1,0,1
" 09","ESTE","VISO DEL ALCOR (EL)","TOTAL POBLACION",8,4,12
" 10","BELLAVISTA-LA PALMERA","- FUERA DE LA PROVINCIA DE SEVILLA","ESPAÑOLES",301,255,556
" 10","BELLAVISTA-LA PALMERA","- FUERA DE LA PROVINCIA DE SEVILLA","EXTRANJEROS",40,47,87
" 10","BELLAVISTA-LA PALMERA","- FUERA DE LA PROVINCIA DE SEVILLA","TOTAL POBLACION",341,302,643
" 10","BELLAVISTA-LA PALMERA","- PROVINCIA DE SEVILLA","ESPAÑOLES",246,268,514
" 10","BELLAVISTA-LA PALMERA","- PROVINCIA DE SEVILLA","EXTRANJEROS",17,24,41
" 10","BELLAVISTA-LA PALMERA","- PROVINCIA DE SEVILLA","TOTAL POBLACION",263,292,555
" 10","BELLAVISTA-LA PALMERA","ALBAIDA DEL ALJARAFE","ESPAÑOLES",1,0,1
" 10","BELLAVISTA-LA PALMERA","ALBAIDA DEL ALJARAFE","TOTAL POBLACION",1,0,1
" 10","BELLAVISTA-LA PALMERA","ALCALA DE GUADAIRA","ESPAÑOLES",11,14,25
" 10","BELLAVISTA-LA PALMERA","ALCALA DE GUADAIRA","EXTRANJEROS",2,1,3
" 10","BELLAVISTA-LA PALMERA","ALCALA DE GUADAIRA","TOTAL POBLACION",13,15,28
" 10","BELLAVISTA-LA PALMERA","ALCALA DEL RIO","EXTRANJEROS",0,1,1
" 10","BELLAVISTA-LA PALMERA","ALCALA DEL RIO","TOTAL POBLACION",0,1,1
" 10","BELLAVISTA-LA PALMERA","ALCOLEA DEL RIO","ESPAÑOLES",1,1,2
" 10","BELLAVISTA-LA PALMERA","ALCOLEA DEL RIO","TOTAL POBLACION",1,1,2
" 10","BELLAVISTA-LA PALMERA","ALGABA (LA)","ESPAÑOLES",3,2,5
" 10","BELLAVISTA-LA PALMERA","ALGABA (LA)","TOTAL POBLACION",3,2,5
" 10","BELLAVISTA-LA PALMERA","ALMENSILLA","ESPAÑOLES",5,3,8
" 10","BELLAVISTA-LA PALMERA","ALMENSILLA","TOTAL POBLACION",5,3,8
" 10","BELLAVISTA-LA PALMERA","AZNALCAZAR","ESPAÑOLES",1,0,1
" 10","BELLAVISTA-LA PALMERA","AZNALCAZAR","TOTAL POBLACION",1,0,1
" 10","BELLAVISTA-LA PALMERA","AZNALCOLLAR","ESPAÑOLES",0,2,2
" 10","BELLAVISTA-LA PALMERA","AZNALCOLLAR","TOTAL POBLACION",0,2,2
" 10","BELLAVISTA-LA PALMERA","BENACAZON","ESPAÑOLES",1,0,1
" 10","BELLAVISTA-LA PALMERA","BENACAZON","TOTAL POBLACION",1,0,1
" 10","BELLAVISTA-LA PALMERA","BOLLULLOS DE LA MITACION","ESPAÑOLES",3,3,6
" 10","BELLAVISTA-LA PALMERA","BOLLULLOS DE LA MITACION","TOTAL POBLACION",3,3,6
" 10","BELLAVISTA-LA PALMERA","BORMUJOS","ESPAÑOLES",5,6,11
" 10","BELLAVISTA-LA PALMERA","BORMUJOS","TOTAL POBLACION",5,6,11
" 10","BELLAVISTA-LA PALMERA","BURGUILLOS","ESPAÑOLES",1,0,1
" 10","BELLAVISTA-LA PALMERA","BURGUILLOS","TOTAL POBLACION",1,0,1
" 10","BELLAVISTA-LA PALMERA","CAMAS","ESPAÑOLES",15,13,28
" 10","BELLAVISTA-LA PALMERA","CAMAS","TOTAL POBLACION",15,13,28
" 10","BELLAVISTA-LA PALMERA","CAMPANA (LA)","ESPAÑOLES",2,0,2
" 10","BELLAVISTA-LA PALMERA","CAMPANA (LA)","TOTAL POBLACION",2,0,2
" 10","BELLAVISTA-LA PALMERA","CARMONA","ESPAÑOLES",6,6,12
" 10","BELLAVISTA-LA PALMERA","CARMONA","TOTAL POBLACION",6,6,12
" 10","BELLAVISTA-LA PALMERA","CARRION DE LOS CESPEDES","ESPAÑOLES",2,0,2
" 10","BELLAVISTA-LA PALMERA","CARRION DE LOS CESPEDES","TOTAL POBLACION",2,0,2
" 10","BELLAVISTA-LA PALMERA","CASTILBLANCO DE LOS ARROYOS","ESPAÑOLES",1,0,1
" 10","BELLAVISTA-LA PALMERA","CASTILBLANCO DE LOS ARROYOS","TOTAL POBLACION",1,0,1
" 10","BELLAVISTA-LA PALMERA","CASTILLEJA DE GUZMAN","ESPAÑOLES",1,0,1
" 10","BELLAVISTA-LA PALMERA","CASTILLEJA DE GUZMAN","TOTAL POBLACION",1,0,1
" 10","BELLAVISTA-LA PALMERA","CASTILLEJA DE LA CUESTA","ESPAÑOLES",8,9,17
" 10","BELLAVISTA-LA PALMERA","CASTILLEJA DE LA CUESTA","TOTAL POBLACION",8,9,17
" 10","BELLAVISTA-LA PALMERA","CASTILLO DE LAS GUARDAS (EL)","ESPAÑOLES",3,3,6
" 10","BELLAVISTA-LA PALMERA","CASTILLO DE LAS GUARDAS (EL)","TOTAL POBLACION",3,3,6
" 10","BELLAVISTA-LA PALMERA","CONSTANTINA","ESPAÑOLES",1,0,1
" 10","BELLAVISTA-LA PALMERA","CONSTANTINA","TOTAL POBLACION",1,0,1
" 10","BELLAVISTA-LA PALMERA","CORIA DEL RIO","ESPAÑOLES",7,9,16
" 10","BELLAVISTA-LA PALMERA","CORIA DEL RIO","EXTRANJEROS",2,1,3
" 10","BELLAVISTA-LA PALMERA","CORIA DEL RIO","TOTAL POBLACION",9,10,19
" 10","BELLAVISTA-LA PALMERA","CORONIL (EL)","ESPAÑOLES",0,1,1
" 10","BELLAVISTA-LA PALMERA","CORONIL (EL)","TOTAL POBLACION",0,1,1
" 10","BELLAVISTA-LA PALMERA","CORRALES (LOS)","ESPAÑOLES",2,0,2
" 10","BELLAVISTA-LA PALMERA","CORRALES (LOS)","TOTAL POBLACION",2,0,2
" 10","BELLAVISTA-LA PALMERA","CUERVO DE SEVILLA (EL)","ESPAÑOLES",1,0,1
" 10","BELLAVISTA-LA PALMERA","CUERVO DE SEVILLA (EL)","TOTAL POBLACION",1,0,1
" 10","BELLAVISTA-LA PALMERA","DOS HERMANAS","ESPAÑOLES",84,91,175
" 10","BELLAVISTA-LA PALMERA","DOS HERMANAS","EXTRANJEROS",5,9,14
" 10","BELLAVISTA-LA PALMERA","DOS HERMANAS","TOTAL POBLACION",89,100,189
" 10","BELLAVISTA-LA PALMERA","ECIJA","ESPAÑOLES",2,0,2
" 10","BELLAVISTA-LA PALMERA","ECIJA","TOTAL POBLACION",2,0,2
" 10","BELLAVISTA-LA PALMERA","ESPARTINAS","ESPAÑOLES",3,5,8
" 10","BELLAVISTA-LA PALMERA","ESPARTINAS","TOTAL POBLACION",3,5,8
" 10","BELLAVISTA-LA PALMERA","ESTEPA","ESPAÑOLES",0,1,1
" 10","BELLAVISTA-LA PALMERA","ESTEPA","TOTAL POBLACION",0,1,1
" 10","BELLAVISTA-LA PALMERA","FUENTES DE ANDALUCIA","EXTRANJEROS",0,1,1
" 10","BELLAVISTA-LA PALMERA","FUENTES DE ANDALUCIA","TOTAL POBLACION",0,1,1
" 10","BELLAVISTA-LA PALMERA","GELVES","ESPAÑOLES",0,2,2
" 10","BELLAVISTA-LA PALMERA","GELVES","TOTAL POBLACION",0,2,2
" 10","BELLAVISTA-LA PALMERA","GINES","ESPAÑOLES",3,4,7
" 10","BELLAVISTA-LA PALMERA","GINES","TOTAL POBLACION",3,4,7
" 10","BELLAVISTA-LA PALMERA","GUILLENA","ESPAÑOLES",3,1,4
" 10","BELLAVISTA-LA PALMERA","GUILLENA","TOTAL POBLACION",3,1,4
" 10","BELLAVISTA-LA PALMERA","LEBRIJA","ESPAÑOLES",3,2,5
" 10","BELLAVISTA-LA PALMERA","LEBRIJA","EXTRANJEROS",1,0,1
" 10","BELLAVISTA-LA PALMERA","LEBRIJA","TOTAL POBLACION",4,2,6
" 10","BELLAVISTA-LA PALMERA","MAIRENA DEL ALCOR","ESPAÑOLES",2,4,6
" 10","BELLAVISTA-LA PALMERA","MAIRENA DEL ALCOR","EXTRANJEROS",0,1,1
" 10","BELLAVISTA-LA PALMERA","MAIRENA DEL ALCOR","TOTAL POBLACION",2,5,7
" 10","BELLAVISTA-LA PALMERA","MAIRENA DEL ALJARAFE","ESPAÑOLES",15,8,23
" 10","BELLAVISTA-LA PALMERA","MAIRENA DEL ALJARAFE","EXTRANJEROS",3,2,5
" 10","BELLAVISTA-LA PALMERA","MAIRENA DEL ALJARAFE","TOTAL POBLACION",18,10,28
" 10","BELLAVISTA-LA PALMERA","MORON DE LA FRONTERA","ESPAÑOLES",0,1,1
" 10","BELLAVISTA-LA PALMERA","MORON DE LA FRONTERA","EXTRANJEROS",0,1,1
" 10","BELLAVISTA-LA PALMERA","MORON DE LA FRONTERA","TOTAL POBLACION",0,2,2
" 10","BELLAVISTA-LA PALMERA","OLIVARES","ESPAÑOLES",4,4,8
" 10","BELLAVISTA-LA PALMERA","OLIVARES","TOTAL POBLACION",4,4,8
" 10","BELLAVISTA-LA PALMERA","OSUNA","ESPAÑOLES",2,5,7
" 10","BELLAVISTA-LA PALMERA","OSUNA","TOTAL POBLACION",2,5,7
" 10","BELLAVISTA-LA PALMERA","PALACIOS Y VILLAFRANCA (LOS)","ESPAÑOLES",5,5,10
" 10","BELLAVISTA-LA PALMERA","PALACIOS Y VILLAFRANCA (LOS)","EXTRANJEROS",1,1,2
" 10","BELLAVISTA-LA PALMERA","PALACIOS Y VILLAFRANCA (LOS)","TOTAL POBLACION",6,6,12
" 10","BELLAVISTA-LA PALMERA","PALOMARES DEL RIO","ESPAÑOLES",2,4,6
" 10","BELLAVISTA-LA PALMERA","PALOMARES DEL RIO","TOTAL POBLACION",2,4,6
" 10","BELLAVISTA-LA PALMERA","PILAS","ESPAÑOLES",3,2,5
" 10","BELLAVISTA-LA PALMERA","PILAS","TOTAL POBLACION",3,2,5
" 10","BELLAVISTA-LA PALMERA","PUEBLA DE CAZALLA (LA)","ESPAÑOLES",0,1,1
" 10","BELLAVISTA-LA PALMERA","PUEBLA DE CAZALLA (LA)","TOTAL POBLACION",0,1,1
" 10","BELLAVISTA-LA PALMERA","PUEBLA DE LOS INFANTES (LA)","ESPAÑOLES",0,1,1
" 10","BELLAVISTA-LA PALMERA","PUEBLA DE LOS INFANTES (LA)","TOTAL POBLACION",0,1,1
" 10","BELLAVISTA-LA PALMERA","PUEBLA DEL RIO (LA)","ESPAÑOLES",0,1,1
" 10","BELLAVISTA-LA PALMERA","PUEBLA DEL RIO (LA)","TOTAL POBLACION",0,1,1
" 10","BELLAVISTA-LA PALMERA","RINCONADA (LA)","ESPAÑOLES",5,5,10
" 10","BELLAVISTA-LA PALMERA","RINCONADA (LA)","EXTRANJEROS",1,1,2
" 10","BELLAVISTA-LA PALMERA","RINCONADA (LA)","TOTAL POBLACION",6,6,12
" 10","BELLAVISTA-LA PALMERA","RODA DE ANDALUCIA (LA)","EXTRANJEROS",0,1,1
" 10","BELLAVISTA-LA PALMERA","RODA DE ANDALUCIA (LA)","TOTAL POBLACION",0,1,1
" 10","BELLAVISTA-LA PALMERA","RONQUILLO (EL)","ESPAÑOLES",1,1,2
" 10","BELLAVISTA-LA PALMERA","RONQUILLO (EL)","TOTAL POBLACION",1,1,2
" 10","BELLAVISTA-LA PALMERA","SALTERAS","ESPAÑOLES",0,2,2
" 10","BELLAVISTA-LA PALMERA","SALTERAS","TOTAL POBLACION",0,2,2
" 10","BELLAVISTA-LA PALMERA","SAN JUAN DE AZNALFARACHE","ESPAÑOLES",5,12,17
" 10","BELLAVISTA-LA PALMERA","SAN JUAN DE AZNALFARACHE","EXTRANJEROS",0,2,2
" 10","BELLAVISTA-LA PALMERA","SAN JUAN DE AZNALFARACHE","TOTAL POBLACION",5,14,19
" 10","BELLAVISTA-LA PALMERA","SANLUCAR LA MAYOR","ESPAÑOLES",2,8,10
" 10","BELLAVISTA-LA PALMERA","SANLUCAR LA MAYOR","EXTRANJEROS",0,1,1
" 10","BELLAVISTA-LA PALMERA","SANLUCAR LA MAYOR","TOTAL POBLACION",2,9,11
" 10","BELLAVISTA-LA PALMERA","SANTIPONCE","ESPAÑOLES",0,1,1
" 10","BELLAVISTA-LA PALMERA","SANTIPONCE","TOTAL POBLACION",0,1,1
" 10","BELLAVISTA-LA PALMERA","TOCINA","EXTRANJEROS",0,1,1
" 10","BELLAVISTA-LA PALMERA","TOCINA","TOTAL POBLACION",0,1,1
" 10","BELLAVISTA-LA PALMERA","TOMARES","ESPAÑOLES",8,6,14
" 10","BELLAVISTA-LA PALMERA","TOMARES","TOTAL POBLACION",8,6,14
" 10","BELLAVISTA-LA PALMERA","UMBRETE","ESPAÑOLES",4,5,9
" 10","BELLAVISTA-LA PALMERA","UMBRETE","EXTRANJEROS",1,0,1
" 10","BELLAVISTA-LA PALMERA","UMBRETE","TOTAL POBLACION",5,5,10
" 10","BELLAVISTA-LA PALMERA","UTRERA","ESPAÑOLES",3,10,13
" 10","BELLAVISTA-LA PALMERA","UTRERA","EXTRANJEROS",1,0,1
" 10","BELLAVISTA-LA PALMERA","UTRERA","TOTAL POBLACION",4,10,14
" 10","BELLAVISTA-LA PALMERA","VALENCINA DE LA CONCEPCION","ESPAÑOLES",1,0,1
" 10","BELLAVISTA-LA PALMERA","VALENCINA DE LA CONCEPCION","TOTAL POBLACION",1,0,1
" 10","BELLAVISTA-LA PALMERA","VILLANUEVA DEL ARISCAL","ESPAÑOLES",4,3,7
" 10","BELLAVISTA-LA PALMERA","VILLANUEVA DEL ARISCAL","TOTAL POBLACION",4,3,7
" 10","BELLAVISTA-LA PALMERA","VISO DEL ALCOR (EL)","ESPAÑOLES",1,1,2
" 10","BELLAVISTA-LA PALMERA","VISO DEL ALCOR (EL)","TOTAL POBLACION",1,1,2
" 11","LOS REMEDIOS","- FUERA DE LA PROVINCIA DE SEVILLA","ESPAÑOLES",147,185,332
" 11","LOS REMEDIOS","- FUERA DE LA PROVINCIA DE SEVILLA","EXTRANJEROS",10,18,28
" 11","LOS REMEDIOS","- FUERA DE LA PROVINCIA DE SEVILLA","TOTAL POBLACION",157,203,360
" 11","LOS REMEDIOS","- PROVINCIA DE SEVILLA","ESPAÑOLES",152,161,313
" 11","LOS REMEDIOS","- PROVINCIA DE SEVILLA","EXTRANJEROS",4,15,19
" 11","LOS REMEDIOS","- PROVINCIA DE SEVILLA","TOTAL POBLACION",156,176,332
" 11","LOS REMEDIOS","ALCALA DE GUADAIRA","ESPAÑOLES",3,7,10
" 11","LOS REMEDIOS","ALCALA DE GUADAIRA","TOTAL POBLACION",3,7,10
" 11","LOS REMEDIOS","ALCALA DEL RIO","ESPAÑOLES",3,1,4
" 11","LOS REMEDIOS","ALCALA DEL RIO","TOTAL POBLACION",3,1,4
" 11","LOS REMEDIOS","ALGABA (LA)","ESPAÑOLES",0,1,1
" 11","LOS REMEDIOS","ALGABA (LA)","EXTRANJEROS",0,1,1
" 11","LOS REMEDIOS","ALGABA (LA)","TOTAL POBLACION",0,2,2
" 11","LOS REMEDIOS","ALMENSILLA","ESPAÑOLES",1,3,4
" 11","LOS REMEDIOS","ALMENSILLA","TOTAL POBLACION",1,3,4
" 11","LOS REMEDIOS","ARAHAL (EL)","ESPAÑOLES",1,1,2
" 11","LOS REMEDIOS","ARAHAL (EL)","TOTAL POBLACION",1,1,2
" 11","LOS REMEDIOS","AZNALCAZAR","ESPAÑOLES",1,0,1
" 11","LOS REMEDIOS","AZNALCAZAR","TOTAL POBLACION",1,0,1
" 11","LOS REMEDIOS","AZNALCOLLAR","ESPAÑOLES",1,0,1
" 11","LOS REMEDIOS","AZNALCOLLAR","TOTAL POBLACION",1,0,1
" 11","LOS REMEDIOS","BOLLULLOS DE LA MITACION","ESPAÑOLES",3,4,7
" 11","LOS REMEDIOS","BOLLULLOS DE LA MITACION","TOTAL POBLACION",3,4,7
" 11","LOS REMEDIOS","BORMUJOS","ESPAÑOLES",6,5,11
" 11","LOS REMEDIOS","BORMUJOS","TOTAL POBLACION",6,5,11
" 11","LOS REMEDIOS","BRENES","ESPAÑOLES",0,1,1
" 11","LOS REMEDIOS","BRENES","TOTAL POBLACION",0,1,1
" 11","LOS REMEDIOS","BURGUILLOS","ESPAÑOLES",1,0,1
" 11","LOS REMEDIOS","BURGUILLOS","TOTAL POBLACION",1,0,1
" 11","LOS REMEDIOS","CAMAS","ESPAÑOLES",7,6,13
" 11","LOS REMEDIOS","CAMAS","EXTRANJEROS",0,1,1
" 11","LOS REMEDIOS","CAMAS","TOTAL POBLACION",7,7,14
" 11","LOS REMEDIOS","CARMONA","ESPAÑOLES",2,1,3
" 11","LOS REMEDIOS","CARMONA","TOTAL POBLACION",2,1,3
" 11","LOS REMEDIOS","CARRION DE LOS CESPEDES","ESPAÑOLES",2,1,3
" 11","LOS REMEDIOS","CARRION DE LOS CESPEDES","TOTAL POBLACION",2,1,3
" 11","LOS REMEDIOS","CASTILLEJA DE GUZMAN","ESPAÑOLES",1,0,1
" 11","LOS REMEDIOS","CASTILLEJA DE GUZMAN","TOTAL POBLACION",1,0,1
" 11","LOS REMEDIOS","CASTILLEJA DE LA CUESTA","ESPAÑOLES",2,2,4
" 11","LOS REMEDIOS","CASTILLEJA DE LA CUESTA","TOTAL POBLACION",2,2,4
" 11","LOS REMEDIOS","CASTILLO DE LAS GUARDAS (EL)","ESPAÑOLES",2,0,2
" 11","LOS REMEDIOS","CASTILLO DE LAS GUARDAS (EL)","TOTAL POBLACION",2,0,2
" 11","LOS REMEDIOS","CONSTANTINA","ESPAÑOLES",2,2,4
" 11","LOS REMEDIOS","CONSTANTINA","TOTAL POBLACION",2,2,4
" 11","LOS REMEDIOS","CORIA DEL RIO","ESPAÑOLES",2,4,6
" 11","LOS REMEDIOS","CORIA DEL RIO","TOTAL POBLACION",2,4,6
" 11","LOS REMEDIOS","DOS HERMANAS","ESPAÑOLES",10,16,26
" 11","LOS REMEDIOS","DOS HERMANAS","EXTRANJEROS",1,2,3
" 11","LOS REMEDIOS","DOS HERMANAS","TOTAL POBLACION",11,18,29
" 11","LOS REMEDIOS","ESPARTINAS","ESPAÑOLES",4,4,8
" 11","LOS REMEDIOS","ESPARTINAS","EXTRANJEROS",3,3,6
" 11","LOS REMEDIOS","ESPARTINAS","TOTAL POBLACION",7,7,14
" 11","LOS REMEDIOS","ESTEPA","ESPAÑOLES",1,0,1
" 11","LOS REMEDIOS","ESTEPA","TOTAL POBLACION",1,0,1
" 11","LOS REMEDIOS","GELVES","ESPAÑOLES",20,17,37
" 11","LOS REMEDIOS","GELVES","TOTAL POBLACION",20,17,37
" 11","LOS REMEDIOS","GERENA","EXTRANJEROS",0,1,1
" 11","LOS REMEDIOS","GERENA","TOTAL POBLACION",0,1,1
" 11","LOS REMEDIOS","GINES","ESPAÑOLES",4,6,10
" 11","LOS REMEDIOS","GINES","TOTAL POBLACION",4,6,10
" 11","LOS REMEDIOS","GUADALCANAL","ESPAÑOLES",1,0,1
" 11","LOS REMEDIOS","GUADALCANAL","TOTAL POBLACION",1,0,1
" 11","LOS REMEDIOS","GUILLENA","ESPAÑOLES",4,8,12
" 11","LOS REMEDIOS","GUILLENA","TOTAL POBLACION",4,8,12
" 11","LOS REMEDIOS","LEBRIJA","ESPAÑOLES",1,0,1
" 11","LOS REMEDIOS","LEBRIJA","TOTAL POBLACION",1,0,1
" 11","LOS REMEDIOS","MAIRENA DEL ALCOR","ESPAÑOLES",2,0,2
" 11","LOS REMEDIOS","MAIRENA DEL ALCOR","TOTAL POBLACION",2,0,2
" 11","LOS REMEDIOS","MAIRENA DEL ALJARAFE","ESPAÑOLES",15,15,30
" 11","LOS REMEDIOS","MAIRENA DEL ALJARAFE","EXTRANJEROS",0,1,1
" 11","LOS REMEDIOS","MAIRENA DEL ALJARAFE","TOTAL POBLACION",15,16,31
" 11","LOS REMEDIOS","MARCHENA","ESPAÑOLES",0,1,1
" 11","LOS REMEDIOS","MARCHENA","TOTAL POBLACION",0,1,1
" 11","LOS REMEDIOS","MORON DE LA FRONTERA","ESPAÑOLES",2,1,3
" 11","LOS REMEDIOS","MORON DE LA FRONTERA","TOTAL POBLACION",2,1,3
" 11","LOS REMEDIOS","PALOMARES DEL RIO","ESPAÑOLES",4,6,10
" 11","LOS REMEDIOS","PALOMARES DEL RIO","TOTAL POBLACION",4,6,10
" 11","LOS REMEDIOS","PILAS","ESPAÑOLES",1,2,3
" 11","LOS REMEDIOS","PILAS","TOTAL POBLACION",1,2,3
" 11","LOS REMEDIOS","PUEBLA DEL RIO (LA)","ESPAÑOLES",2,0,2
" 11","LOS REMEDIOS","PUEBLA DEL RIO (LA)","TOTAL POBLACION",2,0,2
" 11","LOS REMEDIOS","RINCONADA (LA)","ESPAÑOLES",2,0,2
" 11","LOS REMEDIOS","RINCONADA (LA)","EXTRANJEROS",0,1,1
" 11","LOS REMEDIOS","RINCONADA (LA)","TOTAL POBLACION",2,1,3
" 11","LOS REMEDIOS","SALTERAS","ESPAÑOLES",1,0,1
" 11","LOS REMEDIOS","SALTERAS","TOTAL POBLACION",1,0,1
" 11","LOS REMEDIOS","SAN JUAN DE AZNALFARACHE","ESPAÑOLES",13,17,30
" 11","LOS REMEDIOS","SAN JUAN DE AZNALFARACHE","EXTRANJEROS",0,3,3
" 11","LOS REMEDIOS","SAN JUAN DE AZNALFARACHE","TOTAL POBLACION",13,20,33
" 11","LOS REMEDIOS","SANLUCAR LA MAYOR","ESPAÑOLES",0,1,1
" 11","LOS REMEDIOS","SANLUCAR LA MAYOR","TOTAL POBLACION",0,1,1
" 11","LOS REMEDIOS","SANTIPONCE","ESPAÑOLES",1,0,1
" 11","LOS REMEDIOS","SANTIPONCE","EXTRANJEROS",0,1,1
" 11","LOS REMEDIOS","SANTIPONCE","TOTAL POBLACION",1,1,2
" 11","LOS REMEDIOS","TOMARES","ESPAÑOLES",16,18,34
" 11","LOS REMEDIOS","TOMARES","TOTAL POBLACION",16,18,34
" 11","LOS REMEDIOS","UMBRETE","ESPAÑOLES",2,4,6
" 11","LOS REMEDIOS","UMBRETE","TOTAL POBLACION",2,4,6
" 11","LOS REMEDIOS","UTRERA","ESPAÑOLES",3,1,4
" 11","LOS REMEDIOS","UTRERA","EXTRANJEROS",0,1,1
" 11","LOS REMEDIOS","UTRERA","TOTAL POBLACION",3,2,5
" 11","LOS REMEDIOS","VALENCINA DE LA CONCEPCION","ESPAÑOLES",1,2,3
" 11","LOS REMEDIOS","VALENCINA DE LA CONCEPCION","TOTAL POBLACION",1,2,3
" 11","LOS REMEDIOS","VILLAMANRIQUE DE LA CONDESA","ESPAÑOLES",0,1,1
" 11","LOS REMEDIOS","VILLAMANRIQUE DE LA CONDESA","TOTAL POBLACION",0,1,1
" 11","LOS REMEDIOS","VILLANUEVA DEL ARISCAL","ESPAÑOLES",1,1,2
" 11","LOS REMEDIOS","VILLANUEVA DEL ARISCAL","TOTAL POBLACION",1,1,2
" 11","LOS REMEDIOS","VISO DEL ALCOR (EL)","ESPAÑOLES",1,1,2
" 11","LOS REMEDIOS","VISO DEL ALCOR (EL)","TOTAL POBLACION",1,1,2
