"CD";"ND";"DESTINO";"NACION";"HOMBRES";"MUJERES";"TOTAL"
" 01";"CASCO ANTIGUO";"- FUERA DE LA PROVINCIA DE SEVILLA";"ESPAÑOLES";442;432;874
" 01";"CASCO ANTIGUO";"- FUERA DE LA PROVINCIA DE SEVILLA";"EXTRANJEROS";71;104;175
" 01";"CASCO ANTIGUO";"- FUERA DE LA PROVINCIA DE SEVILLA";"TOTAL POBLACION";513;536;1049
" 01";"CASCO ANTIGUO";"- PROVINCIA DE SEVILLA";"ESPAÑOLES";322;298;620
" 01";"CASCO ANTIGUO";"- PROVINCIA DE SEVILLA";"EXTRANJEROS";31;34;65
" 01";"CASCO ANTIGUO";"- PROVINCIA DE SEVILLA";"TOTAL POBLACION";353;332;685
" 01";"CASCO ANTIGUO";"ALANIS";"ESPAÑOLES";0;1;1
" 01";"CASCO ANTIGUO";"ALANIS";"TOTAL POBLACION";0;1;1
" 01";"CASCO ANTIGUO";"ALBAIDA DEL ALJARAFE";"ESPAÑOLES";1;1;2
" 01";"CASCO ANTIGUO";"ALBAIDA DEL ALJARAFE";"TOTAL POBLACION";1;1;2
" 01";"CASCO ANTIGUO";"ALCALA DE GUADAIRA";"ESPAÑOLES";15;9;24
" 01";"CASCO ANTIGUO";"ALCALA DE GUADAIRA";"EXTRANJEROS";1;7;8
" 01";"CASCO ANTIGUO";"ALCALA DE GUADAIRA";"TOTAL POBLACION";16;16;32
" 01";"CASCO ANTIGUO";"ALCALA DEL RIO";"ESPAÑOLES";3;3;6
" 01";"CASCO ANTIGUO";"ALCALA DEL RIO";"TOTAL POBLACION";3;3;6
" 01";"CASCO ANTIGUO";"ALGABA (LA)";"ESPAÑOLES";3;12;15
" 01";"CASCO ANTIGUO";"ALGABA (LA)";"TOTAL POBLACION";3;12;15
" 01";"CASCO ANTIGUO";"ALMADEN DE LA PLATA";"ESPAÑOLES";1;0;1
" 01";"CASCO ANTIGUO";"ALMADEN DE LA PLATA";"TOTAL POBLACION";1;0;1
" 01";"CASCO ANTIGUO";"ALMENSILLA";"ESPAÑOLES";3;2;5
" 01";"CASCO ANTIGUO";"ALMENSILLA";"EXTRANJEROS";0;1;1
" 01";"CASCO ANTIGUO";"ALMENSILLA";"TOTAL POBLACION";3;3;6
" 01";"CASCO ANTIGUO";"ARAHAL (EL)";"ESPAÑOLES";0;2;2
" 01";"CASCO ANTIGUO";"ARAHAL (EL)";"TOTAL POBLACION";0;2;2
" 01";"CASCO ANTIGUO";"AZNALCAZAR";"ESPAÑOLES";2;2;4
" 01";"CASCO ANTIGUO";"AZNALCAZAR";"EXTRANJEROS";1;0;1
" 01";"CASCO ANTIGUO";"AZNALCAZAR";"TOTAL POBLACION";3;2;5
" 01";"CASCO ANTIGUO";"AZNALCOLLAR";"ESPAÑOLES";2;0;2
" 01";"CASCO ANTIGUO";"AZNALCOLLAR";"TOTAL POBLACION";2;0;2
" 01";"CASCO ANTIGUO";"BENACAZON";"ESPAÑOLES";0;1;1
" 01";"CASCO ANTIGUO";"BENACAZON";"TOTAL POBLACION";0;1;1
" 01";"CASCO ANTIGUO";"BOLLULLOS DE LA MITACION";"ESPAÑOLES";11;7;18
" 01";"CASCO ANTIGUO";"BOLLULLOS DE LA MITACION";"EXTRANJEROS";1;0;1
" 01";"CASCO ANTIGUO";"BOLLULLOS DE LA MITACION";"TOTAL POBLACION";12;7;19
" 01";"CASCO ANTIGUO";"BORMUJOS";"ESPAÑOLES";13;10;23
" 01";"CASCO ANTIGUO";"BORMUJOS";"EXTRANJEROS";2;2;4
" 01";"CASCO ANTIGUO";"BORMUJOS";"TOTAL POBLACION";15;12;27
" 01";"CASCO ANTIGUO";"BRENES";"ESPAÑOLES";2;1;3
" 01";"CASCO ANTIGUO";"BRENES";"TOTAL POBLACION";2;1;3
" 01";"CASCO ANTIGUO";"BURGUILLOS";"ESPAÑOLES";3;1;4
" 01";"CASCO ANTIGUO";"BURGUILLOS";"TOTAL POBLACION";3;1;4
" 01";"CASCO ANTIGUO";"CAMAS";"ESPAÑOLES";24;10;34
" 01";"CASCO ANTIGUO";"CAMAS";"EXTRANJEROS";0;4;4
" 01";"CASCO ANTIGUO";"CAMAS";"TOTAL POBLACION";24;14;38
" 01";"CASCO ANTIGUO";"CANTILLANA";"ESPAÑOLES";4;2;6
" 01";"CASCO ANTIGUO";"CANTILLANA";"TOTAL POBLACION";4;2;6
" 01";"CASCO ANTIGUO";"CARMONA";"ESPAÑOLES";6;8;14
" 01";"CASCO ANTIGUO";"CARMONA";"EXTRANJEROS";2;2;4
" 01";"CASCO ANTIGUO";"CARMONA";"TOTAL POBLACION";8;10;18
" 01";"CASCO ANTIGUO";"CARRION DE LOS CESPEDES";"ESPAÑOLES";0;2;2
" 01";"CASCO ANTIGUO";"CARRION DE LOS CESPEDES";"TOTAL POBLACION";0;2;2
" 01";"CASCO ANTIGUO";"CASTILBLANCO DE LOS ARROYOS";"ESPAÑOLES";1;2;3
" 01";"CASCO ANTIGUO";"CASTILBLANCO DE LOS ARROYOS";"EXTRANJEROS";0;1;1
" 01";"CASCO ANTIGUO";"CASTILBLANCO DE LOS ARROYOS";"TOTAL POBLACION";1;3;4
" 01";"CASCO ANTIGUO";"CASTILLEJA DE GUZMAN";"ESPAÑOLES";5;4;9
" 01";"CASCO ANTIGUO";"CASTILLEJA DE GUZMAN";"TOTAL POBLACION";5;4;9
" 01";"CASCO ANTIGUO";"CASTILLEJA DE LA CUESTA";"ESPAÑOLES";9;7;16
" 01";"CASCO ANTIGUO";"CASTILLEJA DE LA CUESTA";"EXTRANJEROS";1;1;2
" 01";"CASCO ANTIGUO";"CASTILLEJA DE LA CUESTA";"TOTAL POBLACION";10;8;18
" 01";"CASCO ANTIGUO";"CAZALLA DE LA SIERRA";"ESPAÑOLES";1;1;2
" 01";"CASCO ANTIGUO";"CAZALLA DE LA SIERRA";"TOTAL POBLACION";1;1;2
" 01";"CASCO ANTIGUO";"CORIA DEL RIO";"ESPAÑOLES";9;6;15
" 01";"CASCO ANTIGUO";"CORIA DEL RIO";"EXTRANJEROS";2;0;2
" 01";"CASCO ANTIGUO";"CORIA DEL RIO";"TOTAL POBLACION";11;6;17
" 01";"CASCO ANTIGUO";"DOS HERMANAS";"ESPAÑOLES";27;27;54
" 01";"CASCO ANTIGUO";"DOS HERMANAS";"EXTRANJEROS";6;3;9
" 01";"CASCO ANTIGUO";"DOS HERMANAS";"TOTAL POBLACION";33;30;63
" 01";"CASCO ANTIGUO";"ECIJA";"ESPAÑOLES";2;3;5
" 01";"CASCO ANTIGUO";"ECIJA";"TOTAL POBLACION";2;3;5
" 01";"CASCO ANTIGUO";"ESPARTINAS";"ESPAÑOLES";7;13;20
" 01";"CASCO ANTIGUO";"ESPARTINAS";"TOTAL POBLACION";7;13;20
" 01";"CASCO ANTIGUO";"ESTEPA";"ESPAÑOLES";2;1;3
" 01";"CASCO ANTIGUO";"ESTEPA";"TOTAL POBLACION";2;1;3
" 01";"CASCO ANTIGUO";"GELVES";"ESPAÑOLES";4;5;9
" 01";"CASCO ANTIGUO";"GELVES";"TOTAL POBLACION";4;5;9
" 01";"CASCO ANTIGUO";"GERENA";"ESPAÑOLES";0;2;2
" 01";"CASCO ANTIGUO";"GERENA";"EXTRANJEROS";1;0;1
" 01";"CASCO ANTIGUO";"GERENA";"TOTAL POBLACION";1;2;3
" 01";"CASCO ANTIGUO";"GINES";"ESPAÑOLES";8;14;22
" 01";"CASCO ANTIGUO";"GINES";"TOTAL POBLACION";8;14;22
" 01";"CASCO ANTIGUO";"GUADALCANAL";"ESPAÑOLES";1;0;1
" 01";"CASCO ANTIGUO";"GUADALCANAL";"TOTAL POBLACION";1;0;1
" 01";"CASCO ANTIGUO";"GUILLENA";"ESPAÑOLES";4;3;7
" 01";"CASCO ANTIGUO";"GUILLENA";"TOTAL POBLACION";4;3;7
" 01";"CASCO ANTIGUO";"HERRERA";"ESPAÑOLES";1;0;1
" 01";"CASCO ANTIGUO";"HERRERA";"TOTAL POBLACION";1;0;1
" 01";"CASCO ANTIGUO";"HUEVAR DEL ALJARAFE";"ESPAÑOLES";3;0;3
" 01";"CASCO ANTIGUO";"HUEVAR DEL ALJARAFE";"TOTAL POBLACION";3;0;3
" 01";"CASCO ANTIGUO";"ISLA MAYOR";"ESPAÑOLES";0;2;2
" 01";"CASCO ANTIGUO";"ISLA MAYOR";"TOTAL POBLACION";0;2;2
" 01";"CASCO ANTIGUO";"LEBRIJA";"ESPAÑOLES";0;1;1
" 01";"CASCO ANTIGUO";"LEBRIJA";"EXTRANJEROS";1;1;2
" 01";"CASCO ANTIGUO";"LEBRIJA";"TOTAL POBLACION";1;2;3
" 01";"CASCO ANTIGUO";"LORA DEL RIO";"ESPAÑOLES";1;1;2
" 01";"CASCO ANTIGUO";"LORA DEL RIO";"EXTRANJEROS";0;1;1
" 01";"CASCO ANTIGUO";"LORA DEL RIO";"TOTAL POBLACION";1;2;3
" 01";"CASCO ANTIGUO";"MADROÑO (EL)";"ESPAÑOLES";1;0;1
" 01";"CASCO ANTIGUO";"MADROÑO (EL)";"TOTAL POBLACION";1;0;1
" 01";"CASCO ANTIGUO";"MAIRENA DEL ALCOR";"ESPAÑOLES";2;2;4
" 01";"CASCO ANTIGUO";"MAIRENA DEL ALCOR";"EXTRANJEROS";0;1;1
" 01";"CASCO ANTIGUO";"MAIRENA DEL ALCOR";"TOTAL POBLACION";2;3;5
" 01";"CASCO ANTIGUO";"MAIRENA DEL ALJARAFE";"ESPAÑOLES";34;29;63
" 01";"CASCO ANTIGUO";"MAIRENA DEL ALJARAFE";"EXTRANJEROS";3;4;7
" 01";"CASCO ANTIGUO";"MAIRENA DEL ALJARAFE";"TOTAL POBLACION";37;33;70
" 01";"CASCO ANTIGUO";"MARCHENA";"ESPAÑOLES";2;2;4
" 01";"CASCO ANTIGUO";"MARCHENA";"TOTAL POBLACION";2;2;4
" 01";"CASCO ANTIGUO";"MORON DE LA FRONTERA";"ESPAÑOLES";1;4;5
" 01";"CASCO ANTIGUO";"MORON DE LA FRONTERA";"TOTAL POBLACION";1;4;5
" 01";"CASCO ANTIGUO";"OLIVARES";"ESPAÑOLES";1;4;5
" 01";"CASCO ANTIGUO";"OLIVARES";"TOTAL POBLACION";1;4;5
" 01";"CASCO ANTIGUO";"OSUNA";"ESPAÑOLES";1;1;2
" 01";"CASCO ANTIGUO";"OSUNA";"TOTAL POBLACION";1;1;2
" 01";"CASCO ANTIGUO";"PALACIOS Y VILLAFRANCA (LOS)";"ESPAÑOLES";2;1;3
" 01";"CASCO ANTIGUO";"PALACIOS Y VILLAFRANCA (LOS)";"TOTAL POBLACION";2;1;3
" 01";"CASCO ANTIGUO";"PALMAR DE TROYA (EL)";"EXTRANJEROS";1;0;1
" 01";"CASCO ANTIGUO";"PALMAR DE TROYA (EL)";"TOTAL POBLACION";1;0;1
" 01";"CASCO ANTIGUO";"PALOMARES DEL RIO";"ESPAÑOLES";5;6;11
" 01";"CASCO ANTIGUO";"PALOMARES DEL RIO";"EXTRANJEROS";0;1;1
" 01";"CASCO ANTIGUO";"PALOMARES DEL RIO";"TOTAL POBLACION";5;7;12
" 01";"CASCO ANTIGUO";"PARADAS";"ESPAÑOLES";0;1;1
" 01";"CASCO ANTIGUO";"PARADAS";"TOTAL POBLACION";0;1;1
" 01";"CASCO ANTIGUO";"PEDRERA";"ESPAÑOLES";1;0;1
" 01";"CASCO ANTIGUO";"PEDRERA";"TOTAL POBLACION";1;0;1
" 01";"CASCO ANTIGUO";"PEDROSO (EL)";"ESPAÑOLES";1;0;1
" 01";"CASCO ANTIGUO";"PEDROSO (EL)";"TOTAL POBLACION";1;0;1
" 01";"CASCO ANTIGUO";"PEÑAFLOR";"ESPAÑOLES";2;0;2
" 01";"CASCO ANTIGUO";"PEÑAFLOR";"EXTRANJEROS";1;0;1
" 01";"CASCO ANTIGUO";"PEÑAFLOR";"TOTAL POBLACION";3;0;3
" 01";"CASCO ANTIGUO";"PILAS";"ESPAÑOLES";2;2;4
" 01";"CASCO ANTIGUO";"PILAS";"TOTAL POBLACION";2;2;4
" 01";"CASCO ANTIGUO";"PUEBLA DE CAZALLA (LA)";"ESPAÑOLES";1;0;1
" 01";"CASCO ANTIGUO";"PUEBLA DE CAZALLA (LA)";"TOTAL POBLACION";1;0;1
" 01";"CASCO ANTIGUO";"PUEBLA DE LOS INFANTES (LA)";"ESPAÑOLES";3;3;6
" 01";"CASCO ANTIGUO";"PUEBLA DE LOS INFANTES (LA)";"TOTAL POBLACION";3;3;6
" 01";"CASCO ANTIGUO";"PUEBLA DEL RIO (LA)";"ESPAÑOLES";0;3;3
" 01";"CASCO ANTIGUO";"PUEBLA DEL RIO (LA)";"TOTAL POBLACION";0;3;3
" 01";"CASCO ANTIGUO";"REAL DE LA JARA (EL)";"ESPAÑOLES";1;2;3
" 01";"CASCO ANTIGUO";"REAL DE LA JARA (EL)";"TOTAL POBLACION";1;2;3
" 01";"CASCO ANTIGUO";"RINCONADA (LA)";"ESPAÑOLES";13;15;28
" 01";"CASCO ANTIGUO";"RINCONADA (LA)";"EXTRANJEROS";2;0;2
" 01";"CASCO ANTIGUO";"RINCONADA (LA)";"TOTAL POBLACION";15;15;30
" 01";"CASCO ANTIGUO";"RONQUILLO (EL)";"ESPAÑOLES";1;1;2
" 01";"CASCO ANTIGUO";"RONQUILLO (EL)";"TOTAL POBLACION";1;1;2
" 01";"CASCO ANTIGUO";"SALTERAS";"ESPAÑOLES";1;1;2
" 01";"CASCO ANTIGUO";"SALTERAS";"TOTAL POBLACION";1;1;2
" 01";"CASCO ANTIGUO";"SAN JUAN DE AZNALFARACHE";"ESPAÑOLES";9;9;18
" 01";"CASCO ANTIGUO";"SAN JUAN DE AZNALFARACHE";"EXTRANJEROS";1;2;3
" 01";"CASCO ANTIGUO";"SAN JUAN DE AZNALFARACHE";"TOTAL POBLACION";10;11;21
" 01";"CASCO ANTIGUO";"SANLUCAR LA MAYOR";"ESPAÑOLES";8;7;15
" 01";"CASCO ANTIGUO";"SANLUCAR LA MAYOR";"EXTRANJEROS";0;1;1
" 01";"CASCO ANTIGUO";"SANLUCAR LA MAYOR";"TOTAL POBLACION";8;8;16
" 01";"CASCO ANTIGUO";"SANTIPONCE";"ESPAÑOLES";1;1;2
" 01";"CASCO ANTIGUO";"SANTIPONCE";"TOTAL POBLACION";1;1;2
" 01";"CASCO ANTIGUO";"TOCINA";"ESPAÑOLES";2;0;2
" 01";"CASCO ANTIGUO";"TOCINA";"TOTAL POBLACION";2;0;2
" 01";"CASCO ANTIGUO";"TOMARES";"ESPAÑOLES";25;16;41
" 01";"CASCO ANTIGUO";"TOMARES";"EXTRANJEROS";3;1;4
" 01";"CASCO ANTIGUO";"TOMARES";"TOTAL POBLACION";28;17;45
" 01";"CASCO ANTIGUO";"UMBRETE";"ESPAÑOLES";6;6;12
" 01";"CASCO ANTIGUO";"UMBRETE";"TOTAL POBLACION";6;6;12
" 01";"CASCO ANTIGUO";"UTRERA";"ESPAÑOLES";3;4;7
" 01";"CASCO ANTIGUO";"UTRERA";"TOTAL POBLACION";3;4;7
" 01";"CASCO ANTIGUO";"VALENCINA DE LA CONCEPCION";"ESPAÑOLES";5;4;9
" 01";"CASCO ANTIGUO";"VALENCINA DE LA CONCEPCION";"EXTRANJEROS";2;0;2
" 01";"CASCO ANTIGUO";"VALENCINA DE LA CONCEPCION";"TOTAL POBLACION";7;4;11
" 01";"CASCO ANTIGUO";"VILLAMANRIQUE DE LA CONDESA";"ESPAÑOLES";0;1;1
" 01";"CASCO ANTIGUO";"VILLAMANRIQUE DE LA CONDESA";"TOTAL POBLACION";0;1;1
" 01";"CASCO ANTIGUO";"VILLANUEVA DEL ARISCAL";"ESPAÑOLES";3;3;6
" 01";"CASCO ANTIGUO";"VILLANUEVA DEL ARISCAL";"TOTAL POBLACION";3;3;6
" 01";"CASCO ANTIGUO";"VILLANUEVA DEL RIO Y MINAS";"ESPAÑOLES";3;1;4
" 01";"CASCO ANTIGUO";"VILLANUEVA DEL RIO Y MINAS";"TOTAL POBLACION";3;1;4
" 01";"CASCO ANTIGUO";"VILLAVERDE DEL RIO";"ESPAÑOLES";1;1;2
" 01";"CASCO ANTIGUO";"VILLAVERDE DEL RIO";"TOTAL POBLACION";1;1;2
" 01";"CASCO ANTIGUO";"VISO DEL ALCOR (EL)";"ESPAÑOLES";3;2;5
" 01";"CASCO ANTIGUO";"VISO DEL ALCOR (EL)";"EXTRANJEROS";0;1;1
" 01";"CASCO ANTIGUO";"VISO DEL ALCOR (EL)";"TOTAL POBLACION";3;3;6
" 02";"MACARENA";"- FUERA DE LA PROVINCIA DE SEVILLA";"ESPAÑOLES";364;383;747
" 02";"MACARENA";"- FUERA DE LA PROVINCIA DE SEVILLA";"EXTRANJEROS";162;201;363
" 02";"MACARENA";"- FUERA DE LA PROVINCIA DE SEVILLA";"TOTAL POBLACION";526;584;1110
" 02";"MACARENA";"- PROVINCIA DE SEVILLA";"ESPAÑOLES";405;431;836
" 02";"MACARENA";"- PROVINCIA DE SEVILLA";"EXTRANJEROS";78;123;201
" 02";"MACARENA";"- PROVINCIA DE SEVILLA";"NO CONSTA";1;0;1
" 02";"MACARENA";"- PROVINCIA DE SEVILLA";"TOTAL POBLACION";484;554;1038
" 02";"MACARENA";"ALANIS";"ESPAÑOLES";1;0;1
" 02";"MACARENA";"ALANIS";"TOTAL POBLACION";1;0;1
" 02";"MACARENA";"ALBAIDA DEL ALJARAFE";"ESPAÑOLES";2;2;4
" 02";"MACARENA";"ALBAIDA DEL ALJARAFE";"TOTAL POBLACION";2;2;4
" 02";"MACARENA";"ALCALA DE GUADAIRA";"ESPAÑOLES";20;19;39
" 02";"MACARENA";"ALCALA DE GUADAIRA";"EXTRANJEROS";8;11;19
" 02";"MACARENA";"ALCALA DE GUADAIRA";"TOTAL POBLACION";28;30;58
" 02";"MACARENA";"ALCALA DEL RIO";"ESPAÑOLES";16;15;31
" 02";"MACARENA";"ALCALA DEL RIO";"EXTRANJEROS";2;5;7
" 02";"MACARENA";"ALCALA DEL RIO";"TOTAL POBLACION";18;20;38
" 02";"MACARENA";"ALGABA (LA)";"ESPAÑOLES";24;18;42
" 02";"MACARENA";"ALGABA (LA)";"EXTRANJEROS";1;1;2
" 02";"MACARENA";"ALGABA (LA)";"TOTAL POBLACION";25;19;44
" 02";"MACARENA";"ALMENSILLA";"ESPAÑOLES";4;1;5
" 02";"MACARENA";"ALMENSILLA";"EXTRANJEROS";0;2;2
" 02";"MACARENA";"ALMENSILLA";"TOTAL POBLACION";4;3;7
" 02";"MACARENA";"ARAHAL (EL)";"EXTRANJEROS";1;3;4
" 02";"MACARENA";"ARAHAL (EL)";"TOTAL POBLACION";1;3;4
" 02";"MACARENA";"AZNALCAZAR";"ESPAÑOLES";5;3;8
" 02";"MACARENA";"AZNALCAZAR";"EXTRANJEROS";0;2;2
" 02";"MACARENA";"AZNALCAZAR";"TOTAL POBLACION";5;5;10
" 02";"MACARENA";"AZNALCOLLAR";"ESPAÑOLES";0;1;1
" 02";"MACARENA";"AZNALCOLLAR";"TOTAL POBLACION";0;1;1
" 02";"MACARENA";"BENACAZON";"ESPAÑOLES";0;2;2
" 02";"MACARENA";"BENACAZON";"TOTAL POBLACION";0;2;2
" 02";"MACARENA";"BOLLULLOS DE LA MITACION";"ESPAÑOLES";11;10;21
" 02";"MACARENA";"BOLLULLOS DE LA MITACION";"EXTRANJEROS";0;2;2
" 02";"MACARENA";"BOLLULLOS DE LA MITACION";"TOTAL POBLACION";11;12;23
" 02";"MACARENA";"BORMUJOS";"ESPAÑOLES";14;18;32
" 02";"MACARENA";"BORMUJOS";"EXTRANJEROS";2;6;8
" 02";"MACARENA";"BORMUJOS";"TOTAL POBLACION";16;24;40
" 02";"MACARENA";"BRENES";"ESPAÑOLES";4;3;7
" 02";"MACARENA";"BRENES";"EXTRANJEROS";1;0;1
" 02";"MACARENA";"BRENES";"TOTAL POBLACION";5;3;8
" 02";"MACARENA";"BURGUILLOS";"ESPAÑOLES";11;9;20
" 02";"MACARENA";"BURGUILLOS";"EXTRANJEROS";0;1;1
" 02";"MACARENA";"BURGUILLOS";"TOTAL POBLACION";11;10;21
" 02";"MACARENA";"CABEZAS DE SAN JUAN (LAS)";"ESPAÑOLES";1;2;3
" 02";"MACARENA";"CABEZAS DE SAN JUAN (LAS)";"TOTAL POBLACION";1;2;3
" 02";"MACARENA";"CAMAS";"ESPAÑOLES";13;21;34
" 02";"MACARENA";"CAMAS";"EXTRANJEROS";5;8;13
" 02";"MACARENA";"CAMAS";"TOTAL POBLACION";18;29;47
" 02";"MACARENA";"CAMPANA (LA)";"ESPAÑOLES";2;0;2
" 02";"MACARENA";"CAMPANA (LA)";"TOTAL POBLACION";2;0;2
" 02";"MACARENA";"CANTILLANA";"ESPAÑOLES";2;3;5
" 02";"MACARENA";"CANTILLANA";"EXTRANJEROS";2;0;2
" 02";"MACARENA";"CANTILLANA";"TOTAL POBLACION";4;3;7
" 02";"MACARENA";"CARMONA";"ESPAÑOLES";16;11;27
" 02";"MACARENA";"CARMONA";"EXTRANJEROS";1;2;3
" 02";"MACARENA";"CARMONA";"TOTAL POBLACION";17;13;30
" 02";"MACARENA";"CARRION DE LOS CESPEDES";"ESPAÑOLES";4;1;5
" 02";"MACARENA";"CARRION DE LOS CESPEDES";"EXTRANJEROS";1;0;1
" 02";"MACARENA";"CARRION DE LOS CESPEDES";"TOTAL POBLACION";5;1;6
" 02";"MACARENA";"CASARICHE";"ESPAÑOLES";1;0;1
" 02";"MACARENA";"CASARICHE";"TOTAL POBLACION";1;0;1
" 02";"MACARENA";"CASTILBLANCO DE LOS ARROYOS";"ESPAÑOLES";6;5;11
" 02";"MACARENA";"CASTILBLANCO DE LOS ARROYOS";"TOTAL POBLACION";6;5;11
" 02";"MACARENA";"CASTILLEJA DE GUZMAN";"ESPAÑOLES";3;4;7
" 02";"MACARENA";"CASTILLEJA DE GUZMAN";"EXTRANJEROS";1;3;4
" 02";"MACARENA";"CASTILLEJA DE GUZMAN";"TOTAL POBLACION";4;7;11
" 02";"MACARENA";"CASTILLEJA DE LA CUESTA";"ESPAÑOLES";9;8;17
" 02";"MACARENA";"CASTILLEJA DE LA CUESTA";"EXTRANJEROS";3;4;7
" 02";"MACARENA";"CASTILLEJA DE LA CUESTA";"TOTAL POBLACION";12;12;24
" 02";"MACARENA";"CASTILLO DE LAS GUARDAS (EL)";"ESPAÑOLES";0;1;1
" 02";"MACARENA";"CASTILLO DE LAS GUARDAS (EL)";"TOTAL POBLACION";0;1;1
" 02";"MACARENA";"CAZALLA DE LA SIERRA";"ESPAÑOLES";3;3;6
" 02";"MACARENA";"CAZALLA DE LA SIERRA";"EXTRANJEROS";1;2;3
" 02";"MACARENA";"CAZALLA DE LA SIERRA";"TOTAL POBLACION";4;5;9
" 02";"MACARENA";"CONSTANTINA";"ESPAÑOLES";1;2;3
" 02";"MACARENA";"CONSTANTINA";"TOTAL POBLACION";1;2;3
" 02";"MACARENA";"CORIA DEL RIO";"ESPAÑOLES";9;6;15
" 02";"MACARENA";"CORIA DEL RIO";"EXTRANJEROS";6;6;12
" 02";"MACARENA";"CORIA DEL RIO";"TOTAL POBLACION";15;12;27
" 02";"MACARENA";"CORIPE";"ESPAÑOLES";0;1;1
" 02";"MACARENA";"CORIPE";"TOTAL POBLACION";0;1;1
" 02";"MACARENA";"DOS HERMANAS";"ESPAÑOLES";29;39;68
" 02";"MACARENA";"DOS HERMANAS";"EXTRANJEROS";5;3;8
" 02";"MACARENA";"DOS HERMANAS";"TOTAL POBLACION";34;42;76
" 02";"MACARENA";"ECIJA";"ESPAÑOLES";1;1;2
" 02";"MACARENA";"ECIJA";"EXTRANJEROS";1;0;1
" 02";"MACARENA";"ECIJA";"TOTAL POBLACION";2;1;3
" 02";"MACARENA";"ESPARTINAS";"ESPAÑOLES";16;18;34
" 02";"MACARENA";"ESPARTINAS";"EXTRANJEROS";1;0;1
" 02";"MACARENA";"ESPARTINAS";"TOTAL POBLACION";17;18;35
" 02";"MACARENA";"FUENTES DE ANDALUCIA";"EXTRANJEROS";0;2;2
" 02";"MACARENA";"FUENTES DE ANDALUCIA";"TOTAL POBLACION";0;2;2
" 02";"MACARENA";"GARROBO (EL)";"EXTRANJEROS";0;1;1
" 02";"MACARENA";"GARROBO (EL)";"TOTAL POBLACION";0;1;1
" 02";"MACARENA";"GELVES";"ESPAÑOLES";5;7;12
" 02";"MACARENA";"GELVES";"EXTRANJEROS";1;4;5
" 02";"MACARENA";"GELVES";"TOTAL POBLACION";6;11;17
" 02";"MACARENA";"GERENA";"ESPAÑOLES";7;8;15
" 02";"MACARENA";"GERENA";"EXTRANJEROS";0;2;2
" 02";"MACARENA";"GERENA";"TOTAL POBLACION";7;10;17
" 02";"MACARENA";"GILENA";"ESPAÑOLES";1;0;1
" 02";"MACARENA";"GILENA";"TOTAL POBLACION";1;0;1
" 02";"MACARENA";"GINES";"ESPAÑOLES";4;7;11
" 02";"MACARENA";"GINES";"TOTAL POBLACION";4;7;11
" 02";"MACARENA";"GUADALCANAL";"ESPAÑOLES";1;1;2
" 02";"MACARENA";"GUADALCANAL";"TOTAL POBLACION";1;1;2
" 02";"MACARENA";"GUILLENA";"ESPAÑOLES";6;10;16
" 02";"MACARENA";"GUILLENA";"EXTRANJEROS";0;1;1
" 02";"MACARENA";"GUILLENA";"TOTAL POBLACION";6;11;17
" 02";"MACARENA";"HUEVAR DEL ALJARAFE";"ESPAÑOLES";2;1;3
" 02";"MACARENA";"HUEVAR DEL ALJARAFE";"EXTRANJEROS";0;1;1
" 02";"MACARENA";"HUEVAR DEL ALJARAFE";"TOTAL POBLACION";2;2;4
" 02";"MACARENA";"ISLA MAYOR";"ESPAÑOLES";1;0;1
" 02";"MACARENA";"ISLA MAYOR";"TOTAL POBLACION";1;0;1
" 02";"MACARENA";"LORA DEL RIO";"ESPAÑOLES";0;1;1
" 02";"MACARENA";"LORA DEL RIO";"TOTAL POBLACION";0;1;1
" 02";"MACARENA";"MADROÑO (EL)";"ESPAÑOLES";1;0;1
" 02";"MACARENA";"MADROÑO (EL)";"TOTAL POBLACION";1;0;1
" 02";"MACARENA";"MAIRENA DEL ALCOR";"ESPAÑOLES";9;6;15
" 02";"MACARENA";"MAIRENA DEL ALCOR";"EXTRANJEROS";3;3;6
" 02";"MACARENA";"MAIRENA DEL ALCOR";"TOTAL POBLACION";12;9;21
" 02";"MACARENA";"MAIRENA DEL ALJARAFE";"ESPAÑOLES";19;17;36
" 02";"MACARENA";"MAIRENA DEL ALJARAFE";"EXTRANJEROS";5;6;11
" 02";"MACARENA";"MAIRENA DEL ALJARAFE";"TOTAL POBLACION";24;23;47
" 02";"MACARENA";"MARCHENA";"EXTRANJEROS";1;0;1
" 02";"MACARENA";"MARCHENA";"TOTAL POBLACION";1;0;1
" 02";"MACARENA";"MOLARES (LOS)";"ESPAÑOLES";0;2;2
" 02";"MACARENA";"MOLARES (LOS)";"TOTAL POBLACION";0;2;2
" 02";"MACARENA";"MONTELLANO";"ESPAÑOLES";1;1;2
" 02";"MACARENA";"MONTELLANO";"EXTRANJEROS";0;1;1
" 02";"MACARENA";"MONTELLANO";"TOTAL POBLACION";1;2;3
" 02";"MACARENA";"MORON DE LA FRONTERA";"ESPAÑOLES";3;4;7
" 02";"MACARENA";"MORON DE LA FRONTERA";"EXTRANJEROS";2;0;2
" 02";"MACARENA";"MORON DE LA FRONTERA";"TOTAL POBLACION";5;4;9
" 02";"MACARENA";"NAVAS DE LA CONCEPCION (LAS)";"EXTRANJEROS";3;2;5
" 02";"MACARENA";"NAVAS DE LA CONCEPCION (LAS)";"TOTAL POBLACION";3;2;5
" 02";"MACARENA";"OLIVARES";"ESPAÑOLES";8;5;13
" 02";"MACARENA";"OLIVARES";"TOTAL POBLACION";8;5;13
" 02";"MACARENA";"OSUNA";"ESPAÑOLES";1;3;4
" 02";"MACARENA";"OSUNA";"TOTAL POBLACION";1;3;4
" 02";"MACARENA";"PALACIOS Y VILLAFRANCA (LOS)";"ESPAÑOLES";1;1;2
" 02";"MACARENA";"PALACIOS Y VILLAFRANCA (LOS)";"EXTRANJEROS";0;2;2
" 02";"MACARENA";"PALACIOS Y VILLAFRANCA (LOS)";"TOTAL POBLACION";1;3;4
" 02";"MACARENA";"PALOMARES DEL RIO";"ESPAÑOLES";3;5;8
" 02";"MACARENA";"PALOMARES DEL RIO";"EXTRANJEROS";1;0;1
" 02";"MACARENA";"PALOMARES DEL RIO";"TOTAL POBLACION";4;5;9
" 02";"MACARENA";"PARADAS";"EXTRANJEROS";1;0;1
" 02";"MACARENA";"PARADAS";"TOTAL POBLACION";1;0;1
" 02";"MACARENA";"PEDROSO (EL)";"ESPAÑOLES";1;0;1
" 02";"MACARENA";"PEDROSO (EL)";"TOTAL POBLACION";1;0;1
" 02";"MACARENA";"PILAS";"ESPAÑOLES";2;2;4
" 02";"MACARENA";"PILAS";"EXTRANJEROS";0;2;2
" 02";"MACARENA";"PILAS";"TOTAL POBLACION";2;4;6
" 02";"MACARENA";"PRUNA";"EXTRANJEROS";0;1;1
" 02";"MACARENA";"PRUNA";"TOTAL POBLACION";0;1;1
" 02";"MACARENA";"PUEBLA DE CAZALLA (LA)";"ESPAÑOLES";0;1;1
" 02";"MACARENA";"PUEBLA DE CAZALLA (LA)";"TOTAL POBLACION";0;1;1
" 02";"MACARENA";"PUEBLA DE LOS INFANTES (LA)";"ESPAÑOLES";0;1;1
" 02";"MACARENA";"PUEBLA DE LOS INFANTES (LA)";"EXTRANJEROS";0;1;1
" 02";"MACARENA";"PUEBLA DE LOS INFANTES (LA)";"TOTAL POBLACION";0;2;2
" 02";"MACARENA";"PUEBLA DEL RIO (LA)";"ESPAÑOLES";0;1;1
" 02";"MACARENA";"PUEBLA DEL RIO (LA)";"EXTRANJEROS";1;2;3
" 02";"MACARENA";"PUEBLA DEL RIO (LA)";"TOTAL POBLACION";1;3;4
" 02";"MACARENA";"REAL DE LA JARA (EL)";"ESPAÑOLES";0;1;1
" 02";"MACARENA";"REAL DE LA JARA (EL)";"TOTAL POBLACION";0;1;1
" 02";"MACARENA";"RINCONADA (LA)";"ESPAÑOLES";35;52;87
" 02";"MACARENA";"RINCONADA (LA)";"EXTRANJEROS";4;5;9
" 02";"MACARENA";"RINCONADA (LA)";"TOTAL POBLACION";39;57;96
" 02";"MACARENA";"RONQUILLO (EL)";"ESPAÑOLES";3;4;7
" 02";"MACARENA";"RONQUILLO (EL)";"TOTAL POBLACION";3;4;7
" 02";"MACARENA";"RUBIO (EL)";"ESPAÑOLES";1;0;1
" 02";"MACARENA";"RUBIO (EL)";"TOTAL POBLACION";1;0;1
" 02";"MACARENA";"SALTERAS";"ESPAÑOLES";4;0;4
" 02";"MACARENA";"SALTERAS";"EXTRANJEROS";0;2;2
" 02";"MACARENA";"SALTERAS";"TOTAL POBLACION";4;2;6
" 02";"MACARENA";"SAN JUAN DE AZNALFARACHE";"ESPAÑOLES";14;10;24
" 02";"MACARENA";"SAN JUAN DE AZNALFARACHE";"EXTRANJEROS";2;9;11
" 02";"MACARENA";"SAN JUAN DE AZNALFARACHE";"TOTAL POBLACION";16;19;35
" 02";"MACARENA";"SAN NICOLAS DEL PUERTO";"ESPAÑOLES";2;0;2
" 02";"MACARENA";"SAN NICOLAS DEL PUERTO";"TOTAL POBLACION";2;0;2
" 02";"MACARENA";"SANLUCAR LA MAYOR";"ESPAÑOLES";10;10;20
" 02";"MACARENA";"SANLUCAR LA MAYOR";"EXTRANJEROS";2;3;5
" 02";"MACARENA";"SANLUCAR LA MAYOR";"NO CONSTA";1;0;1
" 02";"MACARENA";"SANLUCAR LA MAYOR";"TOTAL POBLACION";13;13;26
" 02";"MACARENA";"SANTIPONCE";"ESPAÑOLES";9;10;19
" 02";"MACARENA";"SANTIPONCE";"EXTRANJEROS";5;2;7
" 02";"MACARENA";"SANTIPONCE";"TOTAL POBLACION";14;12;26
" 02";"MACARENA";"TOCINA";"ESPAÑOLES";0;2;2
" 02";"MACARENA";"TOCINA";"TOTAL POBLACION";0;2;2
" 02";"MACARENA";"TOMARES";"ESPAÑOLES";5;3;8
" 02";"MACARENA";"TOMARES";"EXTRANJEROS";1;4;5
" 02";"MACARENA";"TOMARES";"TOTAL POBLACION";6;7;13
" 02";"MACARENA";"UMBRETE";"ESPAÑOLES";4;5;9
" 02";"MACARENA";"UMBRETE";"TOTAL POBLACION";4;5;9
" 02";"MACARENA";"UTRERA";"ESPAÑOLES";4;7;11
" 02";"MACARENA";"UTRERA";"EXTRANJEROS";3;3;6
" 02";"MACARENA";"UTRERA";"TOTAL POBLACION";7;10;17
" 02";"MACARENA";"VALENCINA DE LA CONCEPCION";"ESPAÑOLES";3;2;5
" 02";"MACARENA";"VALENCINA DE LA CONCEPCION";"EXTRANJEROS";0;1;1
" 02";"MACARENA";"VALENCINA DE LA CONCEPCION";"TOTAL POBLACION";3;3;6
" 02";"MACARENA";"VILLAMANRIQUE DE LA CONDESA";"ESPAÑOLES";0;2;2
" 02";"MACARENA";"VILLAMANRIQUE DE LA CONDESA";"TOTAL POBLACION";0;2;2
" 02";"MACARENA";"VILLANUEVA DEL ARISCAL";"ESPAÑOLES";1;7;8
" 02";"MACARENA";"VILLANUEVA DEL ARISCAL";"EXTRANJEROS";1;1;2
" 02";"MACARENA";"VILLANUEVA DEL ARISCAL";"TOTAL POBLACION";2;8;10
" 02";"MACARENA";"VILLANUEVA DEL RIO Y MINAS";"ESPAÑOLES";3;1;4
" 02";"MACARENA";"VILLANUEVA DEL RIO Y MINAS";"EXTRANJEROS";0;1;1
" 02";"MACARENA";"VILLANUEVA DEL RIO Y MINAS";"TOTAL POBLACION";3;2;5
" 02";"MACARENA";"VILLAVERDE DEL RIO";"ESPAÑOLES";0;1;1
" 02";"MACARENA";"VILLAVERDE DEL RIO";"TOTAL POBLACION";0;1;1
" 02";"MACARENA";"VISO DEL ALCOR (EL)";"ESPAÑOLES";3;3;6
" 02";"MACARENA";"VISO DEL ALCOR (EL)";"TOTAL POBLACION";3;3;6
" 03";"NERVION";"- FUERA DE LA PROVINCIA DE SEVILLA";"ESPAÑOLES";327;316;643
" 03";"NERVION";"- FUERA DE LA PROVINCIA DE SEVILLA";"EXTRANJEROS";60;61;121
" 03";"NERVION";"- FUERA DE LA PROVINCIA DE SEVILLA";"TOTAL POBLACION";387;377;764
" 03";"NERVION";"- PROVINCIA DE SEVILLA";"ESPAÑOLES";198;197;395
" 03";"NERVION";"- PROVINCIA DE SEVILLA";"EXTRANJEROS";13;23;36
" 03";"NERVION";"- PROVINCIA DE SEVILLA";"TOTAL POBLACION";211;220;431
" 03";"NERVION";"ALANIS";"ESPAÑOLES";1;0;1
" 03";"NERVION";"ALANIS";"TOTAL POBLACION";1;0;1
" 03";"NERVION";"ALCALA DE GUADAIRA";"ESPAÑOLES";8;10;18
" 03";"NERVION";"ALCALA DE GUADAIRA";"EXTRANJEROS";1;2;3
" 03";"NERVION";"ALCALA DE GUADAIRA";"TOTAL POBLACION";9;12;21
" 03";"NERVION";"ALCALA DEL RIO";"ESPAÑOLES";2;0;2
" 03";"NERVION";"ALCALA DEL RIO";"TOTAL POBLACION";2;0;2
" 03";"NERVION";"ALGABA (LA)";"ESPAÑOLES";2;4;6
" 03";"NERVION";"ALGABA (LA)";"EXTRANJEROS";0;1;1
" 03";"NERVION";"ALGABA (LA)";"TOTAL POBLACION";2;5;7
" 03";"NERVION";"ALMADEN DE LA PLATA";"ESPAÑOLES";0;1;1
" 03";"NERVION";"ALMADEN DE LA PLATA";"TOTAL POBLACION";0;1;1
" 03";"NERVION";"ALMENSILLA";"ESPAÑOLES";1;1;2
" 03";"NERVION";"ALMENSILLA";"TOTAL POBLACION";1;1;2
" 03";"NERVION";"ARAHAL (EL)";"ESPAÑOLES";1;4;5
" 03";"NERVION";"ARAHAL (EL)";"TOTAL POBLACION";1;4;5
" 03";"NERVION";"AZNALCAZAR";"ESPAÑOLES";2;0;2
" 03";"NERVION";"AZNALCAZAR";"EXTRANJEROS";0;1;1
" 03";"NERVION";"AZNALCAZAR";"TOTAL POBLACION";2;1;3
" 03";"NERVION";"BOLLULLOS DE LA MITACION";"ESPAÑOLES";3;3;6
" 03";"NERVION";"BOLLULLOS DE LA MITACION";"EXTRANJEROS";1;1;2
" 03";"NERVION";"BOLLULLOS DE LA MITACION";"TOTAL POBLACION";4;4;8
" 03";"NERVION";"BORMUJOS";"ESPAÑOLES";4;8;12
" 03";"NERVION";"BORMUJOS";"EXTRANJEROS";3;0;3
" 03";"NERVION";"BORMUJOS";"TOTAL POBLACION";7;8;15
" 03";"NERVION";"BRENES";"ESPAÑOLES";1;0;1
" 03";"NERVION";"BRENES";"EXTRANJEROS";0;2;2
" 03";"NERVION";"BRENES";"TOTAL POBLACION";1;2;3
" 03";"NERVION";"BURGUILLOS";"ESPAÑOLES";0;1;1
" 03";"NERVION";"BURGUILLOS";"TOTAL POBLACION";0;1;1
" 03";"NERVION";"CAMAS";"ESPAÑOLES";10;5;15
" 03";"NERVION";"CAMAS";"TOTAL POBLACION";10;5;15
" 03";"NERVION";"CAMPANA (LA)";"ESPAÑOLES";1;0;1
" 03";"NERVION";"CAMPANA (LA)";"TOTAL POBLACION";1;0;1
" 03";"NERVION";"CANTILLANA";"ESPAÑOLES";0;1;1
" 03";"NERVION";"CANTILLANA";"TOTAL POBLACION";0;1;1
" 03";"NERVION";"CARMONA";"ESPAÑOLES";9;8;17
" 03";"NERVION";"CARMONA";"TOTAL POBLACION";9;8;17
" 03";"NERVION";"CASTILBLANCO DE LOS ARROYOS";"ESPAÑOLES";1;1;2
" 03";"NERVION";"CASTILBLANCO DE LOS ARROYOS";"TOTAL POBLACION";1;1;2
" 03";"NERVION";"CASTILLEJA DE GUZMAN";"ESPAÑOLES";3;2;5
" 03";"NERVION";"CASTILLEJA DE GUZMAN";"TOTAL POBLACION";3;2;5
" 03";"NERVION";"CASTILLEJA DE LA CUESTA";"ESPAÑOLES";4;4;8
" 03";"NERVION";"CASTILLEJA DE LA CUESTA";"TOTAL POBLACION";4;4;8
" 03";"NERVION";"CASTILLO DE LAS GUARDAS (EL)";"ESPAÑOLES";0;1;1
" 03";"NERVION";"CASTILLO DE LAS GUARDAS (EL)";"TOTAL POBLACION";0;1;1
" 03";"NERVION";"CONSTANTINA";"ESPAÑOLES";1;1;2
" 03";"NERVION";"CONSTANTINA";"TOTAL POBLACION";1;1;2
" 03";"NERVION";"CORIA DEL RIO";"ESPAÑOLES";1;0;1
" 03";"NERVION";"CORIA DEL RIO";"TOTAL POBLACION";1;0;1
" 03";"NERVION";"CORONIL (EL)";"ESPAÑOLES";2;1;3
" 03";"NERVION";"CORONIL (EL)";"EXTRANJEROS";0;1;1
" 03";"NERVION";"CORONIL (EL)";"TOTAL POBLACION";2;2;4
" 03";"NERVION";"DOS HERMANAS";"ESPAÑOLES";30;40;70
" 03";"NERVION";"DOS HERMANAS";"EXTRANJEROS";3;4;7
" 03";"NERVION";"DOS HERMANAS";"TOTAL POBLACION";33;44;77
" 03";"NERVION";"ESPARTINAS";"ESPAÑOLES";7;2;9
" 03";"NERVION";"ESPARTINAS";"TOTAL POBLACION";7;2;9
" 03";"NERVION";"ESTEPA";"ESPAÑOLES";1;1;2
" 03";"NERVION";"ESTEPA";"TOTAL POBLACION";1;1;2
" 03";"NERVION";"GELVES";"ESPAÑOLES";2;2;4
" 03";"NERVION";"GELVES";"TOTAL POBLACION";2;2;4
" 03";"NERVION";"GERENA";"ESPAÑOLES";2;0;2
" 03";"NERVION";"GERENA";"TOTAL POBLACION";2;0;2
" 03";"NERVION";"GINES";"ESPAÑOLES";3;7;10
" 03";"NERVION";"GINES";"TOTAL POBLACION";3;7;10
" 03";"NERVION";"GUADALCANAL";"ESPAÑOLES";1;0;1
" 03";"NERVION";"GUADALCANAL";"TOTAL POBLACION";1;0;1
" 03";"NERVION";"GUILLENA";"ESPAÑOLES";3;5;8
" 03";"NERVION";"GUILLENA";"TOTAL POBLACION";3;5;8
" 03";"NERVION";"LEBRIJA";"ESPAÑOLES";1;0;1
" 03";"NERVION";"LEBRIJA";"TOTAL POBLACION";1;0;1
" 03";"NERVION";"LUISIANA (LA)";"ESPAÑOLES";1;0;1
" 03";"NERVION";"LUISIANA (LA)";"TOTAL POBLACION";1;0;1
" 03";"NERVION";"MAIRENA DEL ALCOR";"ESPAÑOLES";1;0;1
" 03";"NERVION";"MAIRENA DEL ALCOR";"TOTAL POBLACION";1;0;1
" 03";"NERVION";"MAIRENA DEL ALJARAFE";"ESPAÑOLES";27;19;46
" 03";"NERVION";"MAIRENA DEL ALJARAFE";"EXTRANJEROS";3;4;7
" 03";"NERVION";"MAIRENA DEL ALJARAFE";"TOTAL POBLACION";30;23;53
" 03";"NERVION";"MARCHENA";"ESPAÑOLES";1;1;2
" 03";"NERVION";"MARCHENA";"EXTRANJEROS";1;0;1
" 03";"NERVION";"MARCHENA";"TOTAL POBLACION";2;1;3
" 03";"NERVION";"MOLARES (LOS)";"ESPAÑOLES";1;0;1
" 03";"NERVION";"MOLARES (LOS)";"TOTAL POBLACION";1;0;1
" 03";"NERVION";"MONTELLANO";"ESPAÑOLES";1;1;2
" 03";"NERVION";"MONTELLANO";"TOTAL POBLACION";1;1;2
" 03";"NERVION";"MORON DE LA FRONTERA";"ESPAÑOLES";1;5;6
" 03";"NERVION";"MORON DE LA FRONTERA";"EXTRANJEROS";1;0;1
" 03";"NERVION";"MORON DE LA FRONTERA";"TOTAL POBLACION";2;5;7
" 03";"NERVION";"OLIVARES";"ESPAÑOLES";0;4;4
" 03";"NERVION";"OLIVARES";"TOTAL POBLACION";0;4;4
" 03";"NERVION";"OSUNA";"ESPAÑOLES";2;0;2
" 03";"NERVION";"OSUNA";"TOTAL POBLACION";2;0;2
" 03";"NERVION";"PALACIOS Y VILLAFRANCA (LOS)";"ESPAÑOLES";3;3;6
" 03";"NERVION";"PALACIOS Y VILLAFRANCA (LOS)";"TOTAL POBLACION";3;3;6
" 03";"NERVION";"PALOMARES DEL RIO";"ESPAÑOLES";3;1;4
" 03";"NERVION";"PALOMARES DEL RIO";"TOTAL POBLACION";3;1;4
" 03";"NERVION";"PARADAS";"ESPAÑOLES";0;2;2
" 03";"NERVION";"PARADAS";"TOTAL POBLACION";0;2;2
" 03";"NERVION";"PILAS";"ESPAÑOLES";0;1;1
" 03";"NERVION";"PILAS";"EXTRANJEROS";0;1;1
" 03";"NERVION";"PILAS";"TOTAL POBLACION";0;2;2
" 03";"NERVION";"PUEBLA DE CAZALLA (LA)";"ESPAÑOLES";0;2;2
" 03";"NERVION";"PUEBLA DE CAZALLA (LA)";"TOTAL POBLACION";0;2;2
" 03";"NERVION";"PUEBLA DEL RIO (LA)";"ESPAÑOLES";0;1;1
" 03";"NERVION";"PUEBLA DEL RIO (LA)";"TOTAL POBLACION";0;1;1
" 03";"NERVION";"RINCONADA (LA)";"ESPAÑOLES";7;8;15
" 03";"NERVION";"RINCONADA (LA)";"EXTRANJEROS";0;1;1
" 03";"NERVION";"RINCONADA (LA)";"TOTAL POBLACION";7;9;16
" 03";"NERVION";"SALTERAS";"ESPAÑOLES";3;2;5
" 03";"NERVION";"SALTERAS";"EXTRANJEROS";0;1;1
" 03";"NERVION";"SALTERAS";"TOTAL POBLACION";3;3;6
" 03";"NERVION";"SAN JUAN DE AZNALFARACHE";"ESPAÑOLES";3;4;7
" 03";"NERVION";"SAN JUAN DE AZNALFARACHE";"EXTRANJEROS";0;2;2
" 03";"NERVION";"SAN JUAN DE AZNALFARACHE";"TOTAL POBLACION";3;6;9
" 03";"NERVION";"SANLUCAR LA MAYOR";"ESPAÑOLES";2;2;4
" 03";"NERVION";"SANLUCAR LA MAYOR";"TOTAL POBLACION";2;2;4
" 03";"NERVION";"SANTIPONCE";"ESPAÑOLES";4;0;4
" 03";"NERVION";"SANTIPONCE";"TOTAL POBLACION";4;0;4
" 03";"NERVION";"TOCINA";"ESPAÑOLES";4;3;7
" 03";"NERVION";"TOCINA";"TOTAL POBLACION";4;3;7
" 03";"NERVION";"TOMARES";"ESPAÑOLES";15;10;25
" 03";"NERVION";"TOMARES";"EXTRANJEROS";0;1;1
" 03";"NERVION";"TOMARES";"TOTAL POBLACION";15;11;26
" 03";"NERVION";"UMBRETE";"ESPAÑOLES";5;4;9
" 03";"NERVION";"UMBRETE";"TOTAL POBLACION";5;4;9
" 03";"NERVION";"UTRERA";"ESPAÑOLES";1;1;2
" 03";"NERVION";"UTRERA";"TOTAL POBLACION";1;1;2
" 03";"NERVION";"VALENCINA DE LA CONCEPCION";"ESPAÑOLES";3;7;10
" 03";"NERVION";"VALENCINA DE LA CONCEPCION";"TOTAL POBLACION";3;7;10
" 03";"NERVION";"VILLANUEVA DEL ARISCAL";"ESPAÑOLES";1;2;3
" 03";"NERVION";"VILLANUEVA DEL ARISCAL";"TOTAL POBLACION";1;2;3
" 03";"NERVION";"VILLAVERDE DEL RIO";"ESPAÑOLES";1;0;1
" 03";"NERVION";"VILLAVERDE DEL RIO";"TOTAL POBLACION";1;0;1
" 03";"NERVION";"VISO DEL ALCOR (EL)";"ESPAÑOLES";1;1;2
" 03";"NERVION";"VISO DEL ALCOR (EL)";"EXTRANJEROS";0;1;1
" 03";"NERVION";"VISO DEL ALCOR (EL)";"TOTAL POBLACION";1;2;3
" 04";"CERRO-AMATE";"- FUERA DE LA PROVINCIA DE SEVILLA";"ESPAÑOLES";334;360;694
" 04";"CERRO-AMATE";"- FUERA DE LA PROVINCIA DE SEVILLA";"EXTRANJEROS";234;235;469
" 04";"CERRO-AMATE";"- FUERA DE LA PROVINCIA DE SEVILLA";"NO CONSTA";1;0;1
" 04";"CERRO-AMATE";"- FUERA DE LA PROVINCIA DE SEVILLA";"TOTAL POBLACION";569;595;1164
" 04";"CERRO-AMATE";"- PROVINCIA DE SEVILLA";"ESPAÑOLES";495;497;992
" 04";"CERRO-AMATE";"- PROVINCIA DE SEVILLA";"EXTRANJEROS";84;113;197
" 04";"CERRO-AMATE";"- PROVINCIA DE SEVILLA";"TOTAL POBLACION";579;610;1189
" 04";"CERRO-AMATE";"AGUADULCE";"ESPAÑOLES";1;0;1
" 04";"CERRO-AMATE";"AGUADULCE";"TOTAL POBLACION";1;0;1
" 04";"CERRO-AMATE";"ALANIS";"EXTRANJEROS";1;0;1
" 04";"CERRO-AMATE";"ALANIS";"TOTAL POBLACION";1;0;1
" 04";"CERRO-AMATE";"ALCALA DE GUADAIRA";"ESPAÑOLES";63;58;121
" 04";"CERRO-AMATE";"ALCALA DE GUADAIRA";"EXTRANJEROS";11;12;23
" 04";"CERRO-AMATE";"ALCALA DE GUADAIRA";"TOTAL POBLACION";74;70;144
" 04";"CERRO-AMATE";"ALCALA DEL RIO";"ESPAÑOLES";7;2;9
" 04";"CERRO-AMATE";"ALCALA DEL RIO";"EXTRANJEROS";1;2;3
" 04";"CERRO-AMATE";"ALCALA DEL RIO";"TOTAL POBLACION";8;4;12
" 04";"CERRO-AMATE";"ALGABA (LA)";"ESPAÑOLES";8;13;21
" 04";"CERRO-AMATE";"ALGABA (LA)";"EXTRANJEROS";0;1;1
" 04";"CERRO-AMATE";"ALGABA (LA)";"TOTAL POBLACION";8;14;22
" 04";"CERRO-AMATE";"ALMADEN DE LA PLATA";"ESPAÑOLES";0;2;2
" 04";"CERRO-AMATE";"ALMADEN DE LA PLATA";"TOTAL POBLACION";0;2;2
" 04";"CERRO-AMATE";"ALMENSILLA";"ESPAÑOLES";3;3;6
" 04";"CERRO-AMATE";"ALMENSILLA";"EXTRANJEROS";3;1;4
" 04";"CERRO-AMATE";"ALMENSILLA";"TOTAL POBLACION";6;4;10
" 04";"CERRO-AMATE";"ARAHAL (EL)";"ESPAÑOLES";5;4;9
" 04";"CERRO-AMATE";"ARAHAL (EL)";"TOTAL POBLACION";5;4;9
" 04";"CERRO-AMATE";"AZNALCAZAR";"ESPAÑOLES";0;1;1
" 04";"CERRO-AMATE";"AZNALCAZAR";"EXTRANJEROS";1;2;3
" 04";"CERRO-AMATE";"AZNALCAZAR";"TOTAL POBLACION";1;3;4
" 04";"CERRO-AMATE";"AZNALCOLLAR";"ESPAÑOLES";1;3;4
" 04";"CERRO-AMATE";"AZNALCOLLAR";"TOTAL POBLACION";1;3;4
" 04";"CERRO-AMATE";"BOLLULLOS DE LA MITACION";"ESPAÑOLES";7;6;13
" 04";"CERRO-AMATE";"BOLLULLOS DE LA MITACION";"EXTRANJEROS";1;2;3
" 04";"CERRO-AMATE";"BOLLULLOS DE LA MITACION";"TOTAL POBLACION";8;8;16
" 04";"CERRO-AMATE";"BORMUJOS";"ESPAÑOLES";13;11;24
" 04";"CERRO-AMATE";"BORMUJOS";"EXTRANJEROS";1;1;2
" 04";"CERRO-AMATE";"BORMUJOS";"TOTAL POBLACION";14;12;26
" 04";"CERRO-AMATE";"BRENES";"ESPAÑOLES";7;8;15
" 04";"CERRO-AMATE";"BRENES";"EXTRANJEROS";0;2;2
" 04";"CERRO-AMATE";"BRENES";"TOTAL POBLACION";7;10;17
" 04";"CERRO-AMATE";"BURGUILLOS";"ESPAÑOLES";4;6;10
" 04";"CERRO-AMATE";"BURGUILLOS";"EXTRANJEROS";1;0;1
" 04";"CERRO-AMATE";"BURGUILLOS";"TOTAL POBLACION";5;6;11
" 04";"CERRO-AMATE";"CABEZAS DE SAN JUAN (LAS)";"ESPAÑOLES";2;4;6
" 04";"CERRO-AMATE";"CABEZAS DE SAN JUAN (LAS)";"EXTRANJEROS";0;1;1
" 04";"CERRO-AMATE";"CABEZAS DE SAN JUAN (LAS)";"TOTAL POBLACION";2;5;7
" 04";"CERRO-AMATE";"CAMAS";"ESPAÑOLES";10;8;18
" 04";"CERRO-AMATE";"CAMAS";"EXTRANJEROS";6;4;10
" 04";"CERRO-AMATE";"CAMAS";"TOTAL POBLACION";16;12;28
" 04";"CERRO-AMATE";"CAMPANA (LA)";"ESPAÑOLES";0;1;1
" 04";"CERRO-AMATE";"CAMPANA (LA)";"EXTRANJEROS";1;1;2
" 04";"CERRO-AMATE";"CAMPANA (LA)";"TOTAL POBLACION";1;2;3
" 04";"CERRO-AMATE";"CANTILLANA";"ESPAÑOLES";2;1;3
" 04";"CERRO-AMATE";"CANTILLANA";"EXTRANJEROS";1;2;3
" 04";"CERRO-AMATE";"CANTILLANA";"TOTAL POBLACION";3;3;6
" 04";"CERRO-AMATE";"CARMONA";"ESPAÑOLES";28;20;48
" 04";"CERRO-AMATE";"CARMONA";"EXTRANJEROS";6;5;11
" 04";"CERRO-AMATE";"CARMONA";"TOTAL POBLACION";34;25;59
" 04";"CERRO-AMATE";"CASTILBLANCO DE LOS ARROYOS";"ESPAÑOLES";3;3;6
" 04";"CERRO-AMATE";"CASTILBLANCO DE LOS ARROYOS";"TOTAL POBLACION";3;3;6
" 04";"CERRO-AMATE";"CASTILLEJA DE GUZMAN";"ESPAÑOLES";1;0;1
" 04";"CERRO-AMATE";"CASTILLEJA DE GUZMAN";"TOTAL POBLACION";1;0;1
" 04";"CERRO-AMATE";"CASTILLEJA DE LA CUESTA";"ESPAÑOLES";6;8;14
" 04";"CERRO-AMATE";"CASTILLEJA DE LA CUESTA";"EXTRANJEROS";2;2;4
" 04";"CERRO-AMATE";"CASTILLEJA DE LA CUESTA";"TOTAL POBLACION";8;10;18
" 04";"CERRO-AMATE";"CASTILLEJA DEL CAMPO";"ESPAÑOLES";0;1;1
" 04";"CERRO-AMATE";"CASTILLEJA DEL CAMPO";"TOTAL POBLACION";0;1;1
" 04";"CERRO-AMATE";"CASTILLO DE LAS GUARDAS (EL)";"ESPAÑOLES";0;2;2
" 04";"CERRO-AMATE";"CASTILLO DE LAS GUARDAS (EL)";"TOTAL POBLACION";0;2;2
" 04";"CERRO-AMATE";"CAZALLA DE LA SIERRA";"ESPAÑOLES";2;1;3
" 04";"CERRO-AMATE";"CAZALLA DE LA SIERRA";"TOTAL POBLACION";2;1;3
" 04";"CERRO-AMATE";"CONSTANTINA";"ESPAÑOLES";0;2;2
" 04";"CERRO-AMATE";"CONSTANTINA";"TOTAL POBLACION";0;2;2
" 04";"CERRO-AMATE";"CORIA DEL RIO";"ESPAÑOLES";18;12;30
" 04";"CERRO-AMATE";"CORIA DEL RIO";"EXTRANJEROS";1;6;7
" 04";"CERRO-AMATE";"CORIA DEL RIO";"TOTAL POBLACION";19;18;37
" 04";"CERRO-AMATE";"CORONIL (EL)";"ESPAÑOLES";2;1;3
" 04";"CERRO-AMATE";"CORONIL (EL)";"EXTRANJEROS";1;1;2
" 04";"CERRO-AMATE";"CORONIL (EL)";"TOTAL POBLACION";3;2;5
" 04";"CERRO-AMATE";"DOS HERMANAS";"ESPAÑOLES";99;119;218
" 04";"CERRO-AMATE";"DOS HERMANAS";"EXTRANJEROS";10;19;29
" 04";"CERRO-AMATE";"DOS HERMANAS";"TOTAL POBLACION";109;138;247
" 04";"CERRO-AMATE";"ECIJA";"EXTRANJEROS";3;3;6
" 04";"CERRO-AMATE";"ECIJA";"TOTAL POBLACION";3;3;6
" 04";"CERRO-AMATE";"ESPARTINAS";"ESPAÑOLES";6;6;12
" 04";"CERRO-AMATE";"ESPARTINAS";"EXTRANJEROS";0;1;1
" 04";"CERRO-AMATE";"ESPARTINAS";"TOTAL POBLACION";6;7;13
" 04";"CERRO-AMATE";"FUENTES DE ANDALUCIA";"ESPAÑOLES";0;1;1
" 04";"CERRO-AMATE";"FUENTES DE ANDALUCIA";"EXTRANJEROS";1;0;1
" 04";"CERRO-AMATE";"FUENTES DE ANDALUCIA";"TOTAL POBLACION";1;1;2
" 04";"CERRO-AMATE";"GARROBO (EL)";"ESPAÑOLES";1;1;2
" 04";"CERRO-AMATE";"GARROBO (EL)";"TOTAL POBLACION";1;1;2
" 04";"CERRO-AMATE";"GELVES";"ESPAÑOLES";6;8;14
" 04";"CERRO-AMATE";"GELVES";"TOTAL POBLACION";6;8;14
" 04";"CERRO-AMATE";"GERENA";"ESPAÑOLES";4;9;13
" 04";"CERRO-AMATE";"GERENA";"TOTAL POBLACION";4;9;13
" 04";"CERRO-AMATE";"GINES";"ESPAÑOLES";3;4;7
" 04";"CERRO-AMATE";"GINES";"EXTRANJEROS";1;0;1
" 04";"CERRO-AMATE";"GINES";"TOTAL POBLACION";4;4;8
" 04";"CERRO-AMATE";"GUILLENA";"ESPAÑOLES";12;10;22
" 04";"CERRO-AMATE";"GUILLENA";"TOTAL POBLACION";12;10;22
" 04";"CERRO-AMATE";"HUEVAR DEL ALJARAFE";"ESPAÑOLES";1;0;1
" 04";"CERRO-AMATE";"HUEVAR DEL ALJARAFE";"TOTAL POBLACION";1;0;1
" 04";"CERRO-AMATE";"ISLA MAYOR";"ESPAÑOLES";1;0;1
" 04";"CERRO-AMATE";"ISLA MAYOR";"TOTAL POBLACION";1;0;1
" 04";"CERRO-AMATE";"LEBRIJA";"ESPAÑOLES";2;0;2
" 04";"CERRO-AMATE";"LEBRIJA";"EXTRANJEROS";1;1;2
" 04";"CERRO-AMATE";"LEBRIJA";"TOTAL POBLACION";3;1;4
" 04";"CERRO-AMATE";"LORA DE ESTEPA";"ESPAÑOLES";0;1;1
" 04";"CERRO-AMATE";"LORA DE ESTEPA";"TOTAL POBLACION";0;1;1
" 04";"CERRO-AMATE";"LORA DEL RIO";"ESPAÑOLES";5;2;7
" 04";"CERRO-AMATE";"LORA DEL RIO";"TOTAL POBLACION";5;2;7
" 04";"CERRO-AMATE";"LUISIANA (LA)";"ESPAÑOLES";1;0;1
" 04";"CERRO-AMATE";"LUISIANA (LA)";"TOTAL POBLACION";1;0;1
" 04";"CERRO-AMATE";"MAIRENA DEL ALCOR";"ESPAÑOLES";19;8;27
" 04";"CERRO-AMATE";"MAIRENA DEL ALCOR";"EXTRANJEROS";1;1;2
" 04";"CERRO-AMATE";"MAIRENA DEL ALCOR";"TOTAL POBLACION";20;9;29
" 04";"CERRO-AMATE";"MAIRENA DEL ALJARAFE";"ESPAÑOLES";16;23;39
" 04";"CERRO-AMATE";"MAIRENA DEL ALJARAFE";"EXTRANJEROS";2;7;9
" 04";"CERRO-AMATE";"MAIRENA DEL ALJARAFE";"TOTAL POBLACION";18;30;48
" 04";"CERRO-AMATE";"MARCHENA";"ESPAÑOLES";1;0;1
" 04";"CERRO-AMATE";"MARCHENA";"EXTRANJEROS";1;0;1
" 04";"CERRO-AMATE";"MARCHENA";"TOTAL POBLACION";2;0;2
" 04";"CERRO-AMATE";"MARINALEDA";"ESPAÑOLES";0;1;1
" 04";"CERRO-AMATE";"MARINALEDA";"TOTAL POBLACION";0;1;1
" 04";"CERRO-AMATE";"MARTIN DE LA JARA";"ESPAÑOLES";0;1;1
" 04";"CERRO-AMATE";"MARTIN DE LA JARA";"TOTAL POBLACION";0;1;1
" 04";"CERRO-AMATE";"MONTELLANO";"ESPAÑOLES";2;2;4
" 04";"CERRO-AMATE";"MONTELLANO";"TOTAL POBLACION";2;2;4
" 04";"CERRO-AMATE";"MORON DE LA FRONTERA";"ESPAÑOLES";3;2;5
" 04";"CERRO-AMATE";"MORON DE LA FRONTERA";"EXTRANJEROS";4;4;8
" 04";"CERRO-AMATE";"MORON DE LA FRONTERA";"TOTAL POBLACION";7;6;13
" 04";"CERRO-AMATE";"OLIVARES";"ESPAÑOLES";2;1;3
" 04";"CERRO-AMATE";"OLIVARES";"TOTAL POBLACION";2;1;3
" 04";"CERRO-AMATE";"OSUNA";"ESPAÑOLES";3;2;5
" 04";"CERRO-AMATE";"OSUNA";"EXTRANJEROS";1;0;1
" 04";"CERRO-AMATE";"OSUNA";"TOTAL POBLACION";4;2;6
" 04";"CERRO-AMATE";"PALACIOS Y VILLAFRANCA (LOS)";"ESPAÑOLES";2;4;6
" 04";"CERRO-AMATE";"PALACIOS Y VILLAFRANCA (LOS)";"EXTRANJEROS";1;1;2
" 04";"CERRO-AMATE";"PALACIOS Y VILLAFRANCA (LOS)";"TOTAL POBLACION";3;5;8
" 04";"CERRO-AMATE";"PALOMARES DEL RIO";"ESPAÑOLES";3;1;4
" 04";"CERRO-AMATE";"PALOMARES DEL RIO";"TOTAL POBLACION";3;1;4
" 04";"CERRO-AMATE";"PARADAS";"ESPAÑOLES";1;0;1
" 04";"CERRO-AMATE";"PARADAS";"EXTRANJEROS";1;0;1
" 04";"CERRO-AMATE";"PARADAS";"TOTAL POBLACION";2;0;2
" 04";"CERRO-AMATE";"PEDROSO (EL)";"ESPAÑOLES";1;1;2
" 04";"CERRO-AMATE";"PEDROSO (EL)";"TOTAL POBLACION";1;1;2
" 04";"CERRO-AMATE";"PILAS";"ESPAÑOLES";3;4;7
" 04";"CERRO-AMATE";"PILAS";"EXTRANJEROS";3;5;8
" 04";"CERRO-AMATE";"PILAS";"TOTAL POBLACION";6;9;15
" 04";"CERRO-AMATE";"PRUNA";"ESPAÑOLES";1;0;1
" 04";"CERRO-AMATE";"PRUNA";"TOTAL POBLACION";1;0;1
" 04";"CERRO-AMATE";"PUEBLA DE CAZALLA (LA)";"ESPAÑOLES";4;1;5
" 04";"CERRO-AMATE";"PUEBLA DE CAZALLA (LA)";"TOTAL POBLACION";4;1;5
" 04";"CERRO-AMATE";"PUEBLA DEL RIO (LA)";"ESPAÑOLES";2;0;2
" 04";"CERRO-AMATE";"PUEBLA DEL RIO (LA)";"EXTRANJEROS";0;1;1
" 04";"CERRO-AMATE";"PUEBLA DEL RIO (LA)";"TOTAL POBLACION";2;1;3
" 04";"CERRO-AMATE";"REAL DE LA JARA (EL)";"ESPAÑOLES";1;1;2
" 04";"CERRO-AMATE";"REAL DE LA JARA (EL)";"TOTAL POBLACION";1;1;2
" 04";"CERRO-AMATE";"RINCONADA (LA)";"ESPAÑOLES";31;24;55
" 04";"CERRO-AMATE";"RINCONADA (LA)";"EXTRANJEROS";6;3;9
" 04";"CERRO-AMATE";"RINCONADA (LA)";"TOTAL POBLACION";37;27;64
" 04";"CERRO-AMATE";"RONQUILLO (EL)";"ESPAÑOLES";2;4;6
" 04";"CERRO-AMATE";"RONQUILLO (EL)";"TOTAL POBLACION";2;4;6
" 04";"CERRO-AMATE";"RUBIO (EL)";"ESPAÑOLES";1;0;1
" 04";"CERRO-AMATE";"RUBIO (EL)";"TOTAL POBLACION";1;0;1
" 04";"CERRO-AMATE";"SALTERAS";"ESPAÑOLES";4;3;7
" 04";"CERRO-AMATE";"SALTERAS";"EXTRANJEROS";1;1;2
" 04";"CERRO-AMATE";"SALTERAS";"TOTAL POBLACION";5;4;9
" 04";"CERRO-AMATE";"SAN JUAN DE AZNALFARACHE";"ESPAÑOLES";15;13;28
" 04";"CERRO-AMATE";"SAN JUAN DE AZNALFARACHE";"EXTRANJEROS";5;14;19
" 04";"CERRO-AMATE";"SAN JUAN DE AZNALFARACHE";"TOTAL POBLACION";20;27;47
" 04";"CERRO-AMATE";"SANLUCAR LA MAYOR";"ESPAÑOLES";4;5;9
" 04";"CERRO-AMATE";"SANLUCAR LA MAYOR";"EXTRANJEROS";0;3;3
" 04";"CERRO-AMATE";"SANLUCAR LA MAYOR";"TOTAL POBLACION";4;8;12
" 04";"CERRO-AMATE";"SANTIPONCE";"ESPAÑOLES";0;4;4
" 04";"CERRO-AMATE";"SANTIPONCE";"TOTAL POBLACION";0;4;4
" 04";"CERRO-AMATE";"TOCINA";"ESPAÑOLES";1;1;2
" 04";"CERRO-AMATE";"TOCINA";"EXTRANJEROS";0;1;1
" 04";"CERRO-AMATE";"TOCINA";"TOTAL POBLACION";1;2;3
" 04";"CERRO-AMATE";"TOMARES";"ESPAÑOLES";5;3;8
" 04";"CERRO-AMATE";"TOMARES";"EXTRANJEROS";1;1;2
" 04";"CERRO-AMATE";"TOMARES";"TOTAL POBLACION";6;4;10
" 04";"CERRO-AMATE";"UMBRETE";"ESPAÑOLES";4;3;7
" 04";"CERRO-AMATE";"UMBRETE";"TOTAL POBLACION";4;3;7
" 04";"CERRO-AMATE";"UTRERA";"ESPAÑOLES";20;25;45
" 04";"CERRO-AMATE";"UTRERA";"EXTRANJEROS";2;0;2
" 04";"CERRO-AMATE";"UTRERA";"TOTAL POBLACION";22;25;47
" 04";"CERRO-AMATE";"VALENCINA DE LA CONCEPCION";"ESPAÑOLES";2;4;6
" 04";"CERRO-AMATE";"VALENCINA DE LA CONCEPCION";"EXTRANJEROS";0;1;1
" 04";"CERRO-AMATE";"VALENCINA DE LA CONCEPCION";"TOTAL POBLACION";2;5;7
" 04";"CERRO-AMATE";"VILLAMANRIQUE DE LA CONDESA";"EXTRANJEROS";1;0;1
" 04";"CERRO-AMATE";"VILLAMANRIQUE DE LA CONDESA";"TOTAL POBLACION";1;0;1
" 04";"CERRO-AMATE";"VILLANUEVA DEL ARISCAL";"ESPAÑOLES";0;3;3
" 04";"CERRO-AMATE";"VILLANUEVA DEL ARISCAL";"EXTRANJEROS";0;1;1
" 04";"CERRO-AMATE";"VILLANUEVA DEL ARISCAL";"TOTAL POBLACION";0;4;4
" 04";"CERRO-AMATE";"VILLANUEVA DEL RIO Y MINAS";"ESPAÑOLES";3;3;6
" 04";"CERRO-AMATE";"VILLANUEVA DEL RIO Y MINAS";"TOTAL POBLACION";3;3;6
" 04";"CERRO-AMATE";"VILLAVERDE DEL RIO";"ESPAÑOLES";2;4;6
" 04";"CERRO-AMATE";"VILLAVERDE DEL RIO";"TOTAL POBLACION";2;4;6
" 04";"CERRO-AMATE";"VISO DEL ALCOR (EL)";"ESPAÑOLES";3;4;7
" 04";"CERRO-AMATE";"VISO DEL ALCOR (EL)";"TOTAL POBLACION";3;4;7
" 05";"SUR";"- FUERA DE LA PROVINCIA DE SEVILLA";"ESPAÑOLES";392;421;813
" 05";"SUR";"- FUERA DE LA PROVINCIA DE SEVILLA";"EXTRANJEROS";105;118;223
" 05";"SUR";"- FUERA DE LA PROVINCIA DE SEVILLA";"TOTAL POBLACION";497;539;1036
" 05";"SUR";"- PROVINCIA DE SEVILLA";"ESPAÑOLES";381;394;775
" 05";"SUR";"- PROVINCIA DE SEVILLA";"EXTRANJEROS";33;58;91
" 05";"SUR";"- PROVINCIA DE SEVILLA";"TOTAL POBLACION";414;452;866
" 05";"SUR";"ALANIS";"ESPAÑOLES";2;2;4
" 05";"SUR";"ALANIS";"TOTAL POBLACION";2;2;4
" 05";"SUR";"ALCALA DE GUADAIRA";"ESPAÑOLES";24;24;48
" 05";"SUR";"ALCALA DE GUADAIRA";"EXTRANJEROS";3;5;8
" 05";"SUR";"ALCALA DE GUADAIRA";"TOTAL POBLACION";27;29;56
" 05";"SUR";"ALCALA DEL RIO";"ESPAÑOLES";3;3;6
" 05";"SUR";"ALCALA DEL RIO";"EXTRANJEROS";1;2;3
" 05";"SUR";"ALCALA DEL RIO";"TOTAL POBLACION";4;5;9
" 05";"SUR";"ALCOLEA DEL RIO";"ESPAÑOLES";0;1;1
" 05";"SUR";"ALCOLEA DEL RIO";"TOTAL POBLACION";0;1;1
" 05";"SUR";"ALGABA (LA)";"ESPAÑOLES";5;5;10
" 05";"SUR";"ALGABA (LA)";"EXTRANJEROS";0;1;1
" 05";"SUR";"ALGABA (LA)";"TOTAL POBLACION";5;6;11
" 05";"SUR";"ALGAMITAS";"ESPAÑOLES";1;0;1
" 05";"SUR";"ALGAMITAS";"TOTAL POBLACION";1;0;1
" 05";"SUR";"ALMADEN DE LA PLATA";"ESPAÑOLES";1;0;1
" 05";"SUR";"ALMADEN DE LA PLATA";"TOTAL POBLACION";1;0;1
" 05";"SUR";"ALMENSILLA";"ESPAÑOLES";5;3;8
" 05";"SUR";"ALMENSILLA";"TOTAL POBLACION";5;3;8
" 05";"SUR";"ARAHAL (EL)";"ESPAÑOLES";3;2;5
" 05";"SUR";"ARAHAL (EL)";"TOTAL POBLACION";3;2;5
" 05";"SUR";"AZNALCAZAR";"ESPAÑOLES";0;2;2
" 05";"SUR";"AZNALCAZAR";"TOTAL POBLACION";0;2;2
" 05";"SUR";"AZNALCOLLAR";"ESPAÑOLES";3;1;4
" 05";"SUR";"AZNALCOLLAR";"TOTAL POBLACION";3;1;4
" 05";"SUR";"BENACAZON";"ESPAÑOLES";1;3;4
" 05";"SUR";"BENACAZON";"TOTAL POBLACION";1;3;4
" 05";"SUR";"BOLLULLOS DE LA MITACION";"ESPAÑOLES";2;3;5
" 05";"SUR";"BOLLULLOS DE LA MITACION";"EXTRANJEROS";0;2;2
" 05";"SUR";"BOLLULLOS DE LA MITACION";"TOTAL POBLACION";2;5;7
" 05";"SUR";"BORMUJOS";"ESPAÑOLES";22;15;37
" 05";"SUR";"BORMUJOS";"EXTRANJEROS";2;3;5
" 05";"SUR";"BORMUJOS";"TOTAL POBLACION";24;18;42
" 05";"SUR";"BRENES";"EXTRANJEROS";0;1;1
" 05";"SUR";"BRENES";"TOTAL POBLACION";0;1;1
" 05";"SUR";"BURGUILLOS";"ESPAÑOLES";1;2;3
" 05";"SUR";"BURGUILLOS";"TOTAL POBLACION";1;2;3
" 05";"SUR";"CABEZAS DE SAN JUAN (LAS)";"ESPAÑOLES";1;3;4
" 05";"SUR";"CABEZAS DE SAN JUAN (LAS)";"TOTAL POBLACION";1;3;4
" 05";"SUR";"CAMAS";"ESPAÑOLES";13;12;25
" 05";"SUR";"CAMAS";"EXTRANJEROS";0;2;2
" 05";"SUR";"CAMAS";"TOTAL POBLACION";13;14;27
" 05";"SUR";"CANTILLANA";"ESPAÑOLES";0;3;3
" 05";"SUR";"CANTILLANA";"EXTRANJEROS";0;2;2
" 05";"SUR";"CANTILLANA";"TOTAL POBLACION";0;5;5
" 05";"SUR";"CARMONA";"ESPAÑOLES";6;6;12
" 05";"SUR";"CARMONA";"EXTRANJEROS";1;0;1
" 05";"SUR";"CARMONA";"TOTAL POBLACION";7;6;13
" 05";"SUR";"CARRION DE LOS CESPEDES";"ESPAÑOLES";2;5;7
" 05";"SUR";"CARRION DE LOS CESPEDES";"EXTRANJEROS";0;1;1
" 05";"SUR";"CARRION DE LOS CESPEDES";"TOTAL POBLACION";2;6;8
" 05";"SUR";"CASTILBLANCO DE LOS ARROYOS";"ESPAÑOLES";2;6;8
" 05";"SUR";"CASTILBLANCO DE LOS ARROYOS";"EXTRANJEROS";2;0;2
" 05";"SUR";"CASTILBLANCO DE LOS ARROYOS";"TOTAL POBLACION";4;6;10
" 05";"SUR";"CASTILLEJA DE GUZMAN";"ESPAÑOLES";1;1;2
" 05";"SUR";"CASTILLEJA DE GUZMAN";"TOTAL POBLACION";1;1;2
" 05";"SUR";"CASTILLEJA DE LA CUESTA";"ESPAÑOLES";6;3;9
" 05";"SUR";"CASTILLEJA DE LA CUESTA";"TOTAL POBLACION";6;3;9
" 05";"SUR";"CASTILLEJA DEL CAMPO";"EXTRANJEROS";0;1;1
" 05";"SUR";"CASTILLEJA DEL CAMPO";"TOTAL POBLACION";0;1;1
" 05";"SUR";"CAZALLA DE LA SIERRA";"EXTRANJEROS";0;1;1
" 05";"SUR";"CAZALLA DE LA SIERRA";"TOTAL POBLACION";0;1;1
" 05";"SUR";"CONSTANTINA";"ESPAÑOLES";1;2;3
" 05";"SUR";"CONSTANTINA";"TOTAL POBLACION";1;2;3
" 05";"SUR";"CORIA DEL RIO";"ESPAÑOLES";4;10;14
" 05";"SUR";"CORIA DEL RIO";"EXTRANJEROS";0;3;3
" 05";"SUR";"CORIA DEL RIO";"TOTAL POBLACION";4;13;17
" 05";"SUR";"CORIPE";"ESPAÑOLES";0;1;1
" 05";"SUR";"CORIPE";"TOTAL POBLACION";0;1;1
" 05";"SUR";"CORONIL (EL)";"ESPAÑOLES";5;3;8
" 05";"SUR";"CORONIL (EL)";"TOTAL POBLACION";5;3;8
" 05";"SUR";"CORRALES (LOS)";"ESPAÑOLES";3;2;5
" 05";"SUR";"CORRALES (LOS)";"TOTAL POBLACION";3;2;5
" 05";"SUR";"DOS HERMANAS";"ESPAÑOLES";106;103;209
" 05";"SUR";"DOS HERMANAS";"EXTRANJEROS";8;8;16
" 05";"SUR";"DOS HERMANAS";"TOTAL POBLACION";114;111;225
" 05";"SUR";"ECIJA";"ESPAÑOLES";0;2;2
" 05";"SUR";"ECIJA";"TOTAL POBLACION";0;2;2
" 05";"SUR";"ESPARTINAS";"ESPAÑOLES";12;10;22
" 05";"SUR";"ESPARTINAS";"EXTRANJEROS";1;2;3
" 05";"SUR";"ESPARTINAS";"TOTAL POBLACION";13;12;25
" 05";"SUR";"FUENTES DE ANDALUCIA";"ESPAÑOLES";2;2;4
" 05";"SUR";"FUENTES DE ANDALUCIA";"TOTAL POBLACION";2;2;4
" 05";"SUR";"GARROBO (EL)";"ESPAÑOLES";0;1;1
" 05";"SUR";"GARROBO (EL)";"TOTAL POBLACION";0;1;1
" 05";"SUR";"GELVES";"ESPAÑOLES";4;9;13
" 05";"SUR";"GELVES";"EXTRANJEROS";0;2;2
" 05";"SUR";"GELVES";"TOTAL POBLACION";4;11;15
" 05";"SUR";"GERENA";"ESPAÑOLES";1;3;4
" 05";"SUR";"GERENA";"EXTRANJEROS";1;0;1
" 05";"SUR";"GERENA";"TOTAL POBLACION";2;3;5
" 05";"SUR";"GILENA";"ESPAÑOLES";1;0;1
" 05";"SUR";"GILENA";"TOTAL POBLACION";1;0;1
" 05";"SUR";"GINES";"ESPAÑOLES";5;3;8
" 05";"SUR";"GINES";"TOTAL POBLACION";5;3;8
" 05";"SUR";"GUILLENA";"ESPAÑOLES";1;4;5
" 05";"SUR";"GUILLENA";"EXTRANJEROS";0;1;1
" 05";"SUR";"GUILLENA";"TOTAL POBLACION";1;5;6
" 05";"SUR";"HERRERA";"ESPAÑOLES";1;0;1
" 05";"SUR";"HERRERA";"TOTAL POBLACION";1;0;1
" 05";"SUR";"ISLA MAYOR";"EXTRANJEROS";1;2;3
" 05";"SUR";"ISLA MAYOR";"TOTAL POBLACION";1;2;3
" 05";"SUR";"LANTEJUELA (LA)";"ESPAÑOLES";1;1;2
" 05";"SUR";"LANTEJUELA (LA)";"TOTAL POBLACION";1;1;2
" 05";"SUR";"LEBRIJA";"ESPAÑOLES";1;4;5
" 05";"SUR";"LEBRIJA";"TOTAL POBLACION";1;4;5
" 05";"SUR";"LORA DEL RIO";"ESPAÑOLES";1;0;1
" 05";"SUR";"LORA DEL RIO";"TOTAL POBLACION";1;0;1
" 05";"SUR";"LUISIANA (LA)";"ESPAÑOLES";0;2;2
" 05";"SUR";"LUISIANA (LA)";"TOTAL POBLACION";0;2;2
" 05";"SUR";"MADROÑO (EL)";"ESPAÑOLES";0;1;1
" 05";"SUR";"MADROÑO (EL)";"TOTAL POBLACION";0;1;1
" 05";"SUR";"MAIRENA DEL ALCOR";"ESPAÑOLES";6;2;8
" 05";"SUR";"MAIRENA DEL ALCOR";"TOTAL POBLACION";6;2;8
" 05";"SUR";"MAIRENA DEL ALJARAFE";"ESPAÑOLES";27;24;51
" 05";"SUR";"MAIRENA DEL ALJARAFE";"EXTRANJEROS";2;6;8
" 05";"SUR";"MAIRENA DEL ALJARAFE";"TOTAL POBLACION";29;30;59
" 05";"SUR";"MARCHENA";"ESPAÑOLES";0;2;2
" 05";"SUR";"MARCHENA";"EXTRANJEROS";0;1;1
" 05";"SUR";"MARCHENA";"TOTAL POBLACION";0;3;3
" 05";"SUR";"MOLARES (LOS)";"ESPAÑOLES";1;1;2
" 05";"SUR";"MOLARES (LOS)";"TOTAL POBLACION";1;1;2
" 05";"SUR";"MORON DE LA FRONTERA";"ESPAÑOLES";1;1;2
" 05";"SUR";"MORON DE LA FRONTERA";"EXTRANJEROS";0;2;2
" 05";"SUR";"MORON DE LA FRONTERA";"TOTAL POBLACION";1;3;4
" 05";"SUR";"OLIVARES";"ESPAÑOLES";3;6;9
" 05";"SUR";"OLIVARES";"TOTAL POBLACION";3;6;9
" 05";"SUR";"OSUNA";"ESPAÑOLES";1;1;2
" 05";"SUR";"OSUNA";"EXTRANJEROS";1;0;1
" 05";"SUR";"OSUNA";"TOTAL POBLACION";2;1;3
" 05";"SUR";"PALACIOS Y VILLAFRANCA (LOS)";"ESPAÑOLES";3;1;4
" 05";"SUR";"PALACIOS Y VILLAFRANCA (LOS)";"TOTAL POBLACION";3;1;4
" 05";"SUR";"PALOMARES DEL RIO";"ESPAÑOLES";6;7;13
" 05";"SUR";"PALOMARES DEL RIO";"TOTAL POBLACION";6;7;13
" 05";"SUR";"PARADAS";"ESPAÑOLES";3;0;3
" 05";"SUR";"PARADAS";"TOTAL POBLACION";3;0;3
" 05";"SUR";"PEDRERA";"ESPAÑOLES";0;1;1
" 05";"SUR";"PEDRERA";"TOTAL POBLACION";0;1;1
" 05";"SUR";"PEDROSO (EL)";"ESPAÑOLES";0;1;1
" 05";"SUR";"PEDROSO (EL)";"TOTAL POBLACION";0;1;1
" 05";"SUR";"PILAS";"ESPAÑOLES";1;1;2
" 05";"SUR";"PILAS";"TOTAL POBLACION";1;1;2
" 05";"SUR";"PUEBLA DE LOS INFANTES (LA)";"EXTRANJEROS";0;1;1
" 05";"SUR";"PUEBLA DE LOS INFANTES (LA)";"TOTAL POBLACION";0;1;1
" 05";"SUR";"PUEBLA DEL RIO (LA)";"ESPAÑOLES";3;4;7
" 05";"SUR";"PUEBLA DEL RIO (LA)";"TOTAL POBLACION";3;4;7
" 05";"SUR";"REAL DE LA JARA (EL)";"ESPAÑOLES";0;1;1
" 05";"SUR";"REAL DE LA JARA (EL)";"TOTAL POBLACION";0;1;1
" 05";"SUR";"RINCONADA (LA)";"ESPAÑOLES";5;5;10
" 05";"SUR";"RINCONADA (LA)";"EXTRANJEROS";2;0;2
" 05";"SUR";"RINCONADA (LA)";"TOTAL POBLACION";7;5;12
" 05";"SUR";"RONQUILLO (EL)";"EXTRANJEROS";0;1;1
" 05";"SUR";"RONQUILLO (EL)";"TOTAL POBLACION";0;1;1
" 05";"SUR";"SAN JUAN DE AZNALFARACHE";"ESPAÑOLES";15;15;30
" 05";"SUR";"SAN JUAN DE AZNALFARACHE";"EXTRANJEROS";3;3;6
" 05";"SUR";"SAN JUAN DE AZNALFARACHE";"TOTAL POBLACION";18;18;36
" 05";"SUR";"SANLUCAR LA MAYOR";"ESPAÑOLES";6;11;17
" 05";"SUR";"SANLUCAR LA MAYOR";"TOTAL POBLACION";6;11;17
" 05";"SUR";"SANTIPONCE";"ESPAÑOLES";0;1;1
" 05";"SUR";"SANTIPONCE";"TOTAL POBLACION";0;1;1
" 05";"SUR";"TOCINA";"ESPAÑOLES";3;1;4
" 05";"SUR";"TOCINA";"EXTRANJEROS";2;1;3
" 05";"SUR";"TOCINA";"TOTAL POBLACION";5;2;7
" 05";"SUR";"TOMARES";"ESPAÑOLES";14;13;27
" 05";"SUR";"TOMARES";"EXTRANJEROS";1;1;2
" 05";"SUR";"TOMARES";"TOTAL POBLACION";15;14;29
" 05";"SUR";"UMBRETE";"ESPAÑOLES";2;3;5
" 05";"SUR";"UMBRETE";"TOTAL POBLACION";2;3;5
" 05";"SUR";"UTRERA";"ESPAÑOLES";12;13;25
" 05";"SUR";"UTRERA";"EXTRANJEROS";1;1;2
" 05";"SUR";"UTRERA";"TOTAL POBLACION";13;14;27
" 05";"SUR";"VALENCINA DE LA CONCEPCION";"ESPAÑOLES";4;6;10
" 05";"SUR";"VALENCINA DE LA CONCEPCION";"TOTAL POBLACION";4;6;10
" 05";"SUR";"VILLAMANRIQUE DE LA CONDESA";"ESPAÑOLES";3;0;3
" 05";"SUR";"VILLAMANRIQUE DE LA CONDESA";"EXTRANJEROS";0;2;2
" 05";"SUR";"VILLAMANRIQUE DE LA CONDESA";"TOTAL POBLACION";3;2;5
" 05";"SUR";"VILLANUEVA DEL ARISCAL";"ESPAÑOLES";3;3;6
" 05";"SUR";"VILLANUEVA DEL ARISCAL";"TOTAL POBLACION";3;3;6
" 05";"SUR";"VILLAVERDE DEL RIO";"ESPAÑOLES";1;0;1
" 05";"SUR";"VILLAVERDE DEL RIO";"TOTAL POBLACION";1;0;1
" 05";"SUR";"VISO DEL ALCOR (EL)";"ESPAÑOLES";5;2;7
" 05";"SUR";"VISO DEL ALCOR (EL)";"EXTRANJEROS";1;0;1
" 05";"SUR";"VISO DEL ALCOR (EL)";"TOTAL POBLACION";6;2;8
" 06";"TRIANA";"- FUERA DE LA PROVINCIA DE SEVILLA";"ESPAÑOLES";272;282;554
" 06";"TRIANA";"- FUERA DE LA PROVINCIA DE SEVILLA";"EXTRANJEROS";37;50;87
" 06";"TRIANA";"- FUERA DE LA PROVINCIA DE SEVILLA";"TOTAL POBLACION";309;332;641
" 06";"TRIANA";"- PROVINCIA DE SEVILLA";"ESPAÑOLES";265;319;584
" 06";"TRIANA";"- PROVINCIA DE SEVILLA";"EXTRANJEROS";18;28;46
" 06";"TRIANA";"- PROVINCIA DE SEVILLA";"NO CONSTA";1;0;1
" 06";"TRIANA";"- PROVINCIA DE SEVILLA";"TOTAL POBLACION";284;347;631
" 06";"TRIANA";"ALBAIDA DEL ALJARAFE";"ESPAÑOLES";1;3;4
" 06";"TRIANA";"ALBAIDA DEL ALJARAFE";"TOTAL POBLACION";1;3;4
" 06";"TRIANA";"ALCALA DE GUADAIRA";"ESPAÑOLES";11;7;18
" 06";"TRIANA";"ALCALA DE GUADAIRA";"EXTRANJEROS";2;2;4
" 06";"TRIANA";"ALCALA DE GUADAIRA";"NO CONSTA";1;0;1
" 06";"TRIANA";"ALCALA DE GUADAIRA";"TOTAL POBLACION";14;9;23
" 06";"TRIANA";"ALCALA DEL RIO";"ESPAÑOLES";1;0;1
" 06";"TRIANA";"ALCALA DEL RIO";"TOTAL POBLACION";1;0;1
" 06";"TRIANA";"ALGABA (LA)";"ESPAÑOLES";1;3;4
" 06";"TRIANA";"ALGABA (LA)";"TOTAL POBLACION";1;3;4
" 06";"TRIANA";"ALMADEN DE LA PLATA";"ESPAÑOLES";0;1;1
" 06";"TRIANA";"ALMADEN DE LA PLATA";"TOTAL POBLACION";0;1;1
" 06";"TRIANA";"ALMENSILLA";"ESPAÑOLES";1;2;3
" 06";"TRIANA";"ALMENSILLA";"TOTAL POBLACION";1;2;3
" 06";"TRIANA";"ARAHAL (EL)";"ESPAÑOLES";1;0;1
" 06";"TRIANA";"ARAHAL (EL)";"TOTAL POBLACION";1;0;1
" 06";"TRIANA";"AZNALCAZAR";"ESPAÑOLES";0;1;1
" 06";"TRIANA";"AZNALCAZAR";"EXTRANJEROS";1;0;1
" 06";"TRIANA";"AZNALCAZAR";"TOTAL POBLACION";1;1;2
" 06";"TRIANA";"BENACAZON";"ESPAÑOLES";1;1;2
" 06";"TRIANA";"BENACAZON";"TOTAL POBLACION";1;1;2
" 06";"TRIANA";"BOLLULLOS DE LA MITACION";"ESPAÑOLES";6;3;9
" 06";"TRIANA";"BOLLULLOS DE LA MITACION";"EXTRANJEROS";0;1;1
" 06";"TRIANA";"BOLLULLOS DE LA MITACION";"TOTAL POBLACION";6;4;10
" 06";"TRIANA";"BORMUJOS";"ESPAÑOLES";15;10;25
" 06";"TRIANA";"BORMUJOS";"EXTRANJEROS";1;0;1
" 06";"TRIANA";"BORMUJOS";"TOTAL POBLACION";16;10;26
" 06";"TRIANA";"BRENES";"ESPAÑOLES";0;2;2
" 06";"TRIANA";"BRENES";"TOTAL POBLACION";0;2;2
" 06";"TRIANA";"BURGUILLOS";"ESPAÑOLES";3;1;4
" 06";"TRIANA";"BURGUILLOS";"TOTAL POBLACION";3;1;4
" 06";"TRIANA";"CAMAS";"ESPAÑOLES";27;38;65
" 06";"TRIANA";"CAMAS";"EXTRANJEROS";2;3;5
" 06";"TRIANA";"CAMAS";"TOTAL POBLACION";29;41;70
" 06";"TRIANA";"CAMPANA (LA)";"ESPAÑOLES";0;1;1
" 06";"TRIANA";"CAMPANA (LA)";"TOTAL POBLACION";0;1;1
" 06";"TRIANA";"CANTILLANA";"ESPAÑOLES";1;2;3
" 06";"TRIANA";"CANTILLANA";"TOTAL POBLACION";1;2;3
" 06";"TRIANA";"CARMONA";"EXTRANJEROS";1;2;3
" 06";"TRIANA";"CARMONA";"TOTAL POBLACION";1;2;3
" 06";"TRIANA";"CARRION DE LOS CESPEDES";"ESPAÑOLES";0;2;2
" 06";"TRIANA";"CARRION DE LOS CESPEDES";"TOTAL POBLACION";0;2;2
" 06";"TRIANA";"CASTILBLANCO DE LOS ARROYOS";"ESPAÑOLES";3;3;6
" 06";"TRIANA";"CASTILBLANCO DE LOS ARROYOS";"TOTAL POBLACION";3;3;6
" 06";"TRIANA";"CASTILLEJA DE GUZMAN";"ESPAÑOLES";0;1;1
" 06";"TRIANA";"CASTILLEJA DE GUZMAN";"TOTAL POBLACION";0;1;1
" 06";"TRIANA";"CASTILLEJA DE LA CUESTA";"ESPAÑOLES";12;13;25
" 06";"TRIANA";"CASTILLEJA DE LA CUESTA";"EXTRANJEROS";2;2;4
" 06";"TRIANA";"CASTILLEJA DE LA CUESTA";"TOTAL POBLACION";14;15;29
" 06";"TRIANA";"CASTILLEJA DEL CAMPO";"EXTRANJEROS";0;1;1
" 06";"TRIANA";"CASTILLEJA DEL CAMPO";"TOTAL POBLACION";0;1;1
" 06";"TRIANA";"CASTILLO DE LAS GUARDAS (EL)";"ESPAÑOLES";1;2;3
" 06";"TRIANA";"CASTILLO DE LAS GUARDAS (EL)";"TOTAL POBLACION";1;2;3
" 06";"TRIANA";"CAZALLA DE LA SIERRA";"ESPAÑOLES";1;0;1
" 06";"TRIANA";"CAZALLA DE LA SIERRA";"TOTAL POBLACION";1;0;1
" 06";"TRIANA";"CONSTANTINA";"ESPAÑOLES";0;1;1
" 06";"TRIANA";"CONSTANTINA";"TOTAL POBLACION";0;1;1
" 06";"TRIANA";"CORIA DEL RIO";"ESPAÑOLES";5;4;9
" 06";"TRIANA";"CORIA DEL RIO";"TOTAL POBLACION";5;4;9
" 06";"TRIANA";"CORONIL (EL)";"ESPAÑOLES";1;1;2
" 06";"TRIANA";"CORONIL (EL)";"TOTAL POBLACION";1;1;2
" 06";"TRIANA";"CUERVO DE SEVILLA (EL)";"ESPAÑOLES";1;0;1
" 06";"TRIANA";"CUERVO DE SEVILLA (EL)";"TOTAL POBLACION";1;0;1
" 06";"TRIANA";"DOS HERMANAS";"ESPAÑOLES";26;27;53
" 06";"TRIANA";"DOS HERMANAS";"EXTRANJEROS";2;0;2
" 06";"TRIANA";"DOS HERMANAS";"TOTAL POBLACION";28;27;55
" 06";"TRIANA";"ECIJA";"ESPAÑOLES";0;1;1
" 06";"TRIANA";"ECIJA";"TOTAL POBLACION";0;1;1
" 06";"TRIANA";"ESPARTINAS";"ESPAÑOLES";7;6;13
" 06";"TRIANA";"ESPARTINAS";"TOTAL POBLACION";7;6;13
" 06";"TRIANA";"ESTEPA";"ESPAÑOLES";1;0;1
" 06";"TRIANA";"ESTEPA";"EXTRANJEROS";0;1;1
" 06";"TRIANA";"ESTEPA";"TOTAL POBLACION";1;1;2
" 06";"TRIANA";"FUENTES DE ANDALUCIA";"ESPAÑOLES";0;1;1
" 06";"TRIANA";"FUENTES DE ANDALUCIA";"TOTAL POBLACION";0;1;1
" 06";"TRIANA";"GARROBO (EL)";"ESPAÑOLES";1;1;2
" 06";"TRIANA";"GARROBO (EL)";"TOTAL POBLACION";1;1;2
" 06";"TRIANA";"GELVES";"ESPAÑOLES";11;9;20
" 06";"TRIANA";"GELVES";"EXTRANJEROS";0;1;1
" 06";"TRIANA";"GELVES";"TOTAL POBLACION";11;10;21
" 06";"TRIANA";"GERENA";"ESPAÑOLES";1;2;3
" 06";"TRIANA";"GERENA";"TOTAL POBLACION";1;2;3
" 06";"TRIANA";"GINES";"ESPAÑOLES";2;7;9
" 06";"TRIANA";"GINES";"EXTRANJEROS";1;2;3
" 06";"TRIANA";"GINES";"TOTAL POBLACION";3;9;12
" 06";"TRIANA";"GUILLENA";"ESPAÑOLES";5;5;10
" 06";"TRIANA";"GUILLENA";"EXTRANJEROS";1;0;1
" 06";"TRIANA";"GUILLENA";"TOTAL POBLACION";6;5;11
" 06";"TRIANA";"HUEVAR DEL ALJARAFE";"ESPAÑOLES";0;3;3
" 06";"TRIANA";"HUEVAR DEL ALJARAFE";"TOTAL POBLACION";0;3;3
" 06";"TRIANA";"ISLA MAYOR";"EXTRANJEROS";0;1;1
" 06";"TRIANA";"ISLA MAYOR";"TOTAL POBLACION";0;1;1
" 06";"TRIANA";"LEBRIJA";"ESPAÑOLES";1;1;2
" 06";"TRIANA";"LEBRIJA";"TOTAL POBLACION";1;1;2
" 06";"TRIANA";"LORA DEL RIO";"ESPAÑOLES";1;0;1
" 06";"TRIANA";"LORA DEL RIO";"TOTAL POBLACION";1;0;1
" 06";"TRIANA";"MAIRENA DEL ALCOR";"ESPAÑOLES";2;0;2
" 06";"TRIANA";"MAIRENA DEL ALCOR";"TOTAL POBLACION";2;0;2
" 06";"TRIANA";"MAIRENA DEL ALJARAFE";"ESPAÑOLES";28;33;61
" 06";"TRIANA";"MAIRENA DEL ALJARAFE";"EXTRANJEROS";1;2;3
" 06";"TRIANA";"MAIRENA DEL ALJARAFE";"TOTAL POBLACION";29;35;64
" 06";"TRIANA";"MARCHENA";"ESPAÑOLES";0;1;1
" 06";"TRIANA";"MARCHENA";"EXTRANJEROS";0;1;1
" 06";"TRIANA";"MARCHENA";"TOTAL POBLACION";0;2;2
" 06";"TRIANA";"MOLARES (LOS)";"ESPAÑOLES";1;0;1
" 06";"TRIANA";"MOLARES (LOS)";"TOTAL POBLACION";1;0;1
" 06";"TRIANA";"NAVAS DE LA CONCEPCION (LAS)";"ESPAÑOLES";1;1;2
" 06";"TRIANA";"NAVAS DE LA CONCEPCION (LAS)";"TOTAL POBLACION";1;1;2
" 06";"TRIANA";"OLIVARES";"ESPAÑOLES";5;7;12
" 06";"TRIANA";"OLIVARES";"TOTAL POBLACION";5;7;12
" 06";"TRIANA";"OSUNA";"ESPAÑOLES";0;1;1
" 06";"TRIANA";"OSUNA";"TOTAL POBLACION";0;1;1
" 06";"TRIANA";"PALACIOS Y VILLAFRANCA (LOS)";"ESPAÑOLES";1;0;1
" 06";"TRIANA";"PALACIOS Y VILLAFRANCA (LOS)";"TOTAL POBLACION";1;0;1
" 06";"TRIANA";"PALOMARES DEL RIO";"ESPAÑOLES";9;12;21
" 06";"TRIANA";"PALOMARES DEL RIO";"TOTAL POBLACION";9;12;21
" 06";"TRIANA";"PARADAS";"ESPAÑOLES";0;1;1
" 06";"TRIANA";"PARADAS";"TOTAL POBLACION";0;1;1
" 06";"TRIANA";"PEÑAFLOR";"ESPAÑOLES";2;0;2
" 06";"TRIANA";"PEÑAFLOR";"TOTAL POBLACION";2;0;2
" 06";"TRIANA";"PILAS";"ESPAÑOLES";2;1;3
" 06";"TRIANA";"PILAS";"TOTAL POBLACION";2;1;3
" 06";"TRIANA";"PUEBLA DE CAZALLA (LA)";"ESPAÑOLES";0;2;2
" 06";"TRIANA";"PUEBLA DE CAZALLA (LA)";"TOTAL POBLACION";0;2;2
" 06";"TRIANA";"PUEBLA DEL RIO (LA)";"EXTRANJEROS";1;0;1
" 06";"TRIANA";"PUEBLA DEL RIO (LA)";"TOTAL POBLACION";1;0;1
" 06";"TRIANA";"RINCONADA (LA)";"ESPAÑOLES";3;11;14
" 06";"TRIANA";"RINCONADA (LA)";"TOTAL POBLACION";3;11;14
" 06";"TRIANA";"SAN JUAN DE AZNALFARACHE";"ESPAÑOLES";23;26;49
" 06";"TRIANA";"SAN JUAN DE AZNALFARACHE";"EXTRANJEROS";1;7;8
" 06";"TRIANA";"SAN JUAN DE AZNALFARACHE";"TOTAL POBLACION";24;33;57
" 06";"TRIANA";"SAN NICOLAS DEL PUERTO";"ESPAÑOLES";1;1;2
" 06";"TRIANA";"SAN NICOLAS DEL PUERTO";"TOTAL POBLACION";1;1;2
" 06";"TRIANA";"SANLUCAR LA MAYOR";"ESPAÑOLES";5;6;11
" 06";"TRIANA";"SANLUCAR LA MAYOR";"EXTRANJEROS";1;1;2
" 06";"TRIANA";"SANLUCAR LA MAYOR";"TOTAL POBLACION";6;7;13
" 06";"TRIANA";"SANTIPONCE";"ESPAÑOLES";3;4;7
" 06";"TRIANA";"SANTIPONCE";"TOTAL POBLACION";3;4;7
" 06";"TRIANA";"TOMARES";"ESPAÑOLES";14;26;40
" 06";"TRIANA";"TOMARES";"TOTAL POBLACION";14;26;40
" 06";"TRIANA";"UMBRETE";"ESPAÑOLES";5;6;11
" 06";"TRIANA";"UMBRETE";"TOTAL POBLACION";5;6;11
" 06";"TRIANA";"UTRERA";"ESPAÑOLES";4;7;11
" 06";"TRIANA";"UTRERA";"EXTRANJEROS";1;1;2
" 06";"TRIANA";"UTRERA";"TOTAL POBLACION";5;8;13
" 06";"TRIANA";"VALENCINA DE LA CONCEPCION";"ESPAÑOLES";3;4;7
" 06";"TRIANA";"VALENCINA DE LA CONCEPCION";"TOTAL POBLACION";3;4;7
" 06";"TRIANA";"VILLAMANRIQUE DE LA CONDESA";"ESPAÑOLES";0;1;1
" 06";"TRIANA";"VILLAMANRIQUE DE LA CONDESA";"TOTAL POBLACION";0;1;1
" 06";"TRIANA";"VILLANUEVA DEL ARISCAL";"ESPAÑOLES";4;3;7
" 06";"TRIANA";"VILLANUEVA DEL ARISCAL";"TOTAL POBLACION";4;3;7
" 07";"NORTE";"- FUERA DE LA PROVINCIA DE SEVILLA";"ESPAÑOLES";228;247;475
" 07";"NORTE";"- FUERA DE LA PROVINCIA DE SEVILLA";"EXTRANJEROS";49;46;95
" 07";"NORTE";"- FUERA DE LA PROVINCIA DE SEVILLA";"TOTAL POBLACION";277;293;570
" 07";"NORTE";"- PROVINCIA DE SEVILLA";"ESPAÑOLES";376;465;841
" 07";"NORTE";"- PROVINCIA DE SEVILLA";"EXTRANJEROS";28;30;58
" 07";"NORTE";"- PROVINCIA DE SEVILLA";"NO CONSTA";0;1;1
" 07";"NORTE";"- PROVINCIA DE SEVILLA";"TOTAL POBLACION";404;496;900
" 07";"NORTE";"ALCALA DE GUADAIRA";"ESPAÑOLES";25;27;52
" 07";"NORTE";"ALCALA DE GUADAIRA";"EXTRANJEROS";4;3;7
" 07";"NORTE";"ALCALA DE GUADAIRA";"NO CONSTA";0;1;1
" 07";"NORTE";"ALCALA DE GUADAIRA";"TOTAL POBLACION";29;31;60
" 07";"NORTE";"ALCALA DEL RIO";"ESPAÑOLES";9;10;19
" 07";"NORTE";"ALCALA DEL RIO";"TOTAL POBLACION";9;10;19
" 07";"NORTE";"ALCOLEA DEL RIO";"ESPAÑOLES";1;1;2
" 07";"NORTE";"ALCOLEA DEL RIO";"TOTAL POBLACION";1;1;2
" 07";"NORTE";"ALGABA (LA)";"ESPAÑOLES";29;37;66
" 07";"NORTE";"ALGABA (LA)";"TOTAL POBLACION";29;37;66
" 07";"NORTE";"ALGAMITAS";"ESPAÑOLES";1;0;1
" 07";"NORTE";"ALGAMITAS";"TOTAL POBLACION";1;0;1
" 07";"NORTE";"ALMENSILLA";"ESPAÑOLES";2;0;2
" 07";"NORTE";"ALMENSILLA";"TOTAL POBLACION";2;0;2
" 07";"NORTE";"ARAHAL (EL)";"ESPAÑOLES";0;2;2
" 07";"NORTE";"ARAHAL (EL)";"TOTAL POBLACION";0;2;2
" 07";"NORTE";"AZNALCOLLAR";"ESPAÑOLES";0;1;1
" 07";"NORTE";"AZNALCOLLAR";"TOTAL POBLACION";0;1;1
" 07";"NORTE";"BENACAZON";"ESPAÑOLES";2;0;2
" 07";"NORTE";"BENACAZON";"TOTAL POBLACION";2;0;2
" 07";"NORTE";"BOLLULLOS DE LA MITACION";"ESPAÑOLES";3;11;14
" 07";"NORTE";"BOLLULLOS DE LA MITACION";"EXTRANJEROS";2;1;3
" 07";"NORTE";"BOLLULLOS DE LA MITACION";"TOTAL POBLACION";5;12;17
" 07";"NORTE";"BORMUJOS";"ESPAÑOLES";12;12;24
" 07";"NORTE";"BORMUJOS";"EXTRANJEROS";3;0;3
" 07";"NORTE";"BORMUJOS";"TOTAL POBLACION";15;12;27
" 07";"NORTE";"BRENES";"ESPAÑOLES";2;7;9
" 07";"NORTE";"BRENES";"EXTRANJEROS";1;0;1
" 07";"NORTE";"BRENES";"TOTAL POBLACION";3;7;10
" 07";"NORTE";"BURGUILLOS";"ESPAÑOLES";12;16;28
" 07";"NORTE";"BURGUILLOS";"TOTAL POBLACION";12;16;28
" 07";"NORTE";"CABEZAS DE SAN JUAN (LAS)";"ESPAÑOLES";0;2;2
" 07";"NORTE";"CABEZAS DE SAN JUAN (LAS)";"TOTAL POBLACION";0;2;2
" 07";"NORTE";"CAMAS";"ESPAÑOLES";18;17;35
" 07";"NORTE";"CAMAS";"EXTRANJEROS";2;1;3
" 07";"NORTE";"CAMAS";"TOTAL POBLACION";20;18;38
" 07";"NORTE";"CANTILLANA";"ESPAÑOLES";4;4;8
" 07";"NORTE";"CANTILLANA";"TOTAL POBLACION";4;4;8
" 07";"NORTE";"CARMONA";"ESPAÑOLES";10;9;19
" 07";"NORTE";"CARMONA";"TOTAL POBLACION";10;9;19
" 07";"NORTE";"CARRION DE LOS CESPEDES";"ESPAÑOLES";0;1;1
" 07";"NORTE";"CARRION DE LOS CESPEDES";"TOTAL POBLACION";0;1;1
" 07";"NORTE";"CASTILBLANCO DE LOS ARROYOS";"ESPAÑOLES";4;3;7
" 07";"NORTE";"CASTILBLANCO DE LOS ARROYOS";"TOTAL POBLACION";4;3;7
" 07";"NORTE";"CASTILLEJA DE GUZMAN";"ESPAÑOLES";2;0;2
" 07";"NORTE";"CASTILLEJA DE GUZMAN";"TOTAL POBLACION";2;0;2
" 07";"NORTE";"CASTILLEJA DE LA CUESTA";"ESPAÑOLES";9;9;18
" 07";"NORTE";"CASTILLEJA DE LA CUESTA";"EXTRANJEROS";1;0;1
" 07";"NORTE";"CASTILLEJA DE LA CUESTA";"TOTAL POBLACION";10;9;19
" 07";"NORTE";"CAZALLA DE LA SIERRA";"ESPAÑOLES";1;1;2
" 07";"NORTE";"CAZALLA DE LA SIERRA";"TOTAL POBLACION";1;1;2
" 07";"NORTE";"CORIA DEL RIO";"ESPAÑOLES";12;5;17
" 07";"NORTE";"CORIA DEL RIO";"EXTRANJEROS";0;1;1
" 07";"NORTE";"CORIA DEL RIO";"TOTAL POBLACION";12;6;18
" 07";"NORTE";"CUERVO DE SEVILLA (EL)";"ESPAÑOLES";1;1;2
" 07";"NORTE";"CUERVO DE SEVILLA (EL)";"TOTAL POBLACION";1;1;2
" 07";"NORTE";"DOS HERMANAS";"ESPAÑOLES";38;42;80
" 07";"NORTE";"DOS HERMANAS";"EXTRANJEROS";1;4;5
" 07";"NORTE";"DOS HERMANAS";"TOTAL POBLACION";39;46;85
" 07";"NORTE";"ECIJA";"ESPAÑOLES";1;5;6
" 07";"NORTE";"ECIJA";"TOTAL POBLACION";1;5;6
" 07";"NORTE";"ESPARTINAS";"ESPAÑOLES";11;22;33
" 07";"NORTE";"ESPARTINAS";"EXTRANJEROS";1;0;1
" 07";"NORTE";"ESPARTINAS";"TOTAL POBLACION";12;22;34
" 07";"NORTE";"ESTEPA";"ESPAÑOLES";1;0;1
" 07";"NORTE";"ESTEPA";"TOTAL POBLACION";1;0;1
" 07";"NORTE";"FUENTES DE ANDALUCIA";"ESPAÑOLES";1;1;2
" 07";"NORTE";"FUENTES DE ANDALUCIA";"TOTAL POBLACION";1;1;2
" 07";"NORTE";"GELVES";"ESPAÑOLES";5;2;7
" 07";"NORTE";"GELVES";"TOTAL POBLACION";5;2;7
" 07";"NORTE";"GERENA";"ESPAÑOLES";4;8;12
" 07";"NORTE";"GERENA";"EXTRANJEROS";0;1;1
" 07";"NORTE";"GERENA";"TOTAL POBLACION";4;9;13
" 07";"NORTE";"GINES";"ESPAÑOLES";7;7;14
" 07";"NORTE";"GINES";"EXTRANJEROS";0;1;1
" 07";"NORTE";"GINES";"TOTAL POBLACION";7;8;15
" 07";"NORTE";"GUADALCANAL";"ESPAÑOLES";0;1;1
" 07";"NORTE";"GUADALCANAL";"TOTAL POBLACION";0;1;1
" 07";"NORTE";"GUILLENA";"ESPAÑOLES";7;9;16
" 07";"NORTE";"GUILLENA";"TOTAL POBLACION";7;9;16
" 07";"NORTE";"HUEVAR DEL ALJARAFE";"ESPAÑOLES";0;1;1
" 07";"NORTE";"HUEVAR DEL ALJARAFE";"TOTAL POBLACION";0;1;1
" 07";"NORTE";"ISLA MAYOR";"ESPAÑOLES";1;0;1
" 07";"NORTE";"ISLA MAYOR";"TOTAL POBLACION";1;0;1
" 07";"NORTE";"LEBRIJA";"ESPAÑOLES";1;2;3
" 07";"NORTE";"LEBRIJA";"TOTAL POBLACION";1;2;3
" 07";"NORTE";"LORA DEL RIO";"ESPAÑOLES";0;2;2
" 07";"NORTE";"LORA DEL RIO";"TOTAL POBLACION";0;2;2
" 07";"NORTE";"LUISIANA (LA)";"ESPAÑOLES";1;0;1
" 07";"NORTE";"LUISIANA (LA)";"TOTAL POBLACION";1;0;1
" 07";"NORTE";"MADROÑO (EL)";"ESPAÑOLES";1;0;1
" 07";"NORTE";"MADROÑO (EL)";"TOTAL POBLACION";1;0;1
" 07";"NORTE";"MAIRENA DEL ALCOR";"ESPAÑOLES";3;4;7
" 07";"NORTE";"MAIRENA DEL ALCOR";"EXTRANJEROS";0;1;1
" 07";"NORTE";"MAIRENA DEL ALCOR";"TOTAL POBLACION";3;5;8
" 07";"NORTE";"MAIRENA DEL ALJARAFE";"ESPAÑOLES";18;18;36
" 07";"NORTE";"MAIRENA DEL ALJARAFE";"EXTRANJEROS";1;1;2
" 07";"NORTE";"MAIRENA DEL ALJARAFE";"TOTAL POBLACION";19;19;38
" 07";"NORTE";"MARCHENA";"ESPAÑOLES";1;1;2
" 07";"NORTE";"MARCHENA";"TOTAL POBLACION";1;1;2
" 07";"NORTE";"MOLARES (LOS)";"ESPAÑOLES";1;0;1
" 07";"NORTE";"MOLARES (LOS)";"TOTAL POBLACION";1;0;1
" 07";"NORTE";"MORON DE LA FRONTERA";"ESPAÑOLES";4;4;8
" 07";"NORTE";"MORON DE LA FRONTERA";"TOTAL POBLACION";4;4;8
" 07";"NORTE";"NAVAS DE LA CONCEPCION (LAS)";"ESPAÑOLES";0;1;1
" 07";"NORTE";"NAVAS DE LA CONCEPCION (LAS)";"TOTAL POBLACION";0;1;1
" 07";"NORTE";"OLIVARES";"ESPAÑOLES";5;9;14
" 07";"NORTE";"OLIVARES";"TOTAL POBLACION";5;9;14
" 07";"NORTE";"OSUNA";"ESPAÑOLES";0;1;1
" 07";"NORTE";"OSUNA";"EXTRANJEROS";1;0;1
" 07";"NORTE";"OSUNA";"TOTAL POBLACION";1;1;2
" 07";"NORTE";"PALACIOS Y VILLAFRANCA (LOS)";"ESPAÑOLES";1;0;1
" 07";"NORTE";"PALACIOS Y VILLAFRANCA (LOS)";"TOTAL POBLACION";1;0;1
" 07";"NORTE";"PALOMARES DEL RIO";"ESPAÑOLES";2;5;7
" 07";"NORTE";"PALOMARES DEL RIO";"TOTAL POBLACION";2;5;7
" 07";"NORTE";"PEDROSO (EL)";"ESPAÑOLES";2;2;4
" 07";"NORTE";"PEDROSO (EL)";"EXTRANJEROS";0;1;1
" 07";"NORTE";"PEDROSO (EL)";"TOTAL POBLACION";2;3;5
" 07";"NORTE";"PEÑAFLOR";"ESPAÑOLES";0;2;2
" 07";"NORTE";"PEÑAFLOR";"TOTAL POBLACION";0;2;2
" 07";"NORTE";"PILAS";"ESPAÑOLES";2;5;7
" 07";"NORTE";"PILAS";"TOTAL POBLACION";2;5;7
" 07";"NORTE";"PUEBLA DE CAZALLA (LA)";"EXTRANJEROS";0;1;1
" 07";"NORTE";"PUEBLA DE CAZALLA (LA)";"TOTAL POBLACION";0;1;1
" 07";"NORTE";"PUEBLA DEL RIO (LA)";"ESPAÑOLES";0;2;2
" 07";"NORTE";"PUEBLA DEL RIO (LA)";"TOTAL POBLACION";0;2;2
" 07";"NORTE";"RINCONADA (LA)";"ESPAÑOLES";48;70;118
" 07";"NORTE";"RINCONADA (LA)";"EXTRANJEROS";5;7;12
" 07";"NORTE";"RINCONADA (LA)";"TOTAL POBLACION";53;77;130
" 07";"NORTE";"RONQUILLO (EL)";"ESPAÑOLES";1;1;2
" 07";"NORTE";"RONQUILLO (EL)";"TOTAL POBLACION";1;1;2
" 07";"NORTE";"SALTERAS";"ESPAÑOLES";1;6;7
" 07";"NORTE";"SALTERAS";"TOTAL POBLACION";1;6;7
" 07";"NORTE";"SAN JUAN DE AZNALFARACHE";"ESPAÑOLES";15;15;30
" 07";"NORTE";"SAN JUAN DE AZNALFARACHE";"EXTRANJEROS";2;1;3
" 07";"NORTE";"SAN JUAN DE AZNALFARACHE";"TOTAL POBLACION";17;16;33
" 07";"NORTE";"SAN NICOLAS DEL PUERTO";"ESPAÑOLES";1;0;1
" 07";"NORTE";"SAN NICOLAS DEL PUERTO";"TOTAL POBLACION";1;0;1
" 07";"NORTE";"SANLUCAR LA MAYOR";"ESPAÑOLES";4;5;9
" 07";"NORTE";"SANLUCAR LA MAYOR";"EXTRANJEROS";1;1;2
" 07";"NORTE";"SANLUCAR LA MAYOR";"TOTAL POBLACION";5;6;11
" 07";"NORTE";"SANTIPONCE";"ESPAÑOLES";5;4;9
" 07";"NORTE";"SANTIPONCE";"TOTAL POBLACION";5;4;9
" 07";"NORTE";"TOCINA";"ESPAÑOLES";2;3;5
" 07";"NORTE";"TOCINA";"TOTAL POBLACION";2;3;5
" 07";"NORTE";"TOMARES";"ESPAÑOLES";6;8;14
" 07";"NORTE";"TOMARES";"EXTRANJEROS";2;2;4
" 07";"NORTE";"TOMARES";"TOTAL POBLACION";8;10;18
" 07";"NORTE";"UMBRETE";"ESPAÑOLES";4;2;6
" 07";"NORTE";"UMBRETE";"TOTAL POBLACION";4;2;6
" 07";"NORTE";"UTRERA";"ESPAÑOLES";3;3;6
" 07";"NORTE";"UTRERA";"EXTRANJEROS";0;3;3
" 07";"NORTE";"UTRERA";"TOTAL POBLACION";3;6;9
" 07";"NORTE";"VALENCINA DE LA CONCEPCION";"ESPAÑOLES";0;3;3
" 07";"NORTE";"VALENCINA DE LA CONCEPCION";"TOTAL POBLACION";0;3;3
" 07";"NORTE";"VILLAMANRIQUE DE LA CONDESA";"EXTRANJEROS";1;0;1
" 07";"NORTE";"VILLAMANRIQUE DE LA CONDESA";"TOTAL POBLACION";1;0;1
" 07";"NORTE";"VILLANUEVA DE SAN JUAN";"ESPAÑOLES";0;1;1
" 07";"NORTE";"VILLANUEVA DE SAN JUAN";"TOTAL POBLACION";0;1;1
" 07";"NORTE";"VILLANUEVA DEL ARISCAL";"ESPAÑOLES";5;6;11
" 07";"NORTE";"VILLANUEVA DEL ARISCAL";"TOTAL POBLACION";5;6;11
" 07";"NORTE";"VILLANUEVA DEL RIO Y MINAS";"ESPAÑOLES";0;1;1
" 07";"NORTE";"VILLANUEVA DEL RIO Y MINAS";"TOTAL POBLACION";0;1;1
" 07";"NORTE";"VILLAVERDE DEL RIO";"ESPAÑOLES";2;1;3
" 07";"NORTE";"VILLAVERDE DEL RIO";"TOTAL POBLACION";2;1;3
" 07";"NORTE";"VISO DEL ALCOR (EL)";"ESPAÑOLES";2;4;6
" 07";"NORTE";"VISO DEL ALCOR (EL)";"TOTAL POBLACION";2;4;6
" 08";"S. PABLO-STA. JUSTA";"- FUERA DE LA PROVINCIA DE SEVILLA";"ESPAÑOLES";318;278;596
" 08";"S. PABLO-STA. JUSTA";"- FUERA DE LA PROVINCIA DE SEVILLA";"EXTRANJEROS";61;62;123
" 08";"S. PABLO-STA. JUSTA";"- FUERA DE LA PROVINCIA DE SEVILLA";"TOTAL POBLACION";379;340;719
" 08";"S. PABLO-STA. JUSTA";"- PROVINCIA DE SEVILLA";"ESPAÑOLES";305;294;599
" 08";"S. PABLO-STA. JUSTA";"- PROVINCIA DE SEVILLA";"EXTRANJEROS";16;36;52
" 08";"S. PABLO-STA. JUSTA";"- PROVINCIA DE SEVILLA";"TOTAL POBLACION";321;330;651
" 08";"S. PABLO-STA. JUSTA";"ALBAIDA DEL ALJARAFE";"ESPAÑOLES";3;0;3
" 08";"S. PABLO-STA. JUSTA";"ALBAIDA DEL ALJARAFE";"TOTAL POBLACION";3;0;3
" 08";"S. PABLO-STA. JUSTA";"ALCALA DE GUADAIRA";"ESPAÑOLES";14;21;35
" 08";"S. PABLO-STA. JUSTA";"ALCALA DE GUADAIRA";"EXTRANJEROS";1;0;1
" 08";"S. PABLO-STA. JUSTA";"ALCALA DE GUADAIRA";"TOTAL POBLACION";15;21;36
" 08";"S. PABLO-STA. JUSTA";"ALCALA DEL RIO";"ESPAÑOLES";6;7;13
" 08";"S. PABLO-STA. JUSTA";"ALCALA DEL RIO";"TOTAL POBLACION";6;7;13
" 08";"S. PABLO-STA. JUSTA";"ALCOLEA DEL RIO";"ESPAÑOLES";0;1;1
" 08";"S. PABLO-STA. JUSTA";"ALCOLEA DEL RIO";"TOTAL POBLACION";0;1;1
" 08";"S. PABLO-STA. JUSTA";"ALGABA (LA)";"ESPAÑOLES";7;6;13
" 08";"S. PABLO-STA. JUSTA";"ALGABA (LA)";"EXTRANJEROS";0;1;1
" 08";"S. PABLO-STA. JUSTA";"ALGABA (LA)";"TOTAL POBLACION";7;7;14
" 08";"S. PABLO-STA. JUSTA";"ALMADEN DE LA PLATA";"ESPAÑOLES";2;0;2
" 08";"S. PABLO-STA. JUSTA";"ALMADEN DE LA PLATA";"TOTAL POBLACION";2;0;2
" 08";"S. PABLO-STA. JUSTA";"ALMENSILLA";"ESPAÑOLES";1;0;1
" 08";"S. PABLO-STA. JUSTA";"ALMENSILLA";"TOTAL POBLACION";1;0;1
" 08";"S. PABLO-STA. JUSTA";"AZNALCAZAR";"ESPAÑOLES";1;3;4
" 08";"S. PABLO-STA. JUSTA";"AZNALCAZAR";"TOTAL POBLACION";1;3;4
" 08";"S. PABLO-STA. JUSTA";"AZNALCOLLAR";"ESPAÑOLES";1;1;2
" 08";"S. PABLO-STA. JUSTA";"AZNALCOLLAR";"TOTAL POBLACION";1;1;2
" 08";"S. PABLO-STA. JUSTA";"BENACAZON";"ESPAÑOLES";0;1;1
" 08";"S. PABLO-STA. JUSTA";"BENACAZON";"TOTAL POBLACION";0;1;1
" 08";"S. PABLO-STA. JUSTA";"BOLLULLOS DE LA MITACION";"ESPAÑOLES";1;2;3
" 08";"S. PABLO-STA. JUSTA";"BOLLULLOS DE LA MITACION";"TOTAL POBLACION";1;2;3
" 08";"S. PABLO-STA. JUSTA";"BORMUJOS";"ESPAÑOLES";11;8;19
" 08";"S. PABLO-STA. JUSTA";"BORMUJOS";"TOTAL POBLACION";11;8;19
" 08";"S. PABLO-STA. JUSTA";"BRENES";"ESPAÑOLES";3;2;5
" 08";"S. PABLO-STA. JUSTA";"BRENES";"EXTRANJEROS";4;3;7
" 08";"S. PABLO-STA. JUSTA";"BRENES";"TOTAL POBLACION";7;5;12
" 08";"S. PABLO-STA. JUSTA";"BURGUILLOS";"ESPAÑOLES";3;4;7
" 08";"S. PABLO-STA. JUSTA";"BURGUILLOS";"EXTRANJEROS";0;1;1
" 08";"S. PABLO-STA. JUSTA";"BURGUILLOS";"TOTAL POBLACION";3;5;8
" 08";"S. PABLO-STA. JUSTA";"CAMAS";"ESPAÑOLES";5;10;15
" 08";"S. PABLO-STA. JUSTA";"CAMAS";"EXTRANJEROS";1;5;6
" 08";"S. PABLO-STA. JUSTA";"CAMAS";"TOTAL POBLACION";6;15;21
" 08";"S. PABLO-STA. JUSTA";"CARMONA";"ESPAÑOLES";18;15;33
" 08";"S. PABLO-STA. JUSTA";"CARMONA";"EXTRANJEROS";1;2;3
" 08";"S. PABLO-STA. JUSTA";"CARMONA";"TOTAL POBLACION";19;17;36
" 08";"S. PABLO-STA. JUSTA";"CARRION DE LOS CESPEDES";"ESPAÑOLES";0;1;1
" 08";"S. PABLO-STA. JUSTA";"CARRION DE LOS CESPEDES";"TOTAL POBLACION";0;1;1
" 08";"S. PABLO-STA. JUSTA";"CASARICHE";"ESPAÑOLES";1;0;1
" 08";"S. PABLO-STA. JUSTA";"CASARICHE";"TOTAL POBLACION";1;0;1
" 08";"S. PABLO-STA. JUSTA";"CASTILBLANCO DE LOS ARROYOS";"ESPAÑOLES";7;5;12
" 08";"S. PABLO-STA. JUSTA";"CASTILBLANCO DE LOS ARROYOS";"TOTAL POBLACION";7;5;12
" 08";"S. PABLO-STA. JUSTA";"CASTILLEJA DE LA CUESTA";"ESPAÑOLES";12;7;19
" 08";"S. PABLO-STA. JUSTA";"CASTILLEJA DE LA CUESTA";"TOTAL POBLACION";12;7;19
" 08";"S. PABLO-STA. JUSTA";"CASTILLO DE LAS GUARDAS (EL)";"ESPAÑOLES";2;2;4
" 08";"S. PABLO-STA. JUSTA";"CASTILLO DE LAS GUARDAS (EL)";"TOTAL POBLACION";2;2;4
" 08";"S. PABLO-STA. JUSTA";"CAZALLA DE LA SIERRA";"ESPAÑOLES";1;4;5
" 08";"S. PABLO-STA. JUSTA";"CAZALLA DE LA SIERRA";"TOTAL POBLACION";1;4;5
" 08";"S. PABLO-STA. JUSTA";"CONSTANTINA";"ESPAÑOLES";2;1;3
" 08";"S. PABLO-STA. JUSTA";"CONSTANTINA";"TOTAL POBLACION";2;1;3
" 08";"S. PABLO-STA. JUSTA";"CORIA DEL RIO";"ESPAÑOLES";4;3;7
" 08";"S. PABLO-STA. JUSTA";"CORIA DEL RIO";"EXTRANJEROS";0;2;2
" 08";"S. PABLO-STA. JUSTA";"CORIA DEL RIO";"TOTAL POBLACION";4;5;9
" 08";"S. PABLO-STA. JUSTA";"DOS HERMANAS";"ESPAÑOLES";53;49;102
" 08";"S. PABLO-STA. JUSTA";"DOS HERMANAS";"EXTRANJEROS";3;3;6
" 08";"S. PABLO-STA. JUSTA";"DOS HERMANAS";"TOTAL POBLACION";56;52;108
" 08";"S. PABLO-STA. JUSTA";"ECIJA";"ESPAÑOLES";1;2;3
" 08";"S. PABLO-STA. JUSTA";"ECIJA";"TOTAL POBLACION";1;2;3
" 08";"S. PABLO-STA. JUSTA";"ESPARTINAS";"ESPAÑOLES";2;4;6
" 08";"S. PABLO-STA. JUSTA";"ESPARTINAS";"TOTAL POBLACION";2;4;6
" 08";"S. PABLO-STA. JUSTA";"ESTEPA";"ESPAÑOLES";1;1;2
" 08";"S. PABLO-STA. JUSTA";"ESTEPA";"TOTAL POBLACION";1;1;2
" 08";"S. PABLO-STA. JUSTA";"FUENTES DE ANDALUCIA";"ESPAÑOLES";1;2;3
" 08";"S. PABLO-STA. JUSTA";"FUENTES DE ANDALUCIA";"TOTAL POBLACION";1;2;3
" 08";"S. PABLO-STA. JUSTA";"GELVES";"ESPAÑOLES";7;8;15
" 08";"S. PABLO-STA. JUSTA";"GELVES";"TOTAL POBLACION";7;8;15
" 08";"S. PABLO-STA. JUSTA";"GERENA";"ESPAÑOLES";5;5;10
" 08";"S. PABLO-STA. JUSTA";"GERENA";"EXTRANJEROS";0;2;2
" 08";"S. PABLO-STA. JUSTA";"GERENA";"TOTAL POBLACION";5;7;12
" 08";"S. PABLO-STA. JUSTA";"GINES";"ESPAÑOLES";3;1;4
" 08";"S. PABLO-STA. JUSTA";"GINES";"EXTRANJEROS";3;1;4
" 08";"S. PABLO-STA. JUSTA";"GINES";"TOTAL POBLACION";6;2;8
" 08";"S. PABLO-STA. JUSTA";"GUADALCANAL";"ESPAÑOLES";1;0;1
" 08";"S. PABLO-STA. JUSTA";"GUADALCANAL";"TOTAL POBLACION";1;0;1
" 08";"S. PABLO-STA. JUSTA";"GUILLENA";"ESPAÑOLES";9;10;19
" 08";"S. PABLO-STA. JUSTA";"GUILLENA";"EXTRANJEROS";2;2;4
" 08";"S. PABLO-STA. JUSTA";"GUILLENA";"TOTAL POBLACION";11;12;23
" 08";"S. PABLO-STA. JUSTA";"ISLA MAYOR";"ESPAÑOLES";2;1;3
" 08";"S. PABLO-STA. JUSTA";"ISLA MAYOR";"TOTAL POBLACION";2;1;3
" 08";"S. PABLO-STA. JUSTA";"LEBRIJA";"ESPAÑOLES";0;1;1
" 08";"S. PABLO-STA. JUSTA";"LEBRIJA";"TOTAL POBLACION";0;1;1
" 08";"S. PABLO-STA. JUSTA";"LORA DEL RIO";"ESPAÑOLES";1;1;2
" 08";"S. PABLO-STA. JUSTA";"LORA DEL RIO";"TOTAL POBLACION";1;1;2
" 08";"S. PABLO-STA. JUSTA";"MADROÑO (EL)";"ESPAÑOLES";2;2;4
" 08";"S. PABLO-STA. JUSTA";"MADROÑO (EL)";"TOTAL POBLACION";2;2;4
" 08";"S. PABLO-STA. JUSTA";"MAIRENA DEL ALCOR";"ESPAÑOLES";9;5;14
" 08";"S. PABLO-STA. JUSTA";"MAIRENA DEL ALCOR";"EXTRANJEROS";0;2;2
" 08";"S. PABLO-STA. JUSTA";"MAIRENA DEL ALCOR";"TOTAL POBLACION";9;7;16
" 08";"S. PABLO-STA. JUSTA";"MAIRENA DEL ALJARAFE";"ESPAÑOLES";17;18;35
" 08";"S. PABLO-STA. JUSTA";"MAIRENA DEL ALJARAFE";"EXTRANJEROS";0;2;2
" 08";"S. PABLO-STA. JUSTA";"MAIRENA DEL ALJARAFE";"TOTAL POBLACION";17;20;37
" 08";"S. PABLO-STA. JUSTA";"MARCHENA";"ESPAÑOLES";2;0;2
" 08";"S. PABLO-STA. JUSTA";"MARCHENA";"EXTRANJEROS";1;0;1
" 08";"S. PABLO-STA. JUSTA";"MARCHENA";"TOTAL POBLACION";3;0;3
" 08";"S. PABLO-STA. JUSTA";"MONTELLANO";"ESPAÑOLES";3;1;4
" 08";"S. PABLO-STA. JUSTA";"MONTELLANO";"TOTAL POBLACION";3;1;4
" 08";"S. PABLO-STA. JUSTA";"MORON DE LA FRONTERA";"ESPAÑOLES";3;0;3
" 08";"S. PABLO-STA. JUSTA";"MORON DE LA FRONTERA";"TOTAL POBLACION";3;0;3
" 08";"S. PABLO-STA. JUSTA";"OLIVARES";"ESPAÑOLES";5;3;8
" 08";"S. PABLO-STA. JUSTA";"OLIVARES";"TOTAL POBLACION";5;3;8
" 08";"S. PABLO-STA. JUSTA";"OSUNA";"ESPAÑOLES";1;1;2
" 08";"S. PABLO-STA. JUSTA";"OSUNA";"TOTAL POBLACION";1;1;2
" 08";"S. PABLO-STA. JUSTA";"PALACIOS Y VILLAFRANCA (LOS)";"ESPAÑOLES";1;0;1
" 08";"S. PABLO-STA. JUSTA";"PALACIOS Y VILLAFRANCA (LOS)";"TOTAL POBLACION";1;0;1
" 08";"S. PABLO-STA. JUSTA";"PALOMARES DEL RIO";"ESPAÑOLES";2;3;5
" 08";"S. PABLO-STA. JUSTA";"PALOMARES DEL RIO";"TOTAL POBLACION";2;3;5
" 08";"S. PABLO-STA. JUSTA";"PARADAS";"ESPAÑOLES";0;1;1
" 08";"S. PABLO-STA. JUSTA";"PARADAS";"TOTAL POBLACION";0;1;1
" 08";"S. PABLO-STA. JUSTA";"PEDRERA";"ESPAÑOLES";0;1;1
" 08";"S. PABLO-STA. JUSTA";"PEDRERA";"EXTRANJEROS";0;1;1
" 08";"S. PABLO-STA. JUSTA";"PEDRERA";"TOTAL POBLACION";0;2;2
" 08";"S. PABLO-STA. JUSTA";"PEDROSO (EL)";"ESPAÑOLES";2;2;4
" 08";"S. PABLO-STA. JUSTA";"PEDROSO (EL)";"TOTAL POBLACION";2;2;4
" 08";"S. PABLO-STA. JUSTA";"PEÑAFLOR";"ESPAÑOLES";1;0;1
" 08";"S. PABLO-STA. JUSTA";"PEÑAFLOR";"TOTAL POBLACION";1;0;1
" 08";"S. PABLO-STA. JUSTA";"PILAS";"ESPAÑOLES";2;2;4
" 08";"S. PABLO-STA. JUSTA";"PILAS";"TOTAL POBLACION";2;2;4
" 08";"S. PABLO-STA. JUSTA";"REAL DE LA JARA (EL)";"ESPAÑOLES";1;0;1
" 08";"S. PABLO-STA. JUSTA";"REAL DE LA JARA (EL)";"TOTAL POBLACION";1;0;1
" 08";"S. PABLO-STA. JUSTA";"RINCONADA (LA)";"ESPAÑOLES";17;15;32
" 08";"S. PABLO-STA. JUSTA";"RINCONADA (LA)";"EXTRANJEROS";0;1;1
" 08";"S. PABLO-STA. JUSTA";"RINCONADA (LA)";"TOTAL POBLACION";17;16;33
" 08";"S. PABLO-STA. JUSTA";"RONQUILLO (EL)";"ESPAÑOLES";2;7;9
" 08";"S. PABLO-STA. JUSTA";"RONQUILLO (EL)";"TOTAL POBLACION";2;7;9
" 08";"S. PABLO-STA. JUSTA";"SALTERAS";"EXTRANJEROS";0;2;2
" 08";"S. PABLO-STA. JUSTA";"SALTERAS";"TOTAL POBLACION";0;2;2
" 08";"S. PABLO-STA. JUSTA";"SAN JUAN DE AZNALFARACHE";"ESPAÑOLES";11;13;24
" 08";"S. PABLO-STA. JUSTA";"SAN JUAN DE AZNALFARACHE";"EXTRANJEROS";0;4;4
" 08";"S. PABLO-STA. JUSTA";"SAN JUAN DE AZNALFARACHE";"TOTAL POBLACION";11;17;28
" 08";"S. PABLO-STA. JUSTA";"SANLUCAR LA MAYOR";"ESPAÑOLES";4;2;6
" 08";"S. PABLO-STA. JUSTA";"SANLUCAR LA MAYOR";"TOTAL POBLACION";4;2;6
" 08";"S. PABLO-STA. JUSTA";"SANTIPONCE";"ESPAÑOLES";1;1;2
" 08";"S. PABLO-STA. JUSTA";"SANTIPONCE";"EXTRANJEROS";0;1;1
" 08";"S. PABLO-STA. JUSTA";"SANTIPONCE";"TOTAL POBLACION";1;2;3
" 08";"S. PABLO-STA. JUSTA";"TOCINA";"ESPAÑOLES";0;5;5
" 08";"S. PABLO-STA. JUSTA";"TOCINA";"TOTAL POBLACION";0;5;5
" 08";"S. PABLO-STA. JUSTA";"TOMARES";"ESPAÑOLES";11;5;16
" 08";"S. PABLO-STA. JUSTA";"TOMARES";"TOTAL POBLACION";11;5;16
" 08";"S. PABLO-STA. JUSTA";"UMBRETE";"ESPAÑOLES";0;2;2
" 08";"S. PABLO-STA. JUSTA";"UMBRETE";"TOTAL POBLACION";0;2;2
" 08";"S. PABLO-STA. JUSTA";"UTRERA";"ESPAÑOLES";5;6;11
" 08";"S. PABLO-STA. JUSTA";"UTRERA";"TOTAL POBLACION";5;6;11
" 08";"S. PABLO-STA. JUSTA";"VALENCINA DE LA CONCEPCION";"ESPAÑOLES";2;0;2
" 08";"S. PABLO-STA. JUSTA";"VALENCINA DE LA CONCEPCION";"TOTAL POBLACION";2;0;2
" 08";"S. PABLO-STA. JUSTA";"VILLAMANRIQUE DE LA CONDESA";"ESPAÑOLES";1;1;2
" 08";"S. PABLO-STA. JUSTA";"VILLAMANRIQUE DE LA CONDESA";"TOTAL POBLACION";1;1;2
" 08";"S. PABLO-STA. JUSTA";"VILLANUEVA DEL ARISCAL";"ESPAÑOLES";3;3;6
" 08";"S. PABLO-STA. JUSTA";"VILLANUEVA DEL ARISCAL";"TOTAL POBLACION";3;3;6
" 08";"S. PABLO-STA. JUSTA";"VILLAVERDE DEL RIO";"ESPAÑOLES";0;1;1
" 08";"S. PABLO-STA. JUSTA";"VILLAVERDE DEL RIO";"EXTRANJEROS";0;1;1
" 08";"S. PABLO-STA. JUSTA";"VILLAVERDE DEL RIO";"TOTAL POBLACION";0;2;2
" 08";"S. PABLO-STA. JUSTA";"VISO DEL ALCOR (EL)";"ESPAÑOLES";6;5;11
" 08";"S. PABLO-STA. JUSTA";"VISO DEL ALCOR (EL)";"TOTAL POBLACION";6;5;11
" 09";"ESTE";"- FUERA DE LA PROVINCIA DE SEVILLA";"ESPAÑOLES";425;404;829
" 09";"ESTE";"- FUERA DE LA PROVINCIA DE SEVILLA";"EXTRANJEROS";90;83;173
" 09";"ESTE";"- FUERA DE LA PROVINCIA DE SEVILLA";"TOTAL POBLACION";515;487;1002
" 09";"ESTE";"- PROVINCIA DE SEVILLA";"ESPAÑOLES";459;436;895
" 09";"ESTE";"- PROVINCIA DE SEVILLA";"EXTRANJEROS";37;69;106
" 09";"ESTE";"- PROVINCIA DE SEVILLA";"TOTAL POBLACION";496;505;1001
" 09";"ESTE";"AGUADULCE";"ESPAÑOLES";0;1;1
" 09";"ESTE";"AGUADULCE";"TOTAL POBLACION";0;1;1
" 09";"ESTE";"ALANIS";"ESPAÑOLES";0;1;1
" 09";"ESTE";"ALANIS";"TOTAL POBLACION";0;1;1
" 09";"ESTE";"ALCALA DE GUADAIRA";"ESPAÑOLES";91;92;183
" 09";"ESTE";"ALCALA DE GUADAIRA";"EXTRANJEROS";5;5;10
" 09";"ESTE";"ALCALA DE GUADAIRA";"TOTAL POBLACION";96;97;193
" 09";"ESTE";"ALCALA DEL RIO";"ESPAÑOLES";2;8;10
" 09";"ESTE";"ALCALA DEL RIO";"EXTRANJEROS";1;0;1
" 09";"ESTE";"ALCALA DEL RIO";"TOTAL POBLACION";3;8;11
" 09";"ESTE";"ALGABA (LA)";"ESPAÑOLES";3;3;6
" 09";"ESTE";"ALGABA (LA)";"EXTRANJEROS";2;3;5
" 09";"ESTE";"ALGABA (LA)";"TOTAL POBLACION";5;6;11
" 09";"ESTE";"ALMENSILLA";"ESPAÑOLES";1;0;1
" 09";"ESTE";"ALMENSILLA";"TOTAL POBLACION";1;0;1
" 09";"ESTE";"ARAHAL (EL)";"ESPAÑOLES";3;3;6
" 09";"ESTE";"ARAHAL (EL)";"TOTAL POBLACION";3;3;6
" 09";"ESTE";"AZNALCAZAR";"ESPAÑOLES";0;1;1
" 09";"ESTE";"AZNALCAZAR";"TOTAL POBLACION";0;1;1
" 09";"ESTE";"AZNALCOLLAR";"ESPAÑOLES";2;1;3
" 09";"ESTE";"AZNALCOLLAR";"TOTAL POBLACION";2;1;3
" 09";"ESTE";"BOLLULLOS DE LA MITACION";"ESPAÑOLES";5;6;11
" 09";"ESTE";"BOLLULLOS DE LA MITACION";"EXTRANJEROS";0;2;2
" 09";"ESTE";"BOLLULLOS DE LA MITACION";"TOTAL POBLACION";5;8;13
" 09";"ESTE";"BORMUJOS";"ESPAÑOLES";14;13;27
" 09";"ESTE";"BORMUJOS";"EXTRANJEROS";0;1;1
" 09";"ESTE";"BORMUJOS";"TOTAL POBLACION";14;14;28
" 09";"ESTE";"BRENES";"ESPAÑOLES";1;2;3
" 09";"ESTE";"BRENES";"EXTRANJEROS";0;1;1
" 09";"ESTE";"BRENES";"TOTAL POBLACION";1;3;4
" 09";"ESTE";"BURGUILLOS";"ESPAÑOLES";5;7;12
" 09";"ESTE";"BURGUILLOS";"EXTRANJEROS";2;1;3
" 09";"ESTE";"BURGUILLOS";"TOTAL POBLACION";7;8;15
" 09";"ESTE";"CAMAS";"ESPAÑOLES";16;13;29
" 09";"ESTE";"CAMAS";"EXTRANJEROS";4;6;10
" 09";"ESTE";"CAMAS";"TOTAL POBLACION";20;19;39
" 09";"ESTE";"CAMPANA (LA)";"ESPAÑOLES";2;1;3
" 09";"ESTE";"CAMPANA (LA)";"TOTAL POBLACION";2;1;3
" 09";"ESTE";"CANTILLANA";"ESPAÑOLES";2;1;3
" 09";"ESTE";"CANTILLANA";"TOTAL POBLACION";2;1;3
" 09";"ESTE";"CARMONA";"ESPAÑOLES";36;32;68
" 09";"ESTE";"CARMONA";"EXTRANJEROS";2;6;8
" 09";"ESTE";"CARMONA";"TOTAL POBLACION";38;38;76
" 09";"ESTE";"CASARICHE";"ESPAÑOLES";1;0;1
" 09";"ESTE";"CASARICHE";"TOTAL POBLACION";1;0;1
" 09";"ESTE";"CASTILBLANCO DE LOS ARROYOS";"ESPAÑOLES";3;4;7
" 09";"ESTE";"CASTILBLANCO DE LOS ARROYOS";"EXTRANJEROS";0;1;1
" 09";"ESTE";"CASTILBLANCO DE LOS ARROYOS";"TOTAL POBLACION";3;5;8
" 09";"ESTE";"CASTILLEJA DE GUZMAN";"ESPAÑOLES";1;3;4
" 09";"ESTE";"CASTILLEJA DE GUZMAN";"TOTAL POBLACION";1;3;4
" 09";"ESTE";"CASTILLEJA DE LA CUESTA";"ESPAÑOLES";3;5;8
" 09";"ESTE";"CASTILLEJA DE LA CUESTA";"EXTRANJEROS";2;0;2
" 09";"ESTE";"CASTILLEJA DE LA CUESTA";"TOTAL POBLACION";5;5;10
" 09";"ESTE";"CASTILLEJA DEL CAMPO";"ESPAÑOLES";1;0;1
" 09";"ESTE";"CASTILLEJA DEL CAMPO";"TOTAL POBLACION";1;0;1
" 09";"ESTE";"CASTILLO DE LAS GUARDAS (EL)";"ESPAÑOLES";2;0;2
" 09";"ESTE";"CASTILLO DE LAS GUARDAS (EL)";"TOTAL POBLACION";2;0;2
" 09";"ESTE";"CAZALLA DE LA SIERRA";"ESPAÑOLES";2;0;2
" 09";"ESTE";"CAZALLA DE LA SIERRA";"TOTAL POBLACION";2;0;2
" 09";"ESTE";"CONSTANTINA";"ESPAÑOLES";1;1;2
" 09";"ESTE";"CONSTANTINA";"TOTAL POBLACION";1;1;2
" 09";"ESTE";"CORIA DEL RIO";"ESPAÑOLES";6;5;11
" 09";"ESTE";"CORIA DEL RIO";"EXTRANJEROS";2;0;2
" 09";"ESTE";"CORIA DEL RIO";"TOTAL POBLACION";8;5;13
" 09";"ESTE";"CORONIL (EL)";"ESPAÑOLES";1;0;1
" 09";"ESTE";"CORONIL (EL)";"TOTAL POBLACION";1;0;1
" 09";"ESTE";"DOS HERMANAS";"ESPAÑOLES";69;73;142
" 09";"ESTE";"DOS HERMANAS";"EXTRANJEROS";2;12;14
" 09";"ESTE";"DOS HERMANAS";"TOTAL POBLACION";71;85;156
" 09";"ESTE";"ECIJA";"ESPAÑOLES";2;0;2
" 09";"ESTE";"ECIJA";"TOTAL POBLACION";2;0;2
" 09";"ESTE";"ESPARTINAS";"ESPAÑOLES";9;9;18
" 09";"ESTE";"ESPARTINAS";"EXTRANJEROS";1;0;1
" 09";"ESTE";"ESPARTINAS";"TOTAL POBLACION";10;9;19
" 09";"ESTE";"ESTEPA";"EXTRANJEROS";0;2;2
" 09";"ESTE";"ESTEPA";"TOTAL POBLACION";0;2;2
" 09";"ESTE";"FUENTES DE ANDALUCIA";"ESPAÑOLES";1;0;1
" 09";"ESTE";"FUENTES DE ANDALUCIA";"TOTAL POBLACION";1;0;1
" 09";"ESTE";"GELVES";"ESPAÑOLES";10;8;18
" 09";"ESTE";"GELVES";"EXTRANJEROS";1;0;1
" 09";"ESTE";"GELVES";"TOTAL POBLACION";11;8;19
" 09";"ESTE";"GERENA";"ESPAÑOLES";2;1;3
" 09";"ESTE";"GERENA";"EXTRANJEROS";0;1;1
" 09";"ESTE";"GERENA";"TOTAL POBLACION";2;2;4
" 09";"ESTE";"GILENA";"ESPAÑOLES";1;1;2
" 09";"ESTE";"GILENA";"TOTAL POBLACION";1;1;2
" 09";"ESTE";"GINES";"ESPAÑOLES";2;4;6
" 09";"ESTE";"GINES";"TOTAL POBLACION";2;4;6
" 09";"ESTE";"GUADALCANAL";"ESPAÑOLES";0;1;1
" 09";"ESTE";"GUADALCANAL";"TOTAL POBLACION";0;1;1
" 09";"ESTE";"GUILLENA";"ESPAÑOLES";7;5;12
" 09";"ESTE";"GUILLENA";"EXTRANJEROS";1;1;2
" 09";"ESTE";"GUILLENA";"TOTAL POBLACION";8;6;14
" 09";"ESTE";"HUEVAR DEL ALJARAFE";"ESPAÑOLES";0;1;1
" 09";"ESTE";"HUEVAR DEL ALJARAFE";"TOTAL POBLACION";0;1;1
" 09";"ESTE";"LANTEJUELA (LA)";"ESPAÑOLES";1;0;1
" 09";"ESTE";"LANTEJUELA (LA)";"TOTAL POBLACION";1;0;1
" 09";"ESTE";"LEBRIJA";"ESPAÑOLES";4;2;6
" 09";"ESTE";"LEBRIJA";"TOTAL POBLACION";4;2;6
" 09";"ESTE";"LORA DEL RIO";"ESPAÑOLES";3;2;5
" 09";"ESTE";"LORA DEL RIO";"TOTAL POBLACION";3;2;5
" 09";"ESTE";"LUISIANA (LA)";"ESPAÑOLES";0;1;1
" 09";"ESTE";"LUISIANA (LA)";"TOTAL POBLACION";0;1;1
" 09";"ESTE";"MAIRENA DEL ALCOR";"ESPAÑOLES";21;13;34
" 09";"ESTE";"MAIRENA DEL ALCOR";"EXTRANJEROS";3;5;8
" 09";"ESTE";"MAIRENA DEL ALCOR";"TOTAL POBLACION";24;18;42
" 09";"ESTE";"MAIRENA DEL ALJARAFE";"ESPAÑOLES";10;13;23
" 09";"ESTE";"MAIRENA DEL ALJARAFE";"TOTAL POBLACION";10;13;23
" 09";"ESTE";"MARCHENA";"ESPAÑOLES";3;3;6
" 09";"ESTE";"MARCHENA";"TOTAL POBLACION";3;3;6
" 09";"ESTE";"MONTELLANO";"ESPAÑOLES";0;1;1
" 09";"ESTE";"MONTELLANO";"TOTAL POBLACION";0;1;1
" 09";"ESTE";"MORON DE LA FRONTERA";"ESPAÑOLES";1;3;4
" 09";"ESTE";"MORON DE LA FRONTERA";"TOTAL POBLACION";1;3;4
" 09";"ESTE";"OLIVARES";"ESPAÑOLES";0;2;2
" 09";"ESTE";"OLIVARES";"TOTAL POBLACION";0;2;2
" 09";"ESTE";"PALACIOS Y VILLAFRANCA (LOS)";"ESPAÑOLES";4;5;9
" 09";"ESTE";"PALACIOS Y VILLAFRANCA (LOS)";"EXTRANJEROS";0;2;2
" 09";"ESTE";"PALACIOS Y VILLAFRANCA (LOS)";"TOTAL POBLACION";4;7;11
" 09";"ESTE";"PALOMARES DEL RIO";"ESPAÑOLES";3;2;5
" 09";"ESTE";"PALOMARES DEL RIO";"EXTRANJEROS";0;1;1
" 09";"ESTE";"PALOMARES DEL RIO";"TOTAL POBLACION";3;3;6
" 09";"ESTE";"PEDROSO (EL)";"ESPAÑOLES";1;3;4
" 09";"ESTE";"PEDROSO (EL)";"TOTAL POBLACION";1;3;4
" 09";"ESTE";"PILAS";"ESPAÑOLES";5;3;8
" 09";"ESTE";"PILAS";"TOTAL POBLACION";5;3;8
" 09";"ESTE";"PUEBLA DE CAZALLA (LA)";"ESPAÑOLES";0;3;3
" 09";"ESTE";"PUEBLA DE CAZALLA (LA)";"TOTAL POBLACION";0;3;3
" 09";"ESTE";"PUEBLA DE LOS INFANTES (LA)";"ESPAÑOLES";0;1;1
" 09";"ESTE";"PUEBLA DE LOS INFANTES (LA)";"TOTAL POBLACION";0;1;1
" 09";"ESTE";"REAL DE LA JARA (EL)";"ESPAÑOLES";2;2;4
" 09";"ESTE";"REAL DE LA JARA (EL)";"TOTAL POBLACION";2;2;4
" 09";"ESTE";"RINCONADA (LA)";"ESPAÑOLES";37;27;64
" 09";"ESTE";"RINCONADA (LA)";"EXTRANJEROS";0;1;1
" 09";"ESTE";"RINCONADA (LA)";"TOTAL POBLACION";37;28;65
" 09";"ESTE";"SALTERAS";"ESPAÑOLES";2;1;3
" 09";"ESTE";"SALTERAS";"TOTAL POBLACION";2;1;3
" 09";"ESTE";"SAN JUAN DE AZNALFARACHE";"ESPAÑOLES";8;8;16
" 09";"ESTE";"SAN JUAN DE AZNALFARACHE";"EXTRANJEROS";7;9;16
" 09";"ESTE";"SAN JUAN DE AZNALFARACHE";"TOTAL POBLACION";15;17;32
" 09";"ESTE";"SANLUCAR LA MAYOR";"ESPAÑOLES";1;2;3
" 09";"ESTE";"SANLUCAR LA MAYOR";"TOTAL POBLACION";1;2;3
" 09";"ESTE";"SANTIPONCE";"ESPAÑOLES";4;2;6
" 09";"ESTE";"SANTIPONCE";"EXTRANJEROS";0;1;1
" 09";"ESTE";"SANTIPONCE";"TOTAL POBLACION";4;3;7
" 09";"ESTE";"TOCINA";"ESPAÑOLES";4;3;7
" 09";"ESTE";"TOCINA";"TOTAL POBLACION";4;3;7
" 09";"ESTE";"TOMARES";"ESPAÑOLES";6;3;9
" 09";"ESTE";"TOMARES";"EXTRANJEROS";0;2;2
" 09";"ESTE";"TOMARES";"TOTAL POBLACION";6;5;11
" 09";"ESTE";"UMBRETE";"ESPAÑOLES";4;1;5
" 09";"ESTE";"UMBRETE";"EXTRANJEROS";0;1;1
" 09";"ESTE";"UMBRETE";"TOTAL POBLACION";4;2;6
" 09";"ESTE";"UTRERA";"ESPAÑOLES";15;12;27
" 09";"ESTE";"UTRERA";"EXTRANJEROS";1;2;3
" 09";"ESTE";"UTRERA";"TOTAL POBLACION";16;14;30
" 09";"ESTE";"VALENCINA DE LA CONCEPCION";"ESPAÑOLES";1;0;1
" 09";"ESTE";"VALENCINA DE LA CONCEPCION";"EXTRANJEROS";0;1;1
" 09";"ESTE";"VALENCINA DE LA CONCEPCION";"TOTAL POBLACION";1;1;2
" 09";"ESTE";"VILLANUEVA DE SAN JUAN";"ESPAÑOLES";1;0;1
" 09";"ESTE";"VILLANUEVA DE SAN JUAN";"TOTAL POBLACION";1;0;1
" 09";"ESTE";"VILLANUEVA DEL ARISCAL";"ESPAÑOLES";0;1;1
" 09";"ESTE";"VILLANUEVA DEL ARISCAL";"TOTAL POBLACION";0;1;1
" 09";"ESTE";"VILLANUEVA DEL RIO Y MINAS";"ESPAÑOLES";4;2;6
" 09";"ESTE";"VILLANUEVA DEL RIO Y MINAS";"TOTAL POBLACION";4;2;6
" 09";"ESTE";"VILLAVERDE DEL RIO";"ESPAÑOLES";2;2;4
" 09";"ESTE";"VILLAVERDE DEL RIO";"TOTAL POBLACION";2;2;4
" 09";"ESTE";"VISO DEL ALCOR (EL)";"ESPAÑOLES";5;7;12
" 09";"ESTE";"VISO DEL ALCOR (EL)";"EXTRANJEROS";1;2;3
" 09";"ESTE";"VISO DEL ALCOR (EL)";"TOTAL POBLACION";6;9;15
" 10";"BELLAVISTA-LA PALMERA";"- FUERA DE LA PROVINCIA DE SEVILLA";"ESPAÑOLES";283;291;574
" 10";"BELLAVISTA-LA PALMERA";"- FUERA DE LA PROVINCIA DE SEVILLA";"EXTRANJEROS";50;56;106
" 10";"BELLAVISTA-LA PALMERA";"- FUERA DE LA PROVINCIA DE SEVILLA";"TOTAL POBLACION";333;347;680
" 10";"BELLAVISTA-LA PALMERA";"- PROVINCIA DE SEVILLA";"ESPAÑOLES";279;265;544
" 10";"BELLAVISTA-LA PALMERA";"- PROVINCIA DE SEVILLA";"EXTRANJEROS";19;23;42
" 10";"BELLAVISTA-LA PALMERA";"- PROVINCIA DE SEVILLA";"NO CONSTA";1;0;1
" 10";"BELLAVISTA-LA PALMERA";"- PROVINCIA DE SEVILLA";"TOTAL POBLACION";299;288;587
" 10";"BELLAVISTA-LA PALMERA";"ALCALA DE GUADAIRA";"ESPAÑOLES";25;24;49
" 10";"BELLAVISTA-LA PALMERA";"ALCALA DE GUADAIRA";"EXTRANJEROS";3;2;5
" 10";"BELLAVISTA-LA PALMERA";"ALCALA DE GUADAIRA";"NO CONSTA";1;0;1
" 10";"BELLAVISTA-LA PALMERA";"ALCALA DE GUADAIRA";"TOTAL POBLACION";29;26;55
" 10";"BELLAVISTA-LA PALMERA";"ALCALA DEL RIO";"ESPAÑOLES";1;1;2
" 10";"BELLAVISTA-LA PALMERA";"ALCALA DEL RIO";"TOTAL POBLACION";1;1;2
" 10";"BELLAVISTA-LA PALMERA";"ALGABA (LA)";"ESPAÑOLES";3;0;3
" 10";"BELLAVISTA-LA PALMERA";"ALGABA (LA)";"EXTRANJEROS";0;1;1
" 10";"BELLAVISTA-LA PALMERA";"ALGABA (LA)";"TOTAL POBLACION";3;1;4
" 10";"BELLAVISTA-LA PALMERA";"ARAHAL (EL)";"ESPAÑOLES";0;1;1
" 10";"BELLAVISTA-LA PALMERA";"ARAHAL (EL)";"TOTAL POBLACION";0;1;1
" 10";"BELLAVISTA-LA PALMERA";"AZNALCAZAR";"ESPAÑOLES";1;0;1
" 10";"BELLAVISTA-LA PALMERA";"AZNALCAZAR";"EXTRANJEROS";0;1;1
" 10";"BELLAVISTA-LA PALMERA";"AZNALCAZAR";"TOTAL POBLACION";1;1;2
" 10";"BELLAVISTA-LA PALMERA";"BENACAZON";"ESPAÑOLES";2;1;3
" 10";"BELLAVISTA-LA PALMERA";"BENACAZON";"TOTAL POBLACION";2;1;3
" 10";"BELLAVISTA-LA PALMERA";"BOLLULLOS DE LA MITACION";"ESPAÑOLES";0;1;1
" 10";"BELLAVISTA-LA PALMERA";"BOLLULLOS DE LA MITACION";"TOTAL POBLACION";0;1;1
" 10";"BELLAVISTA-LA PALMERA";"BORMUJOS";"ESPAÑOLES";7;3;10
" 10";"BELLAVISTA-LA PALMERA";"BORMUJOS";"TOTAL POBLACION";7;3;10
" 10";"BELLAVISTA-LA PALMERA";"BRENES";"ESPAÑOLES";3;2;5
" 10";"BELLAVISTA-LA PALMERA";"BRENES";"TOTAL POBLACION";3;2;5
" 10";"BELLAVISTA-LA PALMERA";"BURGUILLOS";"ESPAÑOLES";1;1;2
" 10";"BELLAVISTA-LA PALMERA";"BURGUILLOS";"TOTAL POBLACION";1;1;2
" 10";"BELLAVISTA-LA PALMERA";"CAMAS";"ESPAÑOLES";4;4;8
" 10";"BELLAVISTA-LA PALMERA";"CAMAS";"TOTAL POBLACION";4;4;8
" 10";"BELLAVISTA-LA PALMERA";"CARMONA";"ESPAÑOLES";5;6;11
" 10";"BELLAVISTA-LA PALMERA";"CARMONA";"EXTRANJEROS";2;1;3
" 10";"BELLAVISTA-LA PALMERA";"CARMONA";"TOTAL POBLACION";7;7;14
" 10";"BELLAVISTA-LA PALMERA";"CASTILBLANCO DE LOS ARROYOS";"ESPAÑOLES";2;1;3
" 10";"BELLAVISTA-LA PALMERA";"CASTILBLANCO DE LOS ARROYOS";"TOTAL POBLACION";2;1;3
" 10";"BELLAVISTA-LA PALMERA";"CASTILLEJA DE LA CUESTA";"ESPAÑOLES";3;6;9
" 10";"BELLAVISTA-LA PALMERA";"CASTILLEJA DE LA CUESTA";"EXTRANJEROS";0;1;1
" 10";"BELLAVISTA-LA PALMERA";"CASTILLEJA DE LA CUESTA";"TOTAL POBLACION";3;7;10
" 10";"BELLAVISTA-LA PALMERA";"CASTILLO DE LAS GUARDAS (EL)";"ESPAÑOLES";1;2;3
" 10";"BELLAVISTA-LA PALMERA";"CASTILLO DE LAS GUARDAS (EL)";"TOTAL POBLACION";1;2;3
" 10";"BELLAVISTA-LA PALMERA";"CONSTANTINA";"ESPAÑOLES";0;1;1
" 10";"BELLAVISTA-LA PALMERA";"CONSTANTINA";"TOTAL POBLACION";0;1;1
" 10";"BELLAVISTA-LA PALMERA";"CORIA DEL RIO";"ESPAÑOLES";10;5;15
" 10";"BELLAVISTA-LA PALMERA";"CORIA DEL RIO";"EXTRANJEROS";1;1;2
" 10";"BELLAVISTA-LA PALMERA";"CORIA DEL RIO";"TOTAL POBLACION";11;6;17
" 10";"BELLAVISTA-LA PALMERA";"CORIPE";"ESPAÑOLES";0;1;1
" 10";"BELLAVISTA-LA PALMERA";"CORIPE";"TOTAL POBLACION";0;1;1
" 10";"BELLAVISTA-LA PALMERA";"CORRALES (LOS)";"ESPAÑOLES";1;0;1
" 10";"BELLAVISTA-LA PALMERA";"CORRALES (LOS)";"EXTRANJEROS";1;1;2
" 10";"BELLAVISTA-LA PALMERA";"CORRALES (LOS)";"TOTAL POBLACION";2;1;3
" 10";"BELLAVISTA-LA PALMERA";"DOS HERMANAS";"ESPAÑOLES";120;118;238
" 10";"BELLAVISTA-LA PALMERA";"DOS HERMANAS";"EXTRANJEROS";7;10;17
" 10";"BELLAVISTA-LA PALMERA";"DOS HERMANAS";"TOTAL POBLACION";127;128;255
" 10";"BELLAVISTA-LA PALMERA";"ECIJA";"ESPAÑOLES";1;1;2
" 10";"BELLAVISTA-LA PALMERA";"ECIJA";"TOTAL POBLACION";1;1;2
" 10";"BELLAVISTA-LA PALMERA";"ESPARTINAS";"ESPAÑOLES";3;1;4
" 10";"BELLAVISTA-LA PALMERA";"ESPARTINAS";"TOTAL POBLACION";3;1;4
" 10";"BELLAVISTA-LA PALMERA";"GELVES";"ESPAÑOLES";11;6;17
" 10";"BELLAVISTA-LA PALMERA";"GELVES";"EXTRANJEROS";0;1;1
" 10";"BELLAVISTA-LA PALMERA";"GELVES";"TOTAL POBLACION";11;7;18
" 10";"BELLAVISTA-LA PALMERA";"GERENA";"ESPAÑOLES";1;1;2
" 10";"BELLAVISTA-LA PALMERA";"GERENA";"TOTAL POBLACION";1;1;2
" 10";"BELLAVISTA-LA PALMERA";"GINES";"ESPAÑOLES";4;1;5
" 10";"BELLAVISTA-LA PALMERA";"GINES";"TOTAL POBLACION";4;1;5
" 10";"BELLAVISTA-LA PALMERA";"GUILLENA";"ESPAÑOLES";4;6;10
" 10";"BELLAVISTA-LA PALMERA";"GUILLENA";"TOTAL POBLACION";4;6;10
" 10";"BELLAVISTA-LA PALMERA";"LANTEJUELA (LA)";"ESPAÑOLES";1;2;3
" 10";"BELLAVISTA-LA PALMERA";"LANTEJUELA (LA)";"TOTAL POBLACION";1;2;3
" 10";"BELLAVISTA-LA PALMERA";"LEBRIJA";"ESPAÑOLES";1;3;4
" 10";"BELLAVISTA-LA PALMERA";"LEBRIJA";"TOTAL POBLACION";1;3;4
" 10";"BELLAVISTA-LA PALMERA";"LUISIANA (LA)";"ESPAÑOLES";0;1;1
" 10";"BELLAVISTA-LA PALMERA";"LUISIANA (LA)";"TOTAL POBLACION";0;1;1
" 10";"BELLAVISTA-LA PALMERA";"MAIRENA DEL ALCOR";"ESPAÑOLES";4;1;5
" 10";"BELLAVISTA-LA PALMERA";"MAIRENA DEL ALCOR";"TOTAL POBLACION";4;1;5
" 10";"BELLAVISTA-LA PALMERA";"MAIRENA DEL ALJARAFE";"ESPAÑOLES";10;14;24
" 10";"BELLAVISTA-LA PALMERA";"MAIRENA DEL ALJARAFE";"EXTRANJEROS";1;1;2
" 10";"BELLAVISTA-LA PALMERA";"MAIRENA DEL ALJARAFE";"TOTAL POBLACION";11;15;26
" 10";"BELLAVISTA-LA PALMERA";"MORON DE LA FRONTERA";"ESPAÑOLES";4;2;6
" 10";"BELLAVISTA-LA PALMERA";"MORON DE LA FRONTERA";"TOTAL POBLACION";4;2;6
" 10";"BELLAVISTA-LA PALMERA";"PALACIOS Y VILLAFRANCA (LOS)";"ESPAÑOLES";2;2;4
" 10";"BELLAVISTA-LA PALMERA";"PALACIOS Y VILLAFRANCA (LOS)";"TOTAL POBLACION";2;2;4
" 10";"BELLAVISTA-LA PALMERA";"PALOMARES DEL RIO";"ESPAÑOLES";3;4;7
" 10";"BELLAVISTA-LA PALMERA";"PALOMARES DEL RIO";"TOTAL POBLACION";3;4;7
" 10";"BELLAVISTA-LA PALMERA";"PEDRERA";"ESPAÑOLES";0;1;1
" 10";"BELLAVISTA-LA PALMERA";"PEDRERA";"TOTAL POBLACION";0;1;1
" 10";"BELLAVISTA-LA PALMERA";"PILAS";"ESPAÑOLES";0;1;1
" 10";"BELLAVISTA-LA PALMERA";"PILAS";"TOTAL POBLACION";0;1;1
" 10";"BELLAVISTA-LA PALMERA";"PUEBLA DE LOS INFANTES (LA)";"ESPAÑOLES";0;1;1
" 10";"BELLAVISTA-LA PALMERA";"PUEBLA DE LOS INFANTES (LA)";"TOTAL POBLACION";0;1;1
" 10";"BELLAVISTA-LA PALMERA";"RINCONADA (LA)";"ESPAÑOLES";4;8;12
" 10";"BELLAVISTA-LA PALMERA";"RINCONADA (LA)";"EXTRANJEROS";1;0;1
" 10";"BELLAVISTA-LA PALMERA";"RINCONADA (LA)";"TOTAL POBLACION";5;8;13
" 10";"BELLAVISTA-LA PALMERA";"RUBIO (EL)";"EXTRANJEROS";1;0;1
" 10";"BELLAVISTA-LA PALMERA";"RUBIO (EL)";"TOTAL POBLACION";1;0;1
" 10";"BELLAVISTA-LA PALMERA";"SALTERAS";"ESPAÑOLES";1;0;1
" 10";"BELLAVISTA-LA PALMERA";"SALTERAS";"TOTAL POBLACION";1;0;1
" 10";"BELLAVISTA-LA PALMERA";"SAN JUAN DE AZNALFARACHE";"ESPAÑOLES";7;6;13
" 10";"BELLAVISTA-LA PALMERA";"SAN JUAN DE AZNALFARACHE";"TOTAL POBLACION";7;6;13
" 10";"BELLAVISTA-LA PALMERA";"SAN NICOLAS DEL PUERTO";"ESPAÑOLES";1;0;1
" 10";"BELLAVISTA-LA PALMERA";"SAN NICOLAS DEL PUERTO";"TOTAL POBLACION";1;0;1
" 10";"BELLAVISTA-LA PALMERA";"SANLUCAR LA MAYOR";"ESPAÑOLES";3;4;7
" 10";"BELLAVISTA-LA PALMERA";"SANLUCAR LA MAYOR";"TOTAL POBLACION";3;4;7
" 10";"BELLAVISTA-LA PALMERA";"SANTIPONCE";"ESPAÑOLES";3;1;4
" 10";"BELLAVISTA-LA PALMERA";"SANTIPONCE";"EXTRANJEROS";0;1;1
" 10";"BELLAVISTA-LA PALMERA";"SANTIPONCE";"TOTAL POBLACION";3;2;5
" 10";"BELLAVISTA-LA PALMERA";"TOCINA";"ESPAÑOLES";1;0;1
" 10";"BELLAVISTA-LA PALMERA";"TOCINA";"TOTAL POBLACION";1;0;1
" 10";"BELLAVISTA-LA PALMERA";"TOMARES";"ESPAÑOLES";10;3;13
" 10";"BELLAVISTA-LA PALMERA";"TOMARES";"EXTRANJEROS";1;0;1
" 10";"BELLAVISTA-LA PALMERA";"TOMARES";"TOTAL POBLACION";11;3;14
" 10";"BELLAVISTA-LA PALMERA";"UMBRETE";"ESPAÑOLES";2;4;6
" 10";"BELLAVISTA-LA PALMERA";"UMBRETE";"TOTAL POBLACION";2;4;6
" 10";"BELLAVISTA-LA PALMERA";"UTRERA";"ESPAÑOLES";5;6;11
" 10";"BELLAVISTA-LA PALMERA";"UTRERA";"TOTAL POBLACION";5;6;11
" 10";"BELLAVISTA-LA PALMERA";"VALENCINA DE LA CONCEPCION";"ESPAÑOLES";2;3;5
" 10";"BELLAVISTA-LA PALMERA";"VALENCINA DE LA CONCEPCION";"EXTRANJEROS";1;1;2
" 10";"BELLAVISTA-LA PALMERA";"VALENCINA DE LA CONCEPCION";"TOTAL POBLACION";3;4;7
" 10";"BELLAVISTA-LA PALMERA";"VILLANUEVA DEL ARISCAL";"ESPAÑOLES";1;3;4
" 10";"BELLAVISTA-LA PALMERA";"VILLANUEVA DEL ARISCAL";"TOTAL POBLACION";1;3;4
" 10";"BELLAVISTA-LA PALMERA";"VILLANUEVA DEL RIO Y MINAS";"ESPAÑOLES";1;0;1
" 10";"BELLAVISTA-LA PALMERA";"VILLANUEVA DEL RIO Y MINAS";"TOTAL POBLACION";1;0;1
" 10";"BELLAVISTA-LA PALMERA";"VISO DEL ALCOR (EL)";"ESPAÑOLES";0;1;1
" 10";"BELLAVISTA-LA PALMERA";"VISO DEL ALCOR (EL)";"EXTRANJEROS";0;1;1
" 10";"BELLAVISTA-LA PALMERA";"VISO DEL ALCOR (EL)";"TOTAL POBLACION";0;2;2
" 11";"LOS REMEDIOS";"- FUERA DE LA PROVINCIA DE SEVILLA";"ESPAÑOLES";150;141;291
" 11";"LOS REMEDIOS";"- FUERA DE LA PROVINCIA DE SEVILLA";"EXTRANJEROS";16;22;38
" 11";"LOS REMEDIOS";"- FUERA DE LA PROVINCIA DE SEVILLA";"TOTAL POBLACION";166;163;329
" 11";"LOS REMEDIOS";"- PROVINCIA DE SEVILLA";"ESPAÑOLES";134;149;283
" 11";"LOS REMEDIOS";"- PROVINCIA DE SEVILLA";"EXTRANJEROS";10;17;27
" 11";"LOS REMEDIOS";"- PROVINCIA DE SEVILLA";"TOTAL POBLACION";144;166;310
" 11";"LOS REMEDIOS";"ALCALA DE GUADAIRA";"ESPAÑOLES";6;5;11
" 11";"LOS REMEDIOS";"ALCALA DE GUADAIRA";"EXTRANJEROS";0;2;2
" 11";"LOS REMEDIOS";"ALCALA DE GUADAIRA";"TOTAL POBLACION";6;7;13
" 11";"LOS REMEDIOS";"ALGABA (LA)";"EXTRANJEROS";2;1;3
" 11";"LOS REMEDIOS";"ALGABA (LA)";"TOTAL POBLACION";2;1;3
" 11";"LOS REMEDIOS";"ALGAMITAS";"ESPAÑOLES";1;0;1
" 11";"LOS REMEDIOS";"ALGAMITAS";"TOTAL POBLACION";1;0;1
" 11";"LOS REMEDIOS";"ALMENSILLA";"ESPAÑOLES";2;0;2
" 11";"LOS REMEDIOS";"ALMENSILLA";"TOTAL POBLACION";2;0;2
" 11";"LOS REMEDIOS";"BADOLATOSA";"ESPAÑOLES";1;1;2
" 11";"LOS REMEDIOS";"BADOLATOSA";"TOTAL POBLACION";1;1;2
" 11";"LOS REMEDIOS";"BENACAZON";"ESPAÑOLES";1;2;3
" 11";"LOS REMEDIOS";"BENACAZON";"TOTAL POBLACION";1;2;3
" 11";"LOS REMEDIOS";"BOLLULLOS DE LA MITACION";"ESPAÑOLES";2;5;7
" 11";"LOS REMEDIOS";"BOLLULLOS DE LA MITACION";"TOTAL POBLACION";2;5;7
" 11";"LOS REMEDIOS";"BORMUJOS";"ESPAÑOLES";8;5;13
" 11";"LOS REMEDIOS";"BORMUJOS";"EXTRANJEROS";1;0;1
" 11";"LOS REMEDIOS";"BORMUJOS";"TOTAL POBLACION";9;5;14
" 11";"LOS REMEDIOS";"BRENES";"EXTRANJEROS";1;1;2
" 11";"LOS REMEDIOS";"BRENES";"TOTAL POBLACION";1;1;2
" 11";"LOS REMEDIOS";"CABEZAS DE SAN JUAN (LAS)";"ESPAÑOLES";2;1;3
" 11";"LOS REMEDIOS";"CABEZAS DE SAN JUAN (LAS)";"TOTAL POBLACION";2;1;3
" 11";"LOS REMEDIOS";"CAMAS";"ESPAÑOLES";4;4;8
" 11";"LOS REMEDIOS";"CAMAS";"EXTRANJEROS";0;1;1
" 11";"LOS REMEDIOS";"CAMAS";"TOTAL POBLACION";4;5;9
" 11";"LOS REMEDIOS";"CARMONA";"ESPAÑOLES";0;2;2
" 11";"LOS REMEDIOS";"CARMONA";"EXTRANJEROS";1;0;1
" 11";"LOS REMEDIOS";"CARMONA";"TOTAL POBLACION";1;2;3
" 11";"LOS REMEDIOS";"CASTILLEJA DE LA CUESTA";"ESPAÑOLES";2;3;5
" 11";"LOS REMEDIOS";"CASTILLEJA DE LA CUESTA";"TOTAL POBLACION";2;3;5
" 11";"LOS REMEDIOS";"CASTILLO DE LAS GUARDAS (EL)";"ESPAÑOLES";0;2;2
" 11";"LOS REMEDIOS";"CASTILLO DE LAS GUARDAS (EL)";"TOTAL POBLACION";0;2;2
" 11";"LOS REMEDIOS";"CAZALLA DE LA SIERRA";"ESPAÑOLES";0;1;1
" 11";"LOS REMEDIOS";"CAZALLA DE LA SIERRA";"TOTAL POBLACION";0;1;1
" 11";"LOS REMEDIOS";"CORIA DEL RIO";"ESPAÑOLES";2;2;4
" 11";"LOS REMEDIOS";"CORIA DEL RIO";"TOTAL POBLACION";2;2;4
" 11";"LOS REMEDIOS";"DOS HERMANAS";"ESPAÑOLES";10;16;26
" 11";"LOS REMEDIOS";"DOS HERMANAS";"EXTRANJEROS";1;0;1
" 11";"LOS REMEDIOS";"DOS HERMANAS";"TOTAL POBLACION";11;16;27
" 11";"LOS REMEDIOS";"ECIJA";"ESPAÑOLES";1;2;3
" 11";"LOS REMEDIOS";"ECIJA";"EXTRANJEROS";0;1;1
" 11";"LOS REMEDIOS";"ECIJA";"TOTAL POBLACION";1;3;4
" 11";"LOS REMEDIOS";"ESPARTINAS";"ESPAÑOLES";7;8;15
" 11";"LOS REMEDIOS";"ESPARTINAS";"EXTRANJEROS";0;1;1
" 11";"LOS REMEDIOS";"ESPARTINAS";"TOTAL POBLACION";7;9;16
" 11";"LOS REMEDIOS";"ESTEPA";"ESPAÑOLES";1;0;1
" 11";"LOS REMEDIOS";"ESTEPA";"TOTAL POBLACION";1;0;1
" 11";"LOS REMEDIOS";"FUENTES DE ANDALUCIA";"ESPAÑOLES";0;1;1
" 11";"LOS REMEDIOS";"FUENTES DE ANDALUCIA";"TOTAL POBLACION";0;1;1
" 11";"LOS REMEDIOS";"GELVES";"ESPAÑOLES";6;4;10
" 11";"LOS REMEDIOS";"GELVES";"TOTAL POBLACION";6;4;10
" 11";"LOS REMEDIOS";"GERENA";"EXTRANJEROS";0;1;1
" 11";"LOS REMEDIOS";"GERENA";"TOTAL POBLACION";0;1;1
" 11";"LOS REMEDIOS";"GINES";"ESPAÑOLES";5;1;6
" 11";"LOS REMEDIOS";"GINES";"TOTAL POBLACION";5;1;6
" 11";"LOS REMEDIOS";"GUILLENA";"ESPAÑOLES";4;4;8
" 11";"LOS REMEDIOS";"GUILLENA";"TOTAL POBLACION";4;4;8
" 11";"LOS REMEDIOS";"ISLA MAYOR";"ESPAÑOLES";0;1;1
" 11";"LOS REMEDIOS";"ISLA MAYOR";"TOTAL POBLACION";0;1;1
" 11";"LOS REMEDIOS";"MAIRENA DEL ALJARAFE";"ESPAÑOLES";17;17;34
" 11";"LOS REMEDIOS";"MAIRENA DEL ALJARAFE";"EXTRANJEROS";0;1;1
" 11";"LOS REMEDIOS";"MAIRENA DEL ALJARAFE";"TOTAL POBLACION";17;18;35
" 11";"LOS REMEDIOS";"MORON DE LA FRONTERA";"ESPAÑOLES";1;1;2
" 11";"LOS REMEDIOS";"MORON DE LA FRONTERA";"TOTAL POBLACION";1;1;2
" 11";"LOS REMEDIOS";"OSUNA";"ESPAÑOLES";0;1;1
" 11";"LOS REMEDIOS";"OSUNA";"TOTAL POBLACION";0;1;1
" 11";"LOS REMEDIOS";"PALMAR DE TROYA (EL)";"EXTRANJEROS";1;0;1
" 11";"LOS REMEDIOS";"PALMAR DE TROYA (EL)";"TOTAL POBLACION";1;0;1
" 11";"LOS REMEDIOS";"PALOMARES DEL RIO";"ESPAÑOLES";3;7;10
" 11";"LOS REMEDIOS";"PALOMARES DEL RIO";"TOTAL POBLACION";3;7;10
" 11";"LOS REMEDIOS";"PEDRERA";"EXTRANJEROS";0;1;1
" 11";"LOS REMEDIOS";"PEDRERA";"TOTAL POBLACION";0;1;1
" 11";"LOS REMEDIOS";"PEDROSO (EL)";"ESPAÑOLES";0;1;1
" 11";"LOS REMEDIOS";"PEDROSO (EL)";"TOTAL POBLACION";0;1;1
" 11";"LOS REMEDIOS";"PUEBLA DEL RIO (LA)";"EXTRANJEROS";0;2;2
" 11";"LOS REMEDIOS";"PUEBLA DEL RIO (LA)";"TOTAL POBLACION";0;2;2
" 11";"LOS REMEDIOS";"RINCONADA (LA)";"ESPAÑOLES";3;5;8
" 11";"LOS REMEDIOS";"RINCONADA (LA)";"TOTAL POBLACION";3;5;8
" 11";"LOS REMEDIOS";"SALTERAS";"ESPAÑOLES";1;0;1
" 11";"LOS REMEDIOS";"SALTERAS";"TOTAL POBLACION";1;0;1
" 11";"LOS REMEDIOS";"SAN JUAN DE AZNALFARACHE";"ESPAÑOLES";21;21;42
" 11";"LOS REMEDIOS";"SAN JUAN DE AZNALFARACHE";"EXTRANJEROS";0;3;3
" 11";"LOS REMEDIOS";"SAN JUAN DE AZNALFARACHE";"TOTAL POBLACION";21;24;45
" 11";"LOS REMEDIOS";"SANLUCAR LA MAYOR";"ESPAÑOLES";0;1;1
" 11";"LOS REMEDIOS";"SANLUCAR LA MAYOR";"TOTAL POBLACION";0;1;1
" 11";"LOS REMEDIOS";"TOMARES";"ESPAÑOLES";15;17;32
" 11";"LOS REMEDIOS";"TOMARES";"EXTRANJEROS";3;1;4
" 11";"LOS REMEDIOS";"TOMARES";"TOTAL POBLACION";18;18;36
" 11";"LOS REMEDIOS";"UMBRETE";"ESPAÑOLES";2;1;3
" 11";"LOS REMEDIOS";"UMBRETE";"TOTAL POBLACION";2;1;3
" 11";"LOS REMEDIOS";"UTRERA";"ESPAÑOLES";2;1;3
" 11";"LOS REMEDIOS";"UTRERA";"EXTRANJEROS";0;1;1
" 11";"LOS REMEDIOS";"UTRERA";"TOTAL POBLACION";2;2;4
" 11";"LOS REMEDIOS";"VALENCINA DE LA CONCEPCION";"ESPAÑOLES";3;2;5
" 11";"LOS REMEDIOS";"VALENCINA DE LA CONCEPCION";"TOTAL POBLACION";3;2;5
" 11";"LOS REMEDIOS";"VILLANUEVA DEL ARISCAL";"ESPAÑOLES";1;2;3
" 11";"LOS REMEDIOS";"VILLANUEVA DEL ARISCAL";"TOTAL POBLACION";1;2;3
" 11";"LOS REMEDIOS";"VILLANUEVA DEL RIO Y MINAS";"ESPAÑOLES";0;1;1
" 11";"LOS REMEDIOS";"VILLANUEVA DEL RIO Y MINAS";"TOTAL POBLACION";0;1;1
" 11";"LOS REMEDIOS";"VISO DEL ALCOR (EL)";"ESPAÑOLES";0;1;1
" 11";"LOS REMEDIOS";"VISO DEL ALCOR (EL)";"TOTAL POBLACION";0;1;1
