"CD","ND","DESTINO","NACION","HOMBRES","MUJERES","TOTAL"
" 00","TOTAL MUNICIPIO","- TODOS -","ESPAÑOLES",7600,7677,15277
" 00","TOTAL MUNICIPIO","- TODOS -","EXTRANJEROS",1058,1137,2195
" 00","TOTAL MUNICIPIO","- TODOS -","NO CONSTA",3,0,3
" 00","TOTAL MUNICIPIO","- TODOS -","TOTAL POBLACION",8661,8814,17475
" 01","CASCO ANTIGUO","- TODOS -","ESPAÑOLES",813,790,1603
" 01","CASCO ANTIGUO","- TODOS -","EXTRANJEROS",95,112,207
" 01","CASCO ANTIGUO","- TODOS -","NO CONSTA",1,0,1
" 01","CASCO ANTIGUO","- TODOS -","TOTAL POBLACION",909,902,1811
" 01","CASCO ANTIGUO","ALBACETE","ESPAÑOLES",0,1,1
" 01","CASCO ANTIGUO","ALBACETE","TOTAL POBLACION",0,1,1
" 01","CASCO ANTIGUO","ALICANTE","ESPAÑOLES",5,6,11
" 01","CASCO ANTIGUO","ALICANTE","EXTRANJEROS",1,3,4
" 01","CASCO ANTIGUO","ALICANTE","TOTAL POBLACION",6,9,15
" 01","CASCO ANTIGUO","ALMERIA","ESPAÑOLES",2,5,7
" 01","CASCO ANTIGUO","ALMERIA","EXTRANJEROS",1,1,2
" 01","CASCO ANTIGUO","ALMERIA","TOTAL POBLACION",3,6,9
" 01","CASCO ANTIGUO","ARABA/ALAVA","ESPAÑOLES",0,1,1
" 01","CASCO ANTIGUO","ARABA/ALAVA","NO CONSTA",1,0,1
" 01","CASCO ANTIGUO","ARABA/ALAVA","TOTAL POBLACION",1,1,2
" 01","CASCO ANTIGUO","ASTURIAS","ESPAÑOLES",0,4,4
" 01","CASCO ANTIGUO","ASTURIAS","TOTAL POBLACION",0,4,4
" 01","CASCO ANTIGUO","AVILA","EXTRANJEROS",0,1,1
" 01","CASCO ANTIGUO","AVILA","TOTAL POBLACION",0,1,1
" 01","CASCO ANTIGUO","BADAJOZ","ESPAÑOLES",15,15,30
" 01","CASCO ANTIGUO","BADAJOZ","EXTRANJEROS",0,1,1
" 01","CASCO ANTIGUO","BADAJOZ","TOTAL POBLACION",15,16,31
" 01","CASCO ANTIGUO","BALEARES","ESPAÑOLES",16,11,27
" 01","CASCO ANTIGUO","BALEARES","EXTRANJEROS",4,2,6
" 01","CASCO ANTIGUO","BALEARES","TOTAL POBLACION",20,13,33
" 01","CASCO ANTIGUO","BARCELONA","ESPAÑOLES",29,21,50
" 01","CASCO ANTIGUO","BARCELONA","EXTRANJEROS",9,6,15
" 01","CASCO ANTIGUO","BARCELONA","TOTAL POBLACION",38,27,65
" 01","CASCO ANTIGUO","BIZKAIA","ESPAÑOLES",3,4,7
" 01","CASCO ANTIGUO","BIZKAIA","EXTRANJEROS",1,0,1
" 01","CASCO ANTIGUO","BIZKAIA","TOTAL POBLACION",4,4,8
" 01","CASCO ANTIGUO","BURGOS","ESPAÑOLES",0,2,2
" 01","CASCO ANTIGUO","BURGOS","TOTAL POBLACION",0,2,2
" 01","CASCO ANTIGUO","CACERES","ESPAÑOLES",3,3,6
" 01","CASCO ANTIGUO","CACERES","TOTAL POBLACION",3,3,6
" 01","CASCO ANTIGUO","CADIZ","ESPAÑOLES",45,56,101
" 01","CASCO ANTIGUO","CADIZ","EXTRANJEROS",4,4,8
" 01","CASCO ANTIGUO","CADIZ","TOTAL POBLACION",49,60,109
" 01","CASCO ANTIGUO","CANTABRIA","ESPAÑOLES",1,1,2
" 01","CASCO ANTIGUO","CANTABRIA","TOTAL POBLACION",1,1,2
" 01","CASCO ANTIGUO","CASTELLON","ESPAÑOLES",0,1,1
" 01","CASCO ANTIGUO","CASTELLON","TOTAL POBLACION",0,1,1
" 01","CASCO ANTIGUO","CEUTA","ESPAÑOLES",3,1,4
" 01","CASCO ANTIGUO","CEUTA","EXTRANJEROS",1,0,1
" 01","CASCO ANTIGUO","CEUTA","TOTAL POBLACION",4,1,5
" 01","CASCO ANTIGUO","CIUDAD REAL","ESPAÑOLES",0,1,1
" 01","CASCO ANTIGUO","CIUDAD REAL","TOTAL POBLACION",0,1,1
" 01","CASCO ANTIGUO","CORDOBA","ESPAÑOLES",13,16,29
" 01","CASCO ANTIGUO","CORDOBA","EXTRANJEROS",0,2,2
" 01","CASCO ANTIGUO","CORDOBA","TOTAL POBLACION",13,18,31
" 01","CASCO ANTIGUO","CUENCA","ESPAÑOLES",1,1,2
" 01","CASCO ANTIGUO","CUENCA","TOTAL POBLACION",1,1,2
" 01","CASCO ANTIGUO","EXTRAJERO","ESPAÑOLES",109,90,199
" 01","CASCO ANTIGUO","EXTRAJERO","EXTRANJEROS",13,7,20
" 01","CASCO ANTIGUO","EXTRAJERO","TOTAL POBLACION",122,97,219
" 01","CASCO ANTIGUO","GERONA","ESPAÑOLES",1,0,1
" 01","CASCO ANTIGUO","GERONA","TOTAL POBLACION",1,0,1
" 01","CASCO ANTIGUO","GIPUZKOA","ESPAÑOLES",4,4,8
" 01","CASCO ANTIGUO","GIPUZKOA","EXTRANJEROS",0,1,1
" 01","CASCO ANTIGUO","GIPUZKOA","TOTAL POBLACION",4,5,9
" 01","CASCO ANTIGUO","GRANADA","ESPAÑOLES",12,14,26
" 01","CASCO ANTIGUO","GRANADA","EXTRANJEROS",2,2,4
" 01","CASCO ANTIGUO","GRANADA","TOTAL POBLACION",14,16,30
" 01","CASCO ANTIGUO","GUADALAJARA","ESPAÑOLES",3,2,5
" 01","CASCO ANTIGUO","GUADALAJARA","TOTAL POBLACION",3,2,5
" 01","CASCO ANTIGUO","HUELVA","ESPAÑOLES",38,41,79
" 01","CASCO ANTIGUO","HUELVA","EXTRANJEROS",3,2,5
" 01","CASCO ANTIGUO","HUELVA","TOTAL POBLACION",41,43,84
" 01","CASCO ANTIGUO","HUESCA","ESPAÑOLES",1,2,3
" 01","CASCO ANTIGUO","HUESCA","TOTAL POBLACION",1,2,3
" 01","CASCO ANTIGUO","JAEN","ESPAÑOLES",8,11,19
" 01","CASCO ANTIGUO","JAEN","TOTAL POBLACION",8,11,19
" 01","CASCO ANTIGUO","LA CORUÑA","ESPAÑOLES",4,2,6
" 01","CASCO ANTIGUO","LA CORUÑA","TOTAL POBLACION",4,2,6
" 01","CASCO ANTIGUO","LAS PALMAS","ESPAÑOLES",8,7,15
" 01","CASCO ANTIGUO","LAS PALMAS","EXTRANJEROS",1,1,2
" 01","CASCO ANTIGUO","LAS PALMAS","TOTAL POBLACION",9,8,17
" 01","CASCO ANTIGUO","LLEIDA","ESPAÑOLES",1,0,1
" 01","CASCO ANTIGUO","LLEIDA","EXTRANJEROS",1,0,1
" 01","CASCO ANTIGUO","LLEIDA","TOTAL POBLACION",2,0,2
" 01","CASCO ANTIGUO","LUGO","ESPAÑOLES",0,1,1
" 01","CASCO ANTIGUO","LUGO","EXTRANJEROS",0,1,1
" 01","CASCO ANTIGUO","LUGO","TOTAL POBLACION",0,2,2
" 01","CASCO ANTIGUO","MADRID","ESPAÑOLES",90,85,175
" 01","CASCO ANTIGUO","MADRID","EXTRANJEROS",8,14,22
" 01","CASCO ANTIGUO","MADRID","TOTAL POBLACION",98,99,197
" 01","CASCO ANTIGUO","MALAGA","ESPAÑOLES",26,25,51
" 01","CASCO ANTIGUO","MALAGA","EXTRANJEROS",6,7,13
" 01","CASCO ANTIGUO","MALAGA","TOTAL POBLACION",32,32,64
" 01","CASCO ANTIGUO","MELILLA","ESPAÑOLES",1,1,2
" 01","CASCO ANTIGUO","MELILLA","TOTAL POBLACION",1,1,2
" 01","CASCO ANTIGUO","MURCIA","ESPAÑOLES",3,2,5
" 01","CASCO ANTIGUO","MURCIA","EXTRANJEROS",1,0,1
" 01","CASCO ANTIGUO","MURCIA","TOTAL POBLACION",4,2,6
" 01","CASCO ANTIGUO","NAVARRA","ESPAÑOLES",1,2,3
" 01","CASCO ANTIGUO","NAVARRA","TOTAL POBLACION",1,2,3
" 01","CASCO ANTIGUO","PALENCIA","ESPAÑOLES",0,1,1
" 01","CASCO ANTIGUO","PALENCIA","TOTAL POBLACION",0,1,1
" 01","CASCO ANTIGUO","PONTEVEDRA","ESPAÑOLES",3,2,5
" 01","CASCO ANTIGUO","PONTEVEDRA","EXTRANJEROS",2,2,4
" 01","CASCO ANTIGUO","PONTEVEDRA","TOTAL POBLACION",5,4,9
" 01","CASCO ANTIGUO","SALAMANCA","ESPAÑOLES",2,3,5
" 01","CASCO ANTIGUO","SALAMANCA","TOTAL POBLACION",2,3,5
" 01","CASCO ANTIGUO","SANTA CRUZ DE TENERIFE","ESPAÑOLES",13,10,23
" 01","CASCO ANTIGUO","SANTA CRUZ DE TENERIFE","EXTRANJEROS",1,1,2
" 01","CASCO ANTIGUO","SANTA CRUZ DE TENERIFE","TOTAL POBLACION",14,11,25
" 01","CASCO ANTIGUO","SEGOVIA","ESPAÑOLES",1,1,2
" 01","CASCO ANTIGUO","SEGOVIA","TOTAL POBLACION",1,1,2
" 01","CASCO ANTIGUO","SEVILLA","ESPAÑOLES",340,323,663
" 01","CASCO ANTIGUO","SEVILLA","EXTRANJEROS",32,49,81
" 01","CASCO ANTIGUO","SEVILLA","TOTAL POBLACION",372,372,744
" 01","CASCO ANTIGUO","SORIA","EXTRANJEROS",0,1,1
" 01","CASCO ANTIGUO","SORIA","TOTAL POBLACION",0,1,1
" 01","CASCO ANTIGUO","TARRAGONA","ESPAÑOLES",1,0,1
" 01","CASCO ANTIGUO","TARRAGONA","EXTRANJEROS",3,2,5
" 01","CASCO ANTIGUO","TARRAGONA","TOTAL POBLACION",4,2,6
" 01","CASCO ANTIGUO","TERUEL","ESPAÑOLES",0,1,1
" 01","CASCO ANTIGUO","TERUEL","TOTAL POBLACION",0,1,1
" 01","CASCO ANTIGUO","TOLEDO","EXTRANJEROS",0,1,1
" 01","CASCO ANTIGUO","TOLEDO","TOTAL POBLACION",0,1,1
" 01","CASCO ANTIGUO","VALENCIA","ESPAÑOLES",4,3,7
" 01","CASCO ANTIGUO","VALENCIA","EXTRANJEROS",1,1,2
" 01","CASCO ANTIGUO","VALENCIA","TOTAL POBLACION",5,4,9
" 01","CASCO ANTIGUO","VALLADOLID","ESPAÑOLES",1,3,4
" 01","CASCO ANTIGUO","VALLADOLID","TOTAL POBLACION",1,3,4
" 01","CASCO ANTIGUO","ZARAGOZA","ESPAÑOLES",2,4,6
" 01","CASCO ANTIGUO","ZARAGOZA","TOTAL POBLACION",2,4,6
" 02","MACARENA","- TODOS -","ESPAÑOLES",833,867,1700
" 02","MACARENA","- TODOS -","EXTRANJEROS",209,197,406
" 02","MACARENA","- TODOS -","TOTAL POBLACION",1042,1064,2106
" 02","MACARENA","ALBACETE","ESPAÑOLES",0,4,4
" 02","MACARENA","ALBACETE","EXTRANJEROS",3,3,6
" 02","MACARENA","ALBACETE","TOTAL POBLACION",3,7,10
" 02","MACARENA","ALICANTE","ESPAÑOLES",6,2,8
" 02","MACARENA","ALICANTE","EXTRANJEROS",2,2,4
" 02","MACARENA","ALICANTE","TOTAL POBLACION",8,4,12
" 02","MACARENA","ALMERIA","ESPAÑOLES",5,7,12
" 02","MACARENA","ALMERIA","TOTAL POBLACION",5,7,12
" 02","MACARENA","ARABA/ALAVA","ESPAÑOLES",0,1,1
" 02","MACARENA","ARABA/ALAVA","TOTAL POBLACION",0,1,1
" 02","MACARENA","ASTURIAS","ESPAÑOLES",2,4,6
" 02","MACARENA","ASTURIAS","TOTAL POBLACION",2,4,6
" 02","MACARENA","AVILA","ESPAÑOLES",1,1,2
" 02","MACARENA","AVILA","TOTAL POBLACION",1,1,2
" 02","MACARENA","BADAJOZ","ESPAÑOLES",12,16,28
" 02","MACARENA","BADAJOZ","EXTRANJEROS",3,2,5
" 02","MACARENA","BADAJOZ","TOTAL POBLACION",15,18,33
" 02","MACARENA","BALEARES","ESPAÑOLES",23,11,34
" 02","MACARENA","BALEARES","EXTRANJEROS",8,3,11
" 02","MACARENA","BALEARES","TOTAL POBLACION",31,14,45
" 02","MACARENA","BARCELONA","ESPAÑOLES",24,24,48
" 02","MACARENA","BARCELONA","EXTRANJEROS",29,12,41
" 02","MACARENA","BARCELONA","TOTAL POBLACION",53,36,89
" 02","MACARENA","BIZKAIA","ESPAÑOLES",2,2,4
" 02","MACARENA","BIZKAIA","EXTRANJEROS",2,1,3
" 02","MACARENA","BIZKAIA","TOTAL POBLACION",4,3,7
" 02","MACARENA","BURGOS","ESPAÑOLES",2,0,2
" 02","MACARENA","BURGOS","TOTAL POBLACION",2,0,2
" 02","MACARENA","CACERES","ESPAÑOLES",1,2,3
" 02","MACARENA","CACERES","TOTAL POBLACION",1,2,3
" 02","MACARENA","CADIZ","ESPAÑOLES",40,50,90
" 02","MACARENA","CADIZ","EXTRANJEROS",8,12,20
" 02","MACARENA","CADIZ","TOTAL POBLACION",48,62,110
" 02","MACARENA","CANTABRIA","EXTRANJEROS",3,1,4
" 02","MACARENA","CANTABRIA","TOTAL POBLACION",3,1,4
" 02","MACARENA","CASTELLON","ESPAÑOLES",8,1,9
" 02","MACARENA","CASTELLON","TOTAL POBLACION",8,1,9
" 02","MACARENA","CEUTA","ESPAÑOLES",4,1,5
" 02","MACARENA","CEUTA","EXTRANJEROS",1,0,1
" 02","MACARENA","CEUTA","TOTAL POBLACION",5,1,6
" 02","MACARENA","CIUDAD REAL","ESPAÑOLES",3,0,3
" 02","MACARENA","CIUDAD REAL","EXTRANJEROS",0,3,3
" 02","MACARENA","CIUDAD REAL","TOTAL POBLACION",3,3,6
" 02","MACARENA","CORDOBA","ESPAÑOLES",14,12,26
" 02","MACARENA","CORDOBA","EXTRANJEROS",7,5,12
" 02","MACARENA","CORDOBA","TOTAL POBLACION",21,17,38
" 02","MACARENA","EXTRAJERO","ESPAÑOLES",97,91,188
" 02","MACARENA","EXTRAJERO","EXTRANJEROS",14,6,20
" 02","MACARENA","EXTRAJERO","TOTAL POBLACION",111,97,208
" 02","MACARENA","GERONA","ESPAÑOLES",3,2,5
" 02","MACARENA","GERONA","EXTRANJEROS",0,2,2
" 02","MACARENA","GERONA","TOTAL POBLACION",3,4,7
" 02","MACARENA","GIPUZKOA","ESPAÑOLES",0,2,2
" 02","MACARENA","GIPUZKOA","EXTRANJEROS",1,3,4
" 02","MACARENA","GIPUZKOA","TOTAL POBLACION",1,5,6
" 02","MACARENA","GRANADA","ESPAÑOLES",7,7,14
" 02","MACARENA","GRANADA","EXTRANJEROS",1,4,5
" 02","MACARENA","GRANADA","TOTAL POBLACION",8,11,19
" 02","MACARENA","GUADALAJARA","EXTRANJEROS",1,0,1
" 02","MACARENA","GUADALAJARA","TOTAL POBLACION",1,0,1
" 02","MACARENA","HUELVA","ESPAÑOLES",41,51,92
" 02","MACARENA","HUELVA","EXTRANJEROS",9,8,17
" 02","MACARENA","HUELVA","TOTAL POBLACION",50,59,109
" 02","MACARENA","JAEN","ESPAÑOLES",5,8,13
" 02","MACARENA","JAEN","EXTRANJEROS",1,1,2
" 02","MACARENA","JAEN","TOTAL POBLACION",6,9,15
" 02","MACARENA","LA CORUÑA","ESPAÑOLES",1,1,2
" 02","MACARENA","LA CORUÑA","EXTRANJEROS",1,1,2
" 02","MACARENA","LA CORUÑA","TOTAL POBLACION",2,2,4
" 02","MACARENA","LA RIOJA","EXTRANJEROS",1,0,1
" 02","MACARENA","LA RIOJA","TOTAL POBLACION",1,0,1
" 02","MACARENA","LAS PALMAS","ESPAÑOLES",13,15,28
" 02","MACARENA","LAS PALMAS","EXTRANJEROS",4,3,7
" 02","MACARENA","LAS PALMAS","TOTAL POBLACION",17,18,35
" 02","MACARENA","LEON","ESPAÑOLES",6,4,10
" 02","MACARENA","LEON","EXTRANJEROS",2,0,2
" 02","MACARENA","LEON","TOTAL POBLACION",8,4,12
" 02","MACARENA","LLEIDA","EXTRANJEROS",1,0,1
" 02","MACARENA","LLEIDA","TOTAL POBLACION",1,0,1
" 02","MACARENA","LUGO","ESPAÑOLES",1,1,2
" 02","MACARENA","LUGO","EXTRANJEROS",1,0,1
" 02","MACARENA","LUGO","TOTAL POBLACION",2,1,3
" 02","MACARENA","MADRID","ESPAÑOLES",51,55,106
" 02","MACARENA","MADRID","EXTRANJEROS",19,17,36
" 02","MACARENA","MADRID","TOTAL POBLACION",70,72,142
" 02","MACARENA","MALAGA","ESPAÑOLES",16,19,35
" 02","MACARENA","MALAGA","EXTRANJEROS",9,8,17
" 02","MACARENA","MALAGA","TOTAL POBLACION",25,27,52
" 02","MACARENA","MELILLA","ESPAÑOLES",1,1,2
" 02","MACARENA","MELILLA","EXTRANJEROS",2,0,2
" 02","MACARENA","MELILLA","TOTAL POBLACION",3,1,4
" 02","MACARENA","MURCIA","ESPAÑOLES",5,5,10
" 02","MACARENA","MURCIA","EXTRANJEROS",2,2,4
" 02","MACARENA","MURCIA","TOTAL POBLACION",7,7,14
" 02","MACARENA","NAVARRA","ESPAÑOLES",5,6,11
" 02","MACARENA","NAVARRA","EXTRANJEROS",3,5,8
" 02","MACARENA","NAVARRA","TOTAL POBLACION",8,11,19
" 02","MACARENA","PALENCIA","ESPAÑOLES",0,2,2
" 02","MACARENA","PALENCIA","EXTRANJEROS",1,1,2
" 02","MACARENA","PALENCIA","TOTAL POBLACION",1,3,4
" 02","MACARENA","PONTEVEDRA","ESPAÑOLES",2,0,2
" 02","MACARENA","PONTEVEDRA","EXTRANJEROS",1,5,6
" 02","MACARENA","PONTEVEDRA","TOTAL POBLACION",3,5,8
" 02","MACARENA","SALAMANCA","ESPAÑOLES",0,1,1
" 02","MACARENA","SALAMANCA","EXTRANJEROS",0,1,1
" 02","MACARENA","SALAMANCA","TOTAL POBLACION",0,2,2
" 02","MACARENA","SANTA CRUZ DE TENERIFE","ESPAÑOLES",12,9,21
" 02","MACARENA","SANTA CRUZ DE TENERIFE","EXTRANJEROS",1,1,2
" 02","MACARENA","SANTA CRUZ DE TENERIFE","TOTAL POBLACION",13,10,23
" 02","MACARENA","SEGOVIA","ESPAÑOLES",1,0,1
" 02","MACARENA","SEGOVIA","TOTAL POBLACION",1,0,1
" 02","MACARENA","SEVILLA","ESPAÑOLES",406,433,839
" 02","MACARENA","SEVILLA","EXTRANJEROS",50,72,122
" 02","MACARENA","SEVILLA","TOTAL POBLACION",456,505,961
" 02","MACARENA","SORIA","EXTRANJEROS",0,1,1
" 02","MACARENA","SORIA","TOTAL POBLACION",0,1,1
" 02","MACARENA","TARRAGONA","ESPAÑOLES",1,3,4
" 02","MACARENA","TARRAGONA","EXTRANJEROS",2,1,3
" 02","MACARENA","TARRAGONA","TOTAL POBLACION",3,4,7
" 02","MACARENA","TERUEL","ESPAÑOLES",0,1,1
" 02","MACARENA","TERUEL","TOTAL POBLACION",0,1,1
" 02","MACARENA","TOLEDO","EXTRANJEROS",3,0,3
" 02","MACARENA","TOLEDO","TOTAL POBLACION",3,0,3
" 02","MACARENA","VALENCIA","ESPAÑOLES",6,3,9
" 02","MACARENA","VALENCIA","EXTRANJEROS",11,9,20
" 02","MACARENA","VALENCIA","TOTAL POBLACION",17,12,29
" 02","MACARENA","VALLADOLID","ESPAÑOLES",1,7,8
" 02","MACARENA","VALLADOLID","TOTAL POBLACION",1,7,8
" 02","MACARENA","ZAMORA","ESPAÑOLES",1,0,1
" 02","MACARENA","ZAMORA","TOTAL POBLACION",1,0,1
" 02","MACARENA","ZARAGOZA","ESPAÑOLES",4,2,6
" 02","MACARENA","ZARAGOZA","EXTRANJEROS",2,2,4
" 02","MACARENA","ZARAGOZA","TOTAL POBLACION",6,4,10
" 03","NERVION","- TODOS -","ESPAÑOLES",517,560,1077
" 03","NERVION","- TODOS -","EXTRANJEROS",55,62,117
" 03","NERVION","- TODOS -","TOTAL POBLACION",572,622,1194
" 03","NERVION","ALBACETE","ESPAÑOLES",1,1,2
" 03","NERVION","ALBACETE","TOTAL POBLACION",1,1,2
" 03","NERVION","ALICANTE","ESPAÑOLES",2,6,8
" 03","NERVION","ALICANTE","TOTAL POBLACION",2,6,8
" 03","NERVION","ALMERIA","ESPAÑOLES",3,6,9
" 03","NERVION","ALMERIA","EXTRANJEROS",0,1,1
" 03","NERVION","ALMERIA","TOTAL POBLACION",3,7,10
" 03","NERVION","ARABA/ALAVA","EXTRANJEROS",1,0,1
" 03","NERVION","ARABA/ALAVA","TOTAL POBLACION",1,0,1
" 03","NERVION","ASTURIAS","ESPAÑOLES",0,1,1
" 03","NERVION","ASTURIAS","EXTRANJEROS",0,1,1
" 03","NERVION","ASTURIAS","TOTAL POBLACION",0,2,2
" 03","NERVION","BADAJOZ","ESPAÑOLES",11,14,25
" 03","NERVION","BADAJOZ","EXTRANJEROS",0,2,2
" 03","NERVION","BADAJOZ","TOTAL POBLACION",11,16,27
" 03","NERVION","BALEARES","ESPAÑOLES",13,8,21
" 03","NERVION","BALEARES","EXTRANJEROS",1,0,1
" 03","NERVION","BALEARES","TOTAL POBLACION",14,8,22
" 03","NERVION","BARCELONA","ESPAÑOLES",20,13,33
" 03","NERVION","BARCELONA","EXTRANJEROS",6,6,12
" 03","NERVION","BARCELONA","TOTAL POBLACION",26,19,45
" 03","NERVION","BIZKAIA","ESPAÑOLES",4,0,4
" 03","NERVION","BIZKAIA","EXTRANJEROS",0,1,1
" 03","NERVION","BIZKAIA","TOTAL POBLACION",4,1,5
" 03","NERVION","BURGOS","ESPAÑOLES",1,2,3
" 03","NERVION","BURGOS","TOTAL POBLACION",1,2,3
" 03","NERVION","CACERES","ESPAÑOLES",2,3,5
" 03","NERVION","CACERES","TOTAL POBLACION",2,3,5
" 03","NERVION","CADIZ","ESPAÑOLES",30,30,60
" 03","NERVION","CADIZ","EXTRANJEROS",1,4,5
" 03","NERVION","CADIZ","TOTAL POBLACION",31,34,65
" 03","NERVION","CANTABRIA","ESPAÑOLES",4,2,6
" 03","NERVION","CANTABRIA","TOTAL POBLACION",4,2,6
" 03","NERVION","CASTELLON","ESPAÑOLES",0,1,1
" 03","NERVION","CASTELLON","TOTAL POBLACION",0,1,1
" 03","NERVION","CEUTA","ESPAÑOLES",4,1,5
" 03","NERVION","CEUTA","TOTAL POBLACION",4,1,5
" 03","NERVION","CIUDAD REAL","ESPAÑOLES",2,4,6
" 03","NERVION","CIUDAD REAL","TOTAL POBLACION",2,4,6
" 03","NERVION","CORDOBA","ESPAÑOLES",13,11,24
" 03","NERVION","CORDOBA","EXTRANJEROS",1,1,2
" 03","NERVION","CORDOBA","TOTAL POBLACION",14,12,26
" 03","NERVION","EXTRAJERO","ESPAÑOLES",65,56,121
" 03","NERVION","EXTRAJERO","EXTRANJEROS",8,4,12
" 03","NERVION","EXTRAJERO","TOTAL POBLACION",73,60,133
" 03","NERVION","GERONA","ESPAÑOLES",2,1,3
" 03","NERVION","GERONA","TOTAL POBLACION",2,1,3
" 03","NERVION","GIPUZKOA","ESPAÑOLES",1,1,2
" 03","NERVION","GIPUZKOA","EXTRANJEROS",1,0,1
" 03","NERVION","GIPUZKOA","TOTAL POBLACION",2,1,3
" 03","NERVION","GRANADA","ESPAÑOLES",6,10,16
" 03","NERVION","GRANADA","TOTAL POBLACION",6,10,16
" 03","NERVION","GUADALAJARA","ESPAÑOLES",2,0,2
" 03","NERVION","GUADALAJARA","EXTRANJEROS",0,1,1
" 03","NERVION","GUADALAJARA","TOTAL POBLACION",2,1,3
" 03","NERVION","HUELVA","ESPAÑOLES",18,20,38
" 03","NERVION","HUELVA","EXTRANJEROS",2,3,5
" 03","NERVION","HUELVA","TOTAL POBLACION",20,23,43
" 03","NERVION","HUESCA","ESPAÑOLES",3,2,5
" 03","NERVION","HUESCA","TOTAL POBLACION",3,2,5
" 03","NERVION","JAEN","ESPAÑOLES",2,1,3
" 03","NERVION","JAEN","EXTRANJEROS",0,1,1
" 03","NERVION","JAEN","TOTAL POBLACION",2,2,4
" 03","NERVION","LA CORUÑA","ESPAÑOLES",3,8,11
" 03","NERVION","LA CORUÑA","TOTAL POBLACION",3,8,11
" 03","NERVION","LA RIOJA","ESPAÑOLES",2,2,4
" 03","NERVION","LA RIOJA","TOTAL POBLACION",2,2,4
" 03","NERVION","LAS PALMAS","ESPAÑOLES",12,4,16
" 03","NERVION","LAS PALMAS","TOTAL POBLACION",12,4,16
" 03","NERVION","LUGO","ESPAÑOLES",1,0,1
" 03","NERVION","LUGO","TOTAL POBLACION",1,0,1
" 03","NERVION","MADRID","ESPAÑOLES",60,65,125
" 03","NERVION","MADRID","EXTRANJEROS",4,9,13
" 03","NERVION","MADRID","TOTAL POBLACION",64,74,138
" 03","NERVION","MALAGA","ESPAÑOLES",17,20,37
" 03","NERVION","MALAGA","EXTRANJEROS",1,3,4
" 03","NERVION","MALAGA","TOTAL POBLACION",18,23,41
" 03","NERVION","MELILLA","ESPAÑOLES",0,1,1
" 03","NERVION","MELILLA","TOTAL POBLACION",0,1,1
" 03","NERVION","MURCIA","ESPAÑOLES",2,5,7
" 03","NERVION","MURCIA","EXTRANJEROS",1,0,1
" 03","NERVION","MURCIA","TOTAL POBLACION",3,5,8
" 03","NERVION","NAVARRA","ESPAÑOLES",1,2,3
" 03","NERVION","NAVARRA","EXTRANJEROS",0,1,1
" 03","NERVION","NAVARRA","TOTAL POBLACION",1,3,4
" 03","NERVION","PONTEVEDRA","ESPAÑOLES",1,0,1
" 03","NERVION","PONTEVEDRA","EXTRANJEROS",1,0,1
" 03","NERVION","PONTEVEDRA","TOTAL POBLACION",2,0,2
" 03","NERVION","SALAMANCA","ESPAÑOLES",1,1,2
" 03","NERVION","SALAMANCA","EXTRANJEROS",1,1,2
" 03","NERVION","SALAMANCA","TOTAL POBLACION",2,2,4
" 03","NERVION","SANTA CRUZ DE TENERIFE","ESPAÑOLES",4,10,14
" 03","NERVION","SANTA CRUZ DE TENERIFE","EXTRANJEROS",1,1,2
" 03","NERVION","SANTA CRUZ DE TENERIFE","TOTAL POBLACION",5,11,16
" 03","NERVION","SEGOVIA","ESPAÑOLES",2,1,3
" 03","NERVION","SEGOVIA","TOTAL POBLACION",2,1,3
" 03","NERVION","SEVILLA","ESPAÑOLES",193,238,431
" 03","NERVION","SEVILLA","EXTRANJEROS",20,17,37
" 03","NERVION","SEVILLA","TOTAL POBLACION",213,255,468
" 03","NERVION","SORIA","ESPAÑOLES",0,1,1
" 03","NERVION","SORIA","TOTAL POBLACION",0,1,1
" 03","NERVION","TARRAGONA","EXTRANJEROS",0,1,1
" 03","NERVION","TARRAGONA","TOTAL POBLACION",0,1,1
" 03","NERVION","TOLEDO","ESPAÑOLES",1,3,4
" 03","NERVION","TOLEDO","EXTRANJEROS",0,1,1
" 03","NERVION","TOLEDO","TOTAL POBLACION",1,4,5
" 03","NERVION","VALENCIA","ESPAÑOLES",5,1,6
" 03","NERVION","VALENCIA","EXTRANJEROS",3,2,5
" 03","NERVION","VALENCIA","TOTAL POBLACION",8,3,11
" 03","NERVION","VALLADOLID","ESPAÑOLES",2,4,6
" 03","NERVION","VALLADOLID","EXTRANJEROS",0,1,1
" 03","NERVION","VALLADOLID","TOTAL POBLACION",2,5,7
" 03","NERVION","ZAMORA","ESPAÑOLES",1,0,1
" 03","NERVION","ZAMORA","TOTAL POBLACION",1,0,1
" 03","NERVION","ZARAGOZA","EXTRANJEROS",2,0,2
" 03","NERVION","ZARAGOZA","TOTAL POBLACION",2,0,2
" 04","CERRO-AMATE","- TODOS -","ESPAÑOLES",864,866,1730
" 04","CERRO-AMATE","- TODOS -","EXTRANJEROS",197,175,372
" 04","CERRO-AMATE","- TODOS -","TOTAL POBLACION",1061,1041,2102
" 04","CERRO-AMATE","ALBACETE","ESPAÑOLES",1,1,2
" 04","CERRO-AMATE","ALBACETE","TOTAL POBLACION",1,1,2
" 04","CERRO-AMATE","ALICANTE","ESPAÑOLES",4,9,13
" 04","CERRO-AMATE","ALICANTE","EXTRANJEROS",5,6,11
" 04","CERRO-AMATE","ALICANTE","TOTAL POBLACION",9,15,24
" 04","CERRO-AMATE","ALMERIA","ESPAÑOLES",6,7,13
" 04","CERRO-AMATE","ALMERIA","EXTRANJEROS",2,2,4
" 04","CERRO-AMATE","ALMERIA","TOTAL POBLACION",8,9,17
" 04","CERRO-AMATE","ARABA/ALAVA","ESPAÑOLES",2,1,3
" 04","CERRO-AMATE","ARABA/ALAVA","EXTRANJEROS",3,2,5
" 04","CERRO-AMATE","ARABA/ALAVA","TOTAL POBLACION",5,3,8
" 04","CERRO-AMATE","ASTURIAS","ESPAÑOLES",1,5,6
" 04","CERRO-AMATE","ASTURIAS","EXTRANJEROS",1,1,2
" 04","CERRO-AMATE","ASTURIAS","TOTAL POBLACION",2,6,8
" 04","CERRO-AMATE","BADAJOZ","ESPAÑOLES",6,15,21
" 04","CERRO-AMATE","BADAJOZ","EXTRANJEROS",2,2,4
" 04","CERRO-AMATE","BADAJOZ","TOTAL POBLACION",8,17,25
" 04","CERRO-AMATE","BALEARES","ESPAÑOLES",21,10,31
" 04","CERRO-AMATE","BALEARES","EXTRANJEROS",4,4,8
" 04","CERRO-AMATE","BALEARES","TOTAL POBLACION",25,14,39
" 04","CERRO-AMATE","BARCELONA","ESPAÑOLES",22,22,44
" 04","CERRO-AMATE","BARCELONA","EXTRANJEROS",12,7,19
" 04","CERRO-AMATE","BARCELONA","TOTAL POBLACION",34,29,63
" 04","CERRO-AMATE","BIZKAIA","ESPAÑOLES",0,3,3
" 04","CERRO-AMATE","BIZKAIA","EXTRANJEROS",4,1,5
" 04","CERRO-AMATE","BIZKAIA","TOTAL POBLACION",4,4,8
" 04","CERRO-AMATE","BURGOS","ESPAÑOLES",1,1,2
" 04","CERRO-AMATE","BURGOS","EXTRANJEROS",0,1,1
" 04","CERRO-AMATE","BURGOS","TOTAL POBLACION",1,2,3
" 04","CERRO-AMATE","CACERES","ESPAÑOLES",2,1,3
" 04","CERRO-AMATE","CACERES","TOTAL POBLACION",2,1,3
" 04","CERRO-AMATE","CADIZ","ESPAÑOLES",44,28,72
" 04","CERRO-AMATE","CADIZ","EXTRANJEROS",10,6,16
" 04","CERRO-AMATE","CADIZ","TOTAL POBLACION",54,34,88
" 04","CERRO-AMATE","CANTABRIA","ESPAÑOLES",3,1,4
" 04","CERRO-AMATE","CANTABRIA","TOTAL POBLACION",3,1,4
" 04","CERRO-AMATE","CASTELLON","ESPAÑOLES",1,0,1
" 04","CERRO-AMATE","CASTELLON","TOTAL POBLACION",1,0,1
" 04","CERRO-AMATE","CEUTA","ESPAÑOLES",3,1,4
" 04","CERRO-AMATE","CEUTA","EXTRANJEROS",3,1,4
" 04","CERRO-AMATE","CEUTA","TOTAL POBLACION",6,2,8
" 04","CERRO-AMATE","CIUDAD REAL","ESPAÑOLES",4,3,7
" 04","CERRO-AMATE","CIUDAD REAL","EXTRANJEROS",1,0,1
" 04","CERRO-AMATE","CIUDAD REAL","TOTAL POBLACION",5,3,8
" 04","CERRO-AMATE","CORDOBA","ESPAÑOLES",9,4,13
" 04","CERRO-AMATE","CORDOBA","EXTRANJEROS",4,4,8
" 04","CERRO-AMATE","CORDOBA","TOTAL POBLACION",13,8,21
" 04","CERRO-AMATE","EXTRAJERO","ESPAÑOLES",51,43,94
" 04","CERRO-AMATE","EXTRAJERO","EXTRANJEROS",11,6,17
" 04","CERRO-AMATE","EXTRAJERO","TOTAL POBLACION",62,49,111
" 04","CERRO-AMATE","GERONA","ESPAÑOLES",4,3,7
" 04","CERRO-AMATE","GERONA","EXTRANJEROS",2,1,3
" 04","CERRO-AMATE","GERONA","TOTAL POBLACION",6,4,10
" 04","CERRO-AMATE","GIPUZKOA","ESPAÑOLES",2,1,3
" 04","CERRO-AMATE","GIPUZKOA","EXTRANJEROS",5,5,10
" 04","CERRO-AMATE","GIPUZKOA","TOTAL POBLACION",7,6,13
" 04","CERRO-AMATE","GRANADA","ESPAÑOLES",10,9,19
" 04","CERRO-AMATE","GRANADA","EXTRANJEROS",2,0,2
" 04","CERRO-AMATE","GRANADA","TOTAL POBLACION",12,9,21
" 04","CERRO-AMATE","GUADALAJARA","ESPAÑOLES",1,3,4
" 04","CERRO-AMATE","GUADALAJARA","TOTAL POBLACION",1,3,4
" 04","CERRO-AMATE","HUELVA","ESPAÑOLES",29,35,64
" 04","CERRO-AMATE","HUELVA","EXTRANJEROS",12,8,20
" 04","CERRO-AMATE","HUELVA","TOTAL POBLACION",41,43,84
" 04","CERRO-AMATE","JAEN","ESPAÑOLES",1,4,5
" 04","CERRO-AMATE","JAEN","TOTAL POBLACION",1,4,5
" 04","CERRO-AMATE","LA CORUÑA","ESPAÑOLES",2,5,7
" 04","CERRO-AMATE","LA CORUÑA","EXTRANJEROS",1,1,2
" 04","CERRO-AMATE","LA CORUÑA","TOTAL POBLACION",3,6,9
" 04","CERRO-AMATE","LA RIOJA","ESPAÑOLES",2,0,2
" 04","CERRO-AMATE","LA RIOJA","EXTRANJEROS",2,1,3
" 04","CERRO-AMATE","LA RIOJA","TOTAL POBLACION",4,1,5
" 04","CERRO-AMATE","LAS PALMAS","ESPAÑOLES",26,13,39
" 04","CERRO-AMATE","LAS PALMAS","EXTRANJEROS",3,2,5
" 04","CERRO-AMATE","LAS PALMAS","TOTAL POBLACION",29,15,44
" 04","CERRO-AMATE","LEON","ESPAÑOLES",1,0,1
" 04","CERRO-AMATE","LEON","TOTAL POBLACION",1,0,1
" 04","CERRO-AMATE","LLEIDA","ESPAÑOLES",5,1,6
" 04","CERRO-AMATE","LLEIDA","TOTAL POBLACION",5,1,6
" 04","CERRO-AMATE","MADRID","ESPAÑOLES",33,34,67
" 04","CERRO-AMATE","MADRID","EXTRANJEROS",29,25,54
" 04","CERRO-AMATE","MADRID","TOTAL POBLACION",62,59,121
" 04","CERRO-AMATE","MALAGA","ESPAÑOLES",20,23,43
" 04","CERRO-AMATE","MALAGA","EXTRANJEROS",11,4,15
" 04","CERRO-AMATE","MALAGA","TOTAL POBLACION",31,27,58
" 04","CERRO-AMATE","MELILLA","ESPAÑOLES",4,3,7
" 04","CERRO-AMATE","MELILLA","TOTAL POBLACION",4,3,7
" 04","CERRO-AMATE","MURCIA","ESPAÑOLES",8,10,18
" 04","CERRO-AMATE","MURCIA","EXTRANJEROS",4,6,10
" 04","CERRO-AMATE","MURCIA","TOTAL POBLACION",12,16,28
" 04","CERRO-AMATE","NAVARRA","ESPAÑOLES",2,1,3
" 04","CERRO-AMATE","NAVARRA","EXTRANJEROS",0,2,2
" 04","CERRO-AMATE","NAVARRA","TOTAL POBLACION",2,3,5
" 04","CERRO-AMATE","ORENSE","ESPAÑOLES",4,5,9
" 04","CERRO-AMATE","ORENSE","EXTRANJEROS",1,2,3
" 04","CERRO-AMATE","ORENSE","TOTAL POBLACION",5,7,12
" 04","CERRO-AMATE","PALENCIA","ESPAÑOLES",2,0,2
" 04","CERRO-AMATE","PALENCIA","TOTAL POBLACION",2,0,2
" 04","CERRO-AMATE","SANTA CRUZ DE TENERIFE","ESPAÑOLES",13,17,30
" 04","CERRO-AMATE","SANTA CRUZ DE TENERIFE","EXTRANJEROS",3,0,3
" 04","CERRO-AMATE","SANTA CRUZ DE TENERIFE","TOTAL POBLACION",16,17,33
" 04","CERRO-AMATE","SEVILLA","ESPAÑOLES",501,526,1027
" 04","CERRO-AMATE","SEVILLA","EXTRANJEROS",49,61,110
" 04","CERRO-AMATE","SEVILLA","TOTAL POBLACION",550,587,1137
" 04","CERRO-AMATE","SORIA","ESPAÑOLES",1,2,3
" 04","CERRO-AMATE","SORIA","TOTAL POBLACION",1,2,3
" 04","CERRO-AMATE","TARRAGONA","ESPAÑOLES",1,2,3
" 04","CERRO-AMATE","TARRAGONA","EXTRANJEROS",2,2,4
" 04","CERRO-AMATE","TARRAGONA","TOTAL POBLACION",3,4,7
" 04","CERRO-AMATE","TOLEDO","ESPAÑOLES",0,1,1
" 04","CERRO-AMATE","TOLEDO","EXTRANJEROS",2,2,4
" 04","CERRO-AMATE","TOLEDO","TOTAL POBLACION",2,3,5
" 04","CERRO-AMATE","VALENCIA","ESPAÑOLES",6,11,17
" 04","CERRO-AMATE","VALENCIA","EXTRANJEROS",5,7,12
" 04","CERRO-AMATE","VALENCIA","TOTAL POBLACION",11,18,29
" 04","CERRO-AMATE","VALLADOLID","ESPAÑOLES",1,1,2
" 04","CERRO-AMATE","VALLADOLID","TOTAL POBLACION",1,1,2
" 04","CERRO-AMATE","ZAMORA","ESPAÑOLES",0,1,1
" 04","CERRO-AMATE","ZAMORA","EXTRANJEROS",0,1,1
" 04","CERRO-AMATE","ZAMORA","TOTAL POBLACION",0,2,2
" 04","CERRO-AMATE","ZARAGOZA","ESPAÑOLES",4,0,4
" 04","CERRO-AMATE","ZARAGOZA","EXTRANJEROS",2,2,4
" 04","CERRO-AMATE","ZARAGOZA","TOTAL POBLACION",6,2,8
" 05","SUR","- TODOS -","ESPAÑOLES",815,868,1683
" 05","SUR","- TODOS -","EXTRANJEROS",111,144,255
" 05","SUR","- TODOS -","TOTAL POBLACION",926,1012,1938
" 05","SUR","ALICANTE","ESPAÑOLES",4,7,11
" 05","SUR","ALICANTE","EXTRANJEROS",2,0,2
" 05","SUR","ALICANTE","TOTAL POBLACION",6,7,13
" 05","SUR","ALMERIA","ESPAÑOLES",5,9,14
" 05","SUR","ALMERIA","EXTRANJEROS",2,0,2
" 05","SUR","ALMERIA","TOTAL POBLACION",7,9,16
" 05","SUR","ASTURIAS","ESPAÑOLES",1,0,1
" 05","SUR","ASTURIAS","EXTRANJEROS",1,1,2
" 05","SUR","ASTURIAS","TOTAL POBLACION",2,1,3
" 05","SUR","AVILA","ESPAÑOLES",3,2,5
" 05","SUR","AVILA","EXTRANJEROS",0,1,1
" 05","SUR","AVILA","TOTAL POBLACION",3,3,6
" 05","SUR","BADAJOZ","ESPAÑOLES",14,13,27
" 05","SUR","BADAJOZ","EXTRANJEROS",1,0,1
" 05","SUR","BADAJOZ","TOTAL POBLACION",15,13,28
" 05","SUR","BALEARES","ESPAÑOLES",16,11,27
" 05","SUR","BALEARES","EXTRANJEROS",1,3,4
" 05","SUR","BALEARES","TOTAL POBLACION",17,14,31
" 05","SUR","BARCELONA","ESPAÑOLES",14,11,25
" 05","SUR","BARCELONA","EXTRANJEROS",7,5,12
" 05","SUR","BARCELONA","TOTAL POBLACION",21,16,37
" 05","SUR","BIZKAIA","ESPAÑOLES",1,3,4
" 05","SUR","BIZKAIA","EXTRANJEROS",1,2,3
" 05","SUR","BIZKAIA","TOTAL POBLACION",2,5,7
" 05","SUR","BURGOS","ESPAÑOLES",1,2,3
" 05","SUR","BURGOS","TOTAL POBLACION",1,2,3
" 05","SUR","CACERES","ESPAÑOLES",1,3,4
" 05","SUR","CACERES","TOTAL POBLACION",1,3,4
" 05","SUR","CADIZ","ESPAÑOLES",63,66,129
" 05","SUR","CADIZ","EXTRANJEROS",4,6,10
" 05","SUR","CADIZ","TOTAL POBLACION",67,72,139
" 05","SUR","CANTABRIA","ESPAÑOLES",1,3,4
" 05","SUR","CANTABRIA","TOTAL POBLACION",1,3,4
" 05","SUR","CASTELLON","ESPAÑOLES",1,0,1
" 05","SUR","CASTELLON","TOTAL POBLACION",1,0,1
" 05","SUR","CEUTA","ESPAÑOLES",4,3,7
" 05","SUR","CEUTA","TOTAL POBLACION",4,3,7
" 05","SUR","CIUDAD REAL","ESPAÑOLES",1,0,1
" 05","SUR","CIUDAD REAL","EXTRANJEROS",4,1,5
" 05","SUR","CIUDAD REAL","TOTAL POBLACION",5,1,6
" 05","SUR","CORDOBA","ESPAÑOLES",12,7,19
" 05","SUR","CORDOBA","EXTRANJEROS",0,2,2
" 05","SUR","CORDOBA","TOTAL POBLACION",12,9,21
" 05","SUR","CUENCA","ESPAÑOLES",0,3,3
" 05","SUR","CUENCA","TOTAL POBLACION",0,3,3
" 05","SUR","EXTRAJERO","ESPAÑOLES",73,70,143
" 05","SUR","EXTRAJERO","EXTRANJEROS",10,18,28
" 05","SUR","EXTRAJERO","TOTAL POBLACION",83,88,171
" 05","SUR","GERONA","ESPAÑOLES",4,6,10
" 05","SUR","GERONA","EXTRANJEROS",1,0,1
" 05","SUR","GERONA","TOTAL POBLACION",5,6,11
" 05","SUR","GIPUZKOA","ESPAÑOLES",2,1,3
" 05","SUR","GIPUZKOA","EXTRANJEROS",5,2,7
" 05","SUR","GIPUZKOA","TOTAL POBLACION",7,3,10
" 05","SUR","GRANADA","ESPAÑOLES",9,13,22
" 05","SUR","GRANADA","EXTRANJEROS",5,4,9
" 05","SUR","GRANADA","TOTAL POBLACION",14,17,31
" 05","SUR","GUADALAJARA","ESPAÑOLES",1,2,3
" 05","SUR","GUADALAJARA","EXTRANJEROS",1,2,3
" 05","SUR","GUADALAJARA","TOTAL POBLACION",2,4,6
" 05","SUR","HUELVA","ESPAÑOLES",22,35,57
" 05","SUR","HUELVA","EXTRANJEROS",11,10,21
" 05","SUR","HUELVA","TOTAL POBLACION",33,45,78
" 05","SUR","HUESCA","EXTRANJEROS",1,1,2
" 05","SUR","HUESCA","TOTAL POBLACION",1,1,2
" 05","SUR","JAEN","ESPAÑOLES",6,2,8
" 05","SUR","JAEN","TOTAL POBLACION",6,2,8
" 05","SUR","LA CORUÑA","ESPAÑOLES",6,3,9
" 05","SUR","LA CORUÑA","EXTRANJEROS",0,1,1
" 05","SUR","LA CORUÑA","TOTAL POBLACION",6,4,10
" 05","SUR","LA RIOJA","ESPAÑOLES",4,3,7
" 05","SUR","LA RIOJA","TOTAL POBLACION",4,3,7
" 05","SUR","LAS PALMAS","ESPAÑOLES",18,18,36
" 05","SUR","LAS PALMAS","EXTRANJEROS",1,1,2
" 05","SUR","LAS PALMAS","TOTAL POBLACION",19,19,38
" 05","SUR","LEON","ESPAÑOLES",2,2,4
" 05","SUR","LEON","EXTRANJEROS",1,1,2
" 05","SUR","LEON","TOTAL POBLACION",3,3,6
" 05","SUR","MADRID","ESPAÑOLES",81,70,151
" 05","SUR","MADRID","EXTRANJEROS",7,16,23
" 05","SUR","MADRID","TOTAL POBLACION",88,86,174
" 05","SUR","MALAGA","ESPAÑOLES",31,48,79
" 05","SUR","MALAGA","EXTRANJEROS",9,11,20
" 05","SUR","MALAGA","TOTAL POBLACION",40,59,99
" 05","SUR","MELILLA","ESPAÑOLES",2,0,2
" 05","SUR","MELILLA","EXTRANJEROS",0,1,1
" 05","SUR","MELILLA","TOTAL POBLACION",2,1,3
" 05","SUR","MURCIA","ESPAÑOLES",3,2,5
" 05","SUR","MURCIA","EXTRANJEROS",2,2,4
" 05","SUR","MURCIA","TOTAL POBLACION",5,4,9
" 05","SUR","NAVARRA","ESPAÑOLES",3,3,6
" 05","SUR","NAVARRA","EXTRANJEROS",1,2,3
" 05","SUR","NAVARRA","TOTAL POBLACION",4,5,9
" 05","SUR","ORENSE","ESPAÑOLES",1,1,2
" 05","SUR","ORENSE","TOTAL POBLACION",1,1,2
" 05","SUR","PONTEVEDRA","ESPAÑOLES",4,2,6
" 05","SUR","PONTEVEDRA","TOTAL POBLACION",4,2,6
" 05","SUR","SALAMANCA","ESPAÑOLES",1,4,5
" 05","SUR","SALAMANCA","EXTRANJEROS",0,1,1
" 05","SUR","SALAMANCA","TOTAL POBLACION",1,5,6
" 05","SUR","SANTA CRUZ DE TENERIFE","ESPAÑOLES",6,7,13
" 05","SUR","SANTA CRUZ DE TENERIFE","EXTRANJEROS",0,1,1
" 05","SUR","SANTA CRUZ DE TENERIFE","TOTAL POBLACION",6,8,14
" 05","SUR","SEVILLA","ESPAÑOLES",379,411,790
" 05","SUR","SEVILLA","EXTRANJEROS",26,46,72
" 05","SUR","SEVILLA","TOTAL POBLACION",405,457,862
" 05","SUR","TARRAGONA","ESPAÑOLES",2,5,7
" 05","SUR","TARRAGONA","TOTAL POBLACION",2,5,7
" 05","SUR","TOLEDO","ESPAÑOLES",0,1,1
" 05","SUR","TOLEDO","TOTAL POBLACION",0,1,1
" 05","SUR","VALENCIA","ESPAÑOLES",6,6,12
" 05","SUR","VALENCIA","EXTRANJEROS",6,3,9
" 05","SUR","VALENCIA","TOTAL POBLACION",12,9,21
" 05","SUR","VALLADOLID","ESPAÑOLES",4,8,12
" 05","SUR","VALLADOLID","TOTAL POBLACION",4,8,12
" 05","SUR","ZAMORA","ESPAÑOLES",1,0,1
" 05","SUR","ZAMORA","TOTAL POBLACION",1,0,1
" 05","SUR","ZARAGOZA","ESPAÑOLES",2,2,4
" 05","SUR","ZARAGOZA","EXTRANJEROS",1,0,1
" 05","SUR","ZARAGOZA","TOTAL POBLACION",3,2,5
" 06","TRIANA","- TODOS -","ESPAÑOLES",596,642,1238
" 06","TRIANA","- TODOS -","EXTRANJEROS",68,98,166
" 06","TRIANA","- TODOS -","TOTAL POBLACION",664,740,1404
" 06","TRIANA","ALBACETE","ESPAÑOLES",0,1,1
" 06","TRIANA","ALBACETE","TOTAL POBLACION",0,1,1
" 06","TRIANA","ALICANTE","ESPAÑOLES",2,4,6
" 06","TRIANA","ALICANTE","EXTRANJEROS",1,0,1
" 06","TRIANA","ALICANTE","TOTAL POBLACION",3,4,7
" 06","TRIANA","ALMERIA","ESPAÑOLES",5,3,8
" 06","TRIANA","ALMERIA","TOTAL POBLACION",5,3,8
" 06","TRIANA","ARABA/ALAVA","ESPAÑOLES",1,0,1
" 06","TRIANA","ARABA/ALAVA","TOTAL POBLACION",1,0,1
" 06","TRIANA","ASTURIAS","ESPAÑOLES",0,1,1
" 06","TRIANA","ASTURIAS","EXTRANJEROS",2,3,5
" 06","TRIANA","ASTURIAS","TOTAL POBLACION",2,4,6
" 06","TRIANA","BADAJOZ","ESPAÑOLES",6,7,13
" 06","TRIANA","BADAJOZ","TOTAL POBLACION",6,7,13
" 06","TRIANA","BALEARES","ESPAÑOLES",10,15,25
" 06","TRIANA","BALEARES","TOTAL POBLACION",10,15,25
" 06","TRIANA","BARCELONA","ESPAÑOLES",20,22,42
" 06","TRIANA","BARCELONA","EXTRANJEROS",3,9,12
" 06","TRIANA","BARCELONA","TOTAL POBLACION",23,31,54
" 06","TRIANA","BIZKAIA","ESPAÑOLES",2,2,4
" 06","TRIANA","BIZKAIA","TOTAL POBLACION",2,2,4
" 06","TRIANA","BURGOS","ESPAÑOLES",1,1,2
" 06","TRIANA","BURGOS","TOTAL POBLACION",1,1,2
" 06","TRIANA","CACERES","ESPAÑOLES",2,1,3
" 06","TRIANA","CACERES","EXTRANJEROS",0,1,1
" 06","TRIANA","CACERES","TOTAL POBLACION",2,2,4
" 06","TRIANA","CADIZ","ESPAÑOLES",34,31,65
" 06","TRIANA","CADIZ","EXTRANJEROS",1,3,4
" 06","TRIANA","CADIZ","TOTAL POBLACION",35,34,69
" 06","TRIANA","CANTABRIA","ESPAÑOLES",2,0,2
" 06","TRIANA","CANTABRIA","EXTRANJEROS",1,1,2
" 06","TRIANA","CANTABRIA","TOTAL POBLACION",3,1,4
" 06","TRIANA","CASTELLON","ESPAÑOLES",1,1,2
" 06","TRIANA","CASTELLON","EXTRANJEROS",1,0,1
" 06","TRIANA","CASTELLON","TOTAL POBLACION",2,1,3
" 06","TRIANA","CEUTA","ESPAÑOLES",1,0,1
" 06","TRIANA","CEUTA","TOTAL POBLACION",1,0,1
" 06","TRIANA","CIUDAD REAL","ESPAÑOLES",2,5,7
" 06","TRIANA","CIUDAD REAL","TOTAL POBLACION",2,5,7
" 06","TRIANA","CORDOBA","ESPAÑOLES",9,12,21
" 06","TRIANA","CORDOBA","EXTRANJEROS",0,1,1
" 06","TRIANA","CORDOBA","TOTAL POBLACION",9,13,22
" 06","TRIANA","EXTRAJERO","ESPAÑOLES",40,51,91
" 06","TRIANA","EXTRAJERO","EXTRANJEROS",6,6,12
" 06","TRIANA","EXTRAJERO","TOTAL POBLACION",46,57,103
" 06","TRIANA","GERONA","ESPAÑOLES",0,2,2
" 06","TRIANA","GERONA","TOTAL POBLACION",0,2,2
" 06","TRIANA","GRANADA","ESPAÑOLES",3,6,9
" 06","TRIANA","GRANADA","EXTRANJEROS",1,0,1
" 06","TRIANA","GRANADA","TOTAL POBLACION",4,6,10
" 06","TRIANA","HUELVA","ESPAÑOLES",30,29,59
" 06","TRIANA","HUELVA","EXTRANJEROS",3,3,6
" 06","TRIANA","HUELVA","TOTAL POBLACION",33,32,65
" 06","TRIANA","JAEN","ESPAÑOLES",3,2,5
" 06","TRIANA","JAEN","EXTRANJEROS",1,0,1
" 06","TRIANA","JAEN","TOTAL POBLACION",4,2,6
" 06","TRIANA","LA CORUÑA","ESPAÑOLES",4,1,5
" 06","TRIANA","LA CORUÑA","TOTAL POBLACION",4,1,5
" 06","TRIANA","LA RIOJA","ESPAÑOLES",0,1,1
" 06","TRIANA","LA RIOJA","EXTRANJEROS",0,1,1
" 06","TRIANA","LA RIOJA","TOTAL POBLACION",0,2,2
" 06","TRIANA","LAS PALMAS","ESPAÑOLES",8,7,15
" 06","TRIANA","LAS PALMAS","EXTRANJEROS",0,4,4
" 06","TRIANA","LAS PALMAS","TOTAL POBLACION",8,11,19
" 06","TRIANA","LEON","ESPAÑOLES",1,1,2
" 06","TRIANA","LEON","TOTAL POBLACION",1,1,2
" 06","TRIANA","LLEIDA","ESPAÑOLES",2,0,2
" 06","TRIANA","LLEIDA","TOTAL POBLACION",2,0,2
" 06","TRIANA","MADRID","ESPAÑOLES",37,41,78
" 06","TRIANA","MADRID","EXTRANJEROS",6,18,24
" 06","TRIANA","MADRID","TOTAL POBLACION",43,59,102
" 06","TRIANA","MALAGA","ESPAÑOLES",16,18,34
" 06","TRIANA","MALAGA","EXTRANJEROS",6,2,8
" 06","TRIANA","MALAGA","TOTAL POBLACION",22,20,42
" 06","TRIANA","MELILLA","ESPAÑOLES",0,1,1
" 06","TRIANA","MELILLA","EXTRANJEROS",0,1,1
" 06","TRIANA","MELILLA","TOTAL POBLACION",0,2,2
" 06","TRIANA","MURCIA","ESPAÑOLES",2,1,3
" 06","TRIANA","MURCIA","EXTRANJEROS",3,2,5
" 06","TRIANA","MURCIA","TOTAL POBLACION",5,3,8
" 06","TRIANA","NAVARRA","ESPAÑOLES",1,1,2
" 06","TRIANA","NAVARRA","TOTAL POBLACION",1,1,2
" 06","TRIANA","ORENSE","ESPAÑOLES",2,3,5
" 06","TRIANA","ORENSE","TOTAL POBLACION",2,3,5
" 06","TRIANA","PONTEVEDRA","ESPAÑOLES",1,3,4
" 06","TRIANA","PONTEVEDRA","EXTRANJEROS",1,0,1
" 06","TRIANA","PONTEVEDRA","TOTAL POBLACION",2,3,5
" 06","TRIANA","SALAMANCA","ESPAÑOLES",2,2,4
" 06","TRIANA","SALAMANCA","EXTRANJEROS",0,1,1
" 06","TRIANA","SALAMANCA","TOTAL POBLACION",2,3,5
" 06","TRIANA","SANTA CRUZ DE TENERIFE","ESPAÑOLES",5,5,10
" 06","TRIANA","SANTA CRUZ DE TENERIFE","EXTRANJEROS",2,0,2
" 06","TRIANA","SANTA CRUZ DE TENERIFE","TOTAL POBLACION",7,5,12
" 06","TRIANA","SEGOVIA","ESPAÑOLES",0,1,1
" 06","TRIANA","SEGOVIA","TOTAL POBLACION",0,1,1
" 06","TRIANA","SEVILLA","ESPAÑOLES",327,349,676
" 06","TRIANA","SEVILLA","EXTRANJEROS",28,41,69
" 06","TRIANA","SEVILLA","TOTAL POBLACION",355,390,745
" 06","TRIANA","TARRAGONA","ESPAÑOLES",3,0,3
" 06","TRIANA","TARRAGONA","TOTAL POBLACION",3,0,3
" 06","TRIANA","TOLEDO","ESPAÑOLES",0,2,2
" 06","TRIANA","TOLEDO","TOTAL POBLACION",0,2,2
" 06","TRIANA","VALENCIA","ESPAÑOLES",1,5,6
" 06","TRIANA","VALENCIA","EXTRANJEROS",2,1,3
" 06","TRIANA","VALENCIA","TOTAL POBLACION",3,6,9
" 06","TRIANA","VALLADOLID","ESPAÑOLES",4,2,6
" 06","TRIANA","VALLADOLID","TOTAL POBLACION",4,2,6
" 06","TRIANA","ZARAGOZA","ESPAÑOLES",6,2,8
" 06","TRIANA","ZARAGOZA","TOTAL POBLACION",6,2,8
" 07","NORTE","- TODOS -","ESPAÑOLES",706,656,1362
" 07","NORTE","- TODOS -","EXTRANJEROS",71,62,133
" 07","NORTE","- TODOS -","NO CONSTA",1,0,1
" 07","NORTE","- TODOS -","TOTAL POBLACION",778,718,1496
" 07","NORTE","ALBACETE","ESPAÑOLES",1,0,1
" 07","NORTE","ALBACETE","TOTAL POBLACION",1,0,1
" 07","NORTE","ALICANTE","ESPAÑOLES",6,2,8
" 07","NORTE","ALICANTE","EXTRANJEROS",1,1,2
" 07","NORTE","ALICANTE","TOTAL POBLACION",7,3,10
" 07","NORTE","ALMERIA","ESPAÑOLES",2,0,2
" 07","NORTE","ALMERIA","TOTAL POBLACION",2,0,2
" 07","NORTE","ARABA/ALAVA","EXTRANJEROS",1,0,1
" 07","NORTE","ARABA/ALAVA","TOTAL POBLACION",1,0,1
" 07","NORTE","BADAJOZ","ESPAÑOLES",7,8,15
" 07","NORTE","BADAJOZ","EXTRANJEROS",1,0,1
" 07","NORTE","BADAJOZ","TOTAL POBLACION",8,8,16
" 07","NORTE","BALEARES","ESPAÑOLES",9,15,24
" 07","NORTE","BALEARES","EXTRANJEROS",7,4,11
" 07","NORTE","BALEARES","TOTAL POBLACION",16,19,35
" 07","NORTE","BARCELONA","ESPAÑOLES",14,26,40
" 07","NORTE","BARCELONA","EXTRANJEROS",4,1,5
" 07","NORTE","BARCELONA","NO CONSTA",1,0,1
" 07","NORTE","BARCELONA","TOTAL POBLACION",19,27,46
" 07","NORTE","BIZKAIA","ESPAÑOLES",3,1,4
" 07","NORTE","BIZKAIA","EXTRANJEROS",1,1,2
" 07","NORTE","BIZKAIA","TOTAL POBLACION",4,2,6
" 07","NORTE","BURGOS","ESPAÑOLES",1,0,1
" 07","NORTE","BURGOS","TOTAL POBLACION",1,0,1
" 07","NORTE","CADIZ","ESPAÑOLES",36,41,77
" 07","NORTE","CADIZ","EXTRANJEROS",1,1,2
" 07","NORTE","CADIZ","TOTAL POBLACION",37,42,79
" 07","NORTE","CANTABRIA","ESPAÑOLES",0,1,1
" 07","NORTE","CANTABRIA","EXTRANJEROS",0,1,1
" 07","NORTE","CANTABRIA","TOTAL POBLACION",0,2,2
" 07","NORTE","CASTELLON","ESPAÑOLES",1,0,1
" 07","NORTE","CASTELLON","TOTAL POBLACION",1,0,1
" 07","NORTE","CEUTA","ESPAÑOLES",0,1,1
" 07","NORTE","CEUTA","TOTAL POBLACION",0,1,1
" 07","NORTE","CIUDAD REAL","ESPAÑOLES",2,1,3
" 07","NORTE","CIUDAD REAL","EXTRANJEROS",1,0,1
" 07","NORTE","CIUDAD REAL","TOTAL POBLACION",3,1,4
" 07","NORTE","CORDOBA","ESPAÑOLES",7,7,14
" 07","NORTE","CORDOBA","TOTAL POBLACION",7,7,14
" 07","NORTE","EXTRAJERO","ESPAÑOLES",33,30,63
" 07","NORTE","EXTRAJERO","EXTRANJEROS",2,2,4
" 07","NORTE","EXTRAJERO","TOTAL POBLACION",35,32,67
" 07","NORTE","GERONA","ESPAÑOLES",4,2,6
" 07","NORTE","GERONA","EXTRANJEROS",0,1,1
" 07","NORTE","GERONA","TOTAL POBLACION",4,3,7
" 07","NORTE","GIPUZKOA","ESPAÑOLES",1,3,4
" 07","NORTE","GIPUZKOA","EXTRANJEROS",0,4,4
" 07","NORTE","GIPUZKOA","TOTAL POBLACION",1,7,8
" 07","NORTE","GRANADA","ESPAÑOLES",8,11,19
" 07","NORTE","GRANADA","EXTRANJEROS",0,1,1
" 07","NORTE","GRANADA","TOTAL POBLACION",8,12,20
" 07","NORTE","GUADALAJARA","ESPAÑOLES",0,2,2
" 07","NORTE","GUADALAJARA","EXTRANJEROS",1,0,1
" 07","NORTE","GUADALAJARA","TOTAL POBLACION",1,2,3
" 07","NORTE","HUELVA","ESPAÑOLES",17,24,41
" 07","NORTE","HUELVA","EXTRANJEROS",4,0,4
" 07","NORTE","HUELVA","TOTAL POBLACION",21,24,45
" 07","NORTE","HUESCA","ESPAÑOLES",1,0,1
" 07","NORTE","HUESCA","TOTAL POBLACION",1,0,1
" 07","NORTE","JAEN","ESPAÑOLES",6,5,11
" 07","NORTE","JAEN","EXTRANJEROS",1,1,2
" 07","NORTE","JAEN","TOTAL POBLACION",7,6,13
" 07","NORTE","LA CORUÑA","ESPAÑOLES",4,0,4
" 07","NORTE","LA CORUÑA","TOTAL POBLACION",4,0,4
" 07","NORTE","LAS PALMAS","ESPAÑOLES",17,16,33
" 07","NORTE","LAS PALMAS","EXTRANJEROS",3,0,3
" 07","NORTE","LAS PALMAS","TOTAL POBLACION",20,16,36
" 07","NORTE","LEON","ESPAÑOLES",3,0,3
" 07","NORTE","LEON","TOTAL POBLACION",3,0,3
" 07","NORTE","LLEIDA","ESPAÑOLES",0,2,2
" 07","NORTE","LLEIDA","TOTAL POBLACION",0,2,2
" 07","NORTE","LUGO","ESPAÑOLES",1,3,4
" 07","NORTE","LUGO","TOTAL POBLACION",1,3,4
" 07","NORTE","MADRID","ESPAÑOLES",45,26,71
" 07","NORTE","MADRID","EXTRANJEROS",8,6,14
" 07","NORTE","MADRID","TOTAL POBLACION",53,32,85
" 07","NORTE","MALAGA","ESPAÑOLES",8,12,20
" 07","NORTE","MALAGA","EXTRANJEROS",5,4,9
" 07","NORTE","MALAGA","TOTAL POBLACION",13,16,29
" 07","NORTE","MELILLA","ESPAÑOLES",0,1,1
" 07","NORTE","MELILLA","EXTRANJEROS",1,1,2
" 07","NORTE","MELILLA","TOTAL POBLACION",1,2,3
" 07","NORTE","MURCIA","ESPAÑOLES",2,3,5
" 07","NORTE","MURCIA","EXTRANJEROS",2,0,2
" 07","NORTE","MURCIA","TOTAL POBLACION",4,3,7
" 07","NORTE","NAVARRA","ESPAÑOLES",4,2,6
" 07","NORTE","NAVARRA","EXTRANJEROS",1,1,2
" 07","NORTE","NAVARRA","TOTAL POBLACION",5,3,8
" 07","NORTE","ORENSE","ESPAÑOLES",0,2,2
" 07","NORTE","ORENSE","TOTAL POBLACION",0,2,2
" 07","NORTE","PONTEVEDRA","ESPAÑOLES",3,3,6
" 07","NORTE","PONTEVEDRA","EXTRANJEROS",0,1,1
" 07","NORTE","PONTEVEDRA","TOTAL POBLACION",3,4,7
" 07","NORTE","SALAMANCA","ESPAÑOLES",2,0,2
" 07","NORTE","SALAMANCA","TOTAL POBLACION",2,0,2
" 07","NORTE","SANTA CRUZ DE TENERIFE","ESPAÑOLES",7,3,10
" 07","NORTE","SANTA CRUZ DE TENERIFE","EXTRANJEROS",1,0,1
" 07","NORTE","SANTA CRUZ DE TENERIFE","TOTAL POBLACION",8,3,11
" 07","NORTE","SEGOVIA","ESPAÑOLES",1,0,1
" 07","NORTE","SEGOVIA","TOTAL POBLACION",1,0,1
" 07","NORTE","SEVILLA","ESPAÑOLES",440,395,835
" 07","NORTE","SEVILLA","EXTRANJEROS",22,29,51
" 07","NORTE","SEVILLA","TOTAL POBLACION",462,424,886
" 07","NORTE","TARRAGONA","ESPAÑOLES",3,2,5
" 07","NORTE","TARRAGONA","TOTAL POBLACION",3,2,5
" 07","NORTE","VALENCIA","ESPAÑOLES",5,4,9
" 07","NORTE","VALENCIA","EXTRANJEROS",3,2,5
" 07","NORTE","VALENCIA","TOTAL POBLACION",8,6,14
" 07","NORTE","VALLADOLID","ESPAÑOLES",1,1,2
" 07","NORTE","VALLADOLID","TOTAL POBLACION",1,1,2
" 07","NORTE","ZARAGOZA","ESPAÑOLES",1,1,2
" 07","NORTE","ZARAGOZA","TOTAL POBLACION",1,1,2
" 08","S. PABLO-STA. JUSTA","- TODOS -","ESPAÑOLES",618,569,1187
" 08","S. PABLO-STA. JUSTA","- TODOS -","EXTRANJEROS",63,79,142
" 08","S. PABLO-STA. JUSTA","- TODOS -","NO CONSTA",1,0,1
" 08","S. PABLO-STA. JUSTA","- TODOS -","TOTAL POBLACION",682,648,1330
" 08","S. PABLO-STA. JUSTA","ALBACETE","ESPAÑOLES",0,1,1
" 08","S. PABLO-STA. JUSTA","ALBACETE","EXTRANJEROS",1,2,3
" 08","S. PABLO-STA. JUSTA","ALBACETE","TOTAL POBLACION",1,3,4
" 08","S. PABLO-STA. JUSTA","ALICANTE","ESPAÑOLES",7,4,11
" 08","S. PABLO-STA. JUSTA","ALICANTE","EXTRANJEROS",1,2,3
" 08","S. PABLO-STA. JUSTA","ALICANTE","TOTAL POBLACION",8,6,14
" 08","S. PABLO-STA. JUSTA","ALMERIA","ESPAÑOLES",0,1,1
" 08","S. PABLO-STA. JUSTA","ALMERIA","EXTRANJEROS",1,0,1
" 08","S. PABLO-STA. JUSTA","ALMERIA","TOTAL POBLACION",1,1,2
" 08","S. PABLO-STA. JUSTA","ARABA/ALAVA","ESPAÑOLES",0,1,1
" 08","S. PABLO-STA. JUSTA","ARABA/ALAVA","EXTRANJEROS",0,1,1
" 08","S. PABLO-STA. JUSTA","ARABA/ALAVA","TOTAL POBLACION",0,2,2
" 08","S. PABLO-STA. JUSTA","ASTURIAS","ESPAÑOLES",3,2,5
" 08","S. PABLO-STA. JUSTA","ASTURIAS","EXTRANJEROS",1,1,2
" 08","S. PABLO-STA. JUSTA","ASTURIAS","TOTAL POBLACION",4,3,7
" 08","S. PABLO-STA. JUSTA","AVILA","EXTRANJEROS",0,1,1
" 08","S. PABLO-STA. JUSTA","AVILA","TOTAL POBLACION",0,1,1
" 08","S. PABLO-STA. JUSTA","BADAJOZ","ESPAÑOLES",7,14,21
" 08","S. PABLO-STA. JUSTA","BADAJOZ","EXTRANJEROS",0,1,1
" 08","S. PABLO-STA. JUSTA","BADAJOZ","TOTAL POBLACION",7,15,22
" 08","S. PABLO-STA. JUSTA","BALEARES","ESPAÑOLES",16,14,30
" 08","S. PABLO-STA. JUSTA","BALEARES","EXTRANJEROS",4,3,7
" 08","S. PABLO-STA. JUSTA","BALEARES","TOTAL POBLACION",20,17,37
" 08","S. PABLO-STA. JUSTA","BARCELONA","ESPAÑOLES",21,15,36
" 08","S. PABLO-STA. JUSTA","BARCELONA","EXTRANJEROS",8,4,12
" 08","S. PABLO-STA. JUSTA","BARCELONA","TOTAL POBLACION",29,19,48
" 08","S. PABLO-STA. JUSTA","BIZKAIA","ESPAÑOLES",0,2,2
" 08","S. PABLO-STA. JUSTA","BIZKAIA","EXTRANJEROS",3,0,3
" 08","S. PABLO-STA. JUSTA","BIZKAIA","TOTAL POBLACION",3,2,5
" 08","S. PABLO-STA. JUSTA","CACERES","ESPAÑOLES",2,1,3
" 08","S. PABLO-STA. JUSTA","CACERES","EXTRANJEROS",1,0,1
" 08","S. PABLO-STA. JUSTA","CACERES","TOTAL POBLACION",3,1,4
" 08","S. PABLO-STA. JUSTA","CADIZ","ESPAÑOLES",44,32,76
" 08","S. PABLO-STA. JUSTA","CADIZ","EXTRANJEROS",4,3,7
" 08","S. PABLO-STA. JUSTA","CADIZ","TOTAL POBLACION",48,35,83
" 08","S. PABLO-STA. JUSTA","CANTABRIA","ESPAÑOLES",2,2,4
" 08","S. PABLO-STA. JUSTA","CANTABRIA","EXTRANJEROS",2,0,2
" 08","S. PABLO-STA. JUSTA","CANTABRIA","TOTAL POBLACION",4,2,6
" 08","S. PABLO-STA. JUSTA","CASTELLON","ESPAÑOLES",1,1,2
" 08","S. PABLO-STA. JUSTA","CASTELLON","TOTAL POBLACION",1,1,2
" 08","S. PABLO-STA. JUSTA","CEUTA","ESPAÑOLES",3,5,8
" 08","S. PABLO-STA. JUSTA","CEUTA","TOTAL POBLACION",3,5,8
" 08","S. PABLO-STA. JUSTA","CORDOBA","ESPAÑOLES",7,6,13
" 08","S. PABLO-STA. JUSTA","CORDOBA","EXTRANJEROS",2,2,4
" 08","S. PABLO-STA. JUSTA","CORDOBA","TOTAL POBLACION",9,8,17
" 08","S. PABLO-STA. JUSTA","EXTRAJERO","ESPAÑOLES",67,78,145
" 08","S. PABLO-STA. JUSTA","EXTRAJERO","EXTRANJEROS",4,3,7
" 08","S. PABLO-STA. JUSTA","EXTRAJERO","TOTAL POBLACION",71,81,152
" 08","S. PABLO-STA. JUSTA","GERONA","ESPAÑOLES",1,0,1
" 08","S. PABLO-STA. JUSTA","GERONA","EXTRANJEROS",1,4,5
" 08","S. PABLO-STA. JUSTA","GERONA","TOTAL POBLACION",2,4,6
" 08","S. PABLO-STA. JUSTA","GIPUZKOA","ESPAÑOLES",3,5,8
" 08","S. PABLO-STA. JUSTA","GIPUZKOA","EXTRANJEROS",2,0,2
" 08","S. PABLO-STA. JUSTA","GIPUZKOA","TOTAL POBLACION",5,5,10
" 08","S. PABLO-STA. JUSTA","GRANADA","ESPAÑOLES",5,5,10
" 08","S. PABLO-STA. JUSTA","GRANADA","TOTAL POBLACION",5,5,10
" 08","S. PABLO-STA. JUSTA","HUELVA","ESPAÑOLES",30,18,48
" 08","S. PABLO-STA. JUSTA","HUELVA","EXTRANJEROS",1,2,3
" 08","S. PABLO-STA. JUSTA","HUELVA","TOTAL POBLACION",31,20,51
" 08","S. PABLO-STA. JUSTA","HUESCA","ESPAÑOLES",0,1,1
" 08","S. PABLO-STA. JUSTA","HUESCA","TOTAL POBLACION",0,1,1
" 08","S. PABLO-STA. JUSTA","JAEN","ESPAÑOLES",2,1,3
" 08","S. PABLO-STA. JUSTA","JAEN","TOTAL POBLACION",2,1,3
" 08","S. PABLO-STA. JUSTA","LA CORUÑA","ESPAÑOLES",4,0,4
" 08","S. PABLO-STA. JUSTA","LA CORUÑA","EXTRANJEROS",1,0,1
" 08","S. PABLO-STA. JUSTA","LA CORUÑA","TOTAL POBLACION",5,0,5
" 08","S. PABLO-STA. JUSTA","LA RIOJA","ESPAÑOLES",0,1,1
" 08","S. PABLO-STA. JUSTA","LA RIOJA","TOTAL POBLACION",0,1,1
" 08","S. PABLO-STA. JUSTA","LAS PALMAS","ESPAÑOLES",10,13,23
" 08","S. PABLO-STA. JUSTA","LAS PALMAS","EXTRANJEROS",2,1,3
" 08","S. PABLO-STA. JUSTA","LAS PALMAS","TOTAL POBLACION",12,14,26
" 08","S. PABLO-STA. JUSTA","LUGO","ESPAÑOLES",1,0,1
" 08","S. PABLO-STA. JUSTA","LUGO","TOTAL POBLACION",1,0,1
" 08","S. PABLO-STA. JUSTA","MADRID","ESPAÑOLES",38,27,65
" 08","S. PABLO-STA. JUSTA","MADRID","EXTRANJEROS",2,7,9
" 08","S. PABLO-STA. JUSTA","MADRID","TOTAL POBLACION",40,34,74
" 08","S. PABLO-STA. JUSTA","MALAGA","ESPAÑOLES",15,18,33
" 08","S. PABLO-STA. JUSTA","MALAGA","EXTRANJEROS",0,6,6
" 08","S. PABLO-STA. JUSTA","MALAGA","TOTAL POBLACION",15,24,39
" 08","S. PABLO-STA. JUSTA","MELILLA","ESPAÑOLES",1,0,1
" 08","S. PABLO-STA. JUSTA","MELILLA","TOTAL POBLACION",1,0,1
" 08","S. PABLO-STA. JUSTA","MURCIA","ESPAÑOLES",5,0,5
" 08","S. PABLO-STA. JUSTA","MURCIA","TOTAL POBLACION",5,0,5
" 08","S. PABLO-STA. JUSTA","NAVARRA","ESPAÑOLES",4,2,6
" 08","S. PABLO-STA. JUSTA","NAVARRA","EXTRANJEROS",0,1,1
" 08","S. PABLO-STA. JUSTA","NAVARRA","TOTAL POBLACION",4,3,7
" 08","S. PABLO-STA. JUSTA","ORENSE","EXTRANJEROS",1,0,1
" 08","S. PABLO-STA. JUSTA","ORENSE","TOTAL POBLACION",1,0,1
" 08","S. PABLO-STA. JUSTA","PALENCIA","EXTRANJEROS",3,0,3
" 08","S. PABLO-STA. JUSTA","PALENCIA","TOTAL POBLACION",3,0,3
" 08","S. PABLO-STA. JUSTA","PONTEVEDRA","ESPAÑOLES",2,2,4
" 08","S. PABLO-STA. JUSTA","PONTEVEDRA","EXTRANJEROS",0,1,1
" 08","S. PABLO-STA. JUSTA","PONTEVEDRA","TOTAL POBLACION",2,3,5
" 08","S. PABLO-STA. JUSTA","SALAMANCA","ESPAÑOLES",1,0,1
" 08","S. PABLO-STA. JUSTA","SALAMANCA","TOTAL POBLACION",1,0,1
" 08","S. PABLO-STA. JUSTA","SANTA CRUZ DE TENERIFE","ESPAÑOLES",4,5,9
" 08","S. PABLO-STA. JUSTA","SANTA CRUZ DE TENERIFE","EXTRANJEROS",2,0,2
" 08","S. PABLO-STA. JUSTA","SANTA CRUZ DE TENERIFE","TOTAL POBLACION",6,5,11
" 08","S. PABLO-STA. JUSTA","SEGOVIA","ESPAÑOLES",1,0,1
" 08","S. PABLO-STA. JUSTA","SEGOVIA","TOTAL POBLACION",1,0,1
" 08","S. PABLO-STA. JUSTA","SEVILLA","ESPAÑOLES",305,285,590
" 08","S. PABLO-STA. JUSTA","SEVILLA","EXTRANJEROS",12,29,41
" 08","S. PABLO-STA. JUSTA","SEVILLA","NO CONSTA",1,0,1
" 08","S. PABLO-STA. JUSTA","SEVILLA","TOTAL POBLACION",318,314,632
" 08","S. PABLO-STA. JUSTA","TARRAGONA","EXTRANJEROS",0,1,1
" 08","S. PABLO-STA. JUSTA","TARRAGONA","TOTAL POBLACION",0,1,1
" 08","S. PABLO-STA. JUSTA","TOLEDO","ESPAÑOLES",0,1,1
" 08","S. PABLO-STA. JUSTA","TOLEDO","EXTRANJEROS",1,1,2
" 08","S. PABLO-STA. JUSTA","TOLEDO","TOTAL POBLACION",1,2,3
" 08","S. PABLO-STA. JUSTA","VALENCIA","ESPAÑOLES",6,0,6
" 08","S. PABLO-STA. JUSTA","VALENCIA","EXTRANJEROS",1,2,3
" 08","S. PABLO-STA. JUSTA","VALENCIA","TOTAL POBLACION",7,2,9
" 08","S. PABLO-STA. JUSTA","VALLADOLID","ESPAÑOLES",0,3,3
" 08","S. PABLO-STA. JUSTA","VALLADOLID","TOTAL POBLACION",0,3,3
" 08","S. PABLO-STA. JUSTA","ZARAGOZA","ESPAÑOLES",0,3,3
" 08","S. PABLO-STA. JUSTA","ZARAGOZA","EXTRANJEROS",2,1,3
" 08","S. PABLO-STA. JUSTA","ZARAGOZA","TOTAL POBLACION",2,4,6
" 09","ESTE","- TODOS -","ESPAÑOLES",1018,1013,2031
" 09","ESTE","- TODOS -","EXTRANJEROS",130,115,245
" 09","ESTE","- TODOS -","TOTAL POBLACION",1148,1128,2276
" 09","ESTE","ALBACETE","ESPAÑOLES",1,4,5
" 09","ESTE","ALBACETE","EXTRANJEROS",0,2,2
" 09","ESTE","ALBACETE","TOTAL POBLACION",1,6,7
" 09","ESTE","ALICANTE","ESPAÑOLES",6,11,17
" 09","ESTE","ALICANTE","EXTRANJEROS",1,2,3
" 09","ESTE","ALICANTE","TOTAL POBLACION",7,13,20
" 09","ESTE","ALMERIA","ESPAÑOLES",8,7,15
" 09","ESTE","ALMERIA","EXTRANJEROS",1,0,1
" 09","ESTE","ALMERIA","TOTAL POBLACION",9,7,16
" 09","ESTE","ARABA/ALAVA","ESPAÑOLES",0,1,1
" 09","ESTE","ARABA/ALAVA","EXTRANJEROS",1,0,1
" 09","ESTE","ARABA/ALAVA","TOTAL POBLACION",1,1,2
" 09","ESTE","ASTURIAS","EXTRANJEROS",1,0,1
" 09","ESTE","ASTURIAS","TOTAL POBLACION",1,0,1
" 09","ESTE","BADAJOZ","ESPAÑOLES",15,12,27
" 09","ESTE","BADAJOZ","TOTAL POBLACION",15,12,27
" 09","ESTE","BALEARES","ESPAÑOLES",20,21,41
" 09","ESTE","BALEARES","EXTRANJEROS",7,2,9
" 09","ESTE","BALEARES","TOTAL POBLACION",27,23,50
" 09","ESTE","BARCELONA","ESPAÑOLES",32,29,61
" 09","ESTE","BARCELONA","EXTRANJEROS",8,15,23
" 09","ESTE","BARCELONA","TOTAL POBLACION",40,44,84
" 09","ESTE","BIZKAIA","ESPAÑOLES",2,0,2
" 09","ESTE","BIZKAIA","EXTRANJEROS",2,0,2
" 09","ESTE","BIZKAIA","TOTAL POBLACION",4,0,4
" 09","ESTE","CACERES","ESPAÑOLES",4,5,9
" 09","ESTE","CACERES","EXTRANJEROS",2,1,3
" 09","ESTE","CACERES","TOTAL POBLACION",6,6,12
" 09","ESTE","CADIZ","ESPAÑOLES",48,54,102
" 09","ESTE","CADIZ","EXTRANJEROS",7,8,15
" 09","ESTE","CADIZ","TOTAL POBLACION",55,62,117
" 09","ESTE","CANTABRIA","ESPAÑOLES",1,2,3
" 09","ESTE","CANTABRIA","EXTRANJEROS",0,1,1
" 09","ESTE","CANTABRIA","TOTAL POBLACION",1,3,4
" 09","ESTE","CASTELLON","ESPAÑOLES",2,1,3
" 09","ESTE","CASTELLON","EXTRANJEROS",0,1,1
" 09","ESTE","CASTELLON","TOTAL POBLACION",2,2,4
" 09","ESTE","CEUTA","ESPAÑOLES",5,1,6
" 09","ESTE","CEUTA","TOTAL POBLACION",5,1,6
" 09","ESTE","CIUDAD REAL","ESPAÑOLES",1,3,4
" 09","ESTE","CIUDAD REAL","EXTRANJEROS",0,1,1
" 09","ESTE","CIUDAD REAL","TOTAL POBLACION",1,4,5
" 09","ESTE","CORDOBA","ESPAÑOLES",16,15,31
" 09","ESTE","CORDOBA","EXTRANJEROS",1,2,3
" 09","ESTE","CORDOBA","TOTAL POBLACION",17,17,34
" 09","ESTE","CUENCA","EXTRANJEROS",1,1,2
" 09","ESTE","CUENCA","TOTAL POBLACION",1,1,2
" 09","ESTE","EXTRAJERO","ESPAÑOLES",74,65,139
" 09","ESTE","EXTRAJERO","EXTRANJEROS",7,5,12
" 09","ESTE","EXTRAJERO","TOTAL POBLACION",81,70,151
" 09","ESTE","GERONA","ESPAÑOLES",2,4,6
" 09","ESTE","GERONA","TOTAL POBLACION",2,4,6
" 09","ESTE","GIPUZKOA","ESPAÑOLES",4,5,9
" 09","ESTE","GIPUZKOA","EXTRANJEROS",5,6,11
" 09","ESTE","GIPUZKOA","TOTAL POBLACION",9,11,20
" 09","ESTE","GRANADA","ESPAÑOLES",16,12,28
" 09","ESTE","GRANADA","EXTRANJEROS",2,1,3
" 09","ESTE","GRANADA","TOTAL POBLACION",18,13,31
" 09","ESTE","GUADALAJARA","ESPAÑOLES",3,0,3
" 09","ESTE","GUADALAJARA","EXTRANJEROS",0,3,3
" 09","ESTE","GUADALAJARA","TOTAL POBLACION",3,3,6
" 09","ESTE","HUELVA","ESPAÑOLES",36,40,76
" 09","ESTE","HUELVA","EXTRANJEROS",5,4,9
" 09","ESTE","HUELVA","TOTAL POBLACION",41,44,85
" 09","ESTE","HUESCA","ESPAÑOLES",1,0,1
" 09","ESTE","HUESCA","TOTAL POBLACION",1,0,1
" 09","ESTE","JAEN","ESPAÑOLES",5,5,10
" 09","ESTE","JAEN","EXTRANJEROS",2,0,2
" 09","ESTE","JAEN","TOTAL POBLACION",7,5,12
" 09","ESTE","LA CORUÑA","ESPAÑOLES",4,5,9
" 09","ESTE","LA CORUÑA","TOTAL POBLACION",4,5,9
" 09","ESTE","LA RIOJA","ESPAÑOLES",2,1,3
" 09","ESTE","LA RIOJA","TOTAL POBLACION",2,1,3
" 09","ESTE","LAS PALMAS","ESPAÑOLES",28,26,54
" 09","ESTE","LAS PALMAS","EXTRANJEROS",1,2,3
" 09","ESTE","LAS PALMAS","TOTAL POBLACION",29,28,57
" 09","ESTE","LEON","ESPAÑOLES",3,1,4
" 09","ESTE","LEON","EXTRANJEROS",0,1,1
" 09","ESTE","LEON","TOTAL POBLACION",3,2,5
" 09","ESTE","LLEIDA","ESPAÑOLES",1,0,1
" 09","ESTE","LLEIDA","EXTRANJEROS",0,1,1
" 09","ESTE","LLEIDA","TOTAL POBLACION",1,1,2
" 09","ESTE","MADRID","ESPAÑOLES",49,49,98
" 09","ESTE","MADRID","EXTRANJEROS",16,16,32
" 09","ESTE","MADRID","TOTAL POBLACION",65,65,130
" 09","ESTE","MALAGA","ESPAÑOLES",30,32,62
" 09","ESTE","MALAGA","EXTRANJEROS",11,10,21
" 09","ESTE","MALAGA","TOTAL POBLACION",41,42,83
" 09","ESTE","MELILLA","ESPAÑOLES",5,1,6
" 09","ESTE","MELILLA","TOTAL POBLACION",5,1,6
" 09","ESTE","MURCIA","ESPAÑOLES",3,1,4
" 09","ESTE","MURCIA","EXTRANJEROS",4,2,6
" 09","ESTE","MURCIA","TOTAL POBLACION",7,3,10
" 09","ESTE","NAVARRA","ESPAÑOLES",2,0,2
" 09","ESTE","NAVARRA","TOTAL POBLACION",2,0,2
" 09","ESTE","ORENSE","EXTRANJEROS",2,0,2
" 09","ESTE","ORENSE","TOTAL POBLACION",2,0,2
" 09","ESTE","PALENCIA","ESPAÑOLES",0,2,2
" 09","ESTE","PALENCIA","TOTAL POBLACION",0,2,2
" 09","ESTE","PONTEVEDRA","ESPAÑOLES",2,1,3
" 09","ESTE","PONTEVEDRA","TOTAL POBLACION",2,1,3
" 09","ESTE","SANTA CRUZ DE TENERIFE","ESPAÑOLES",5,12,17
" 09","ESTE","SANTA CRUZ DE TENERIFE","EXTRANJEROS",4,0,4
" 09","ESTE","SANTA CRUZ DE TENERIFE","TOTAL POBLACION",9,12,21
" 09","ESTE","SEGOVIA","EXTRANJEROS",1,0,1
" 09","ESTE","SEGOVIA","TOTAL POBLACION",1,0,1
" 09","ESTE","SEVILLA","ESPAÑOLES",563,570,1133
" 09","ESTE","SEVILLA","EXTRANJEROS",26,23,49
" 09","ESTE","SEVILLA","TOTAL POBLACION",589,593,1182
" 09","ESTE","SORIA","ESPAÑOLES",1,0,1
" 09","ESTE","SORIA","EXTRANJEROS",1,1,2
" 09","ESTE","SORIA","TOTAL POBLACION",2,1,3
" 09","ESTE","TARRAGONA","ESPAÑOLES",2,1,3
" 09","ESTE","TARRAGONA","TOTAL POBLACION",2,1,3
" 09","ESTE","TERUEL","ESPAÑOLES",0,1,1
" 09","ESTE","TERUEL","TOTAL POBLACION",0,1,1
" 09","ESTE","TOLEDO","ESPAÑOLES",2,2,4
" 09","ESTE","TOLEDO","EXTRANJEROS",1,0,1
" 09","ESTE","TOLEDO","TOTAL POBLACION",3,2,5
" 09","ESTE","VALENCIA","ESPAÑOLES",4,4,8
" 09","ESTE","VALENCIA","EXTRANJEROS",9,3,12
" 09","ESTE","VALENCIA","TOTAL POBLACION",13,7,20
" 09","ESTE","VALLADOLID","ESPAÑOLES",6,5,11
" 09","ESTE","VALLADOLID","TOTAL POBLACION",6,5,11
" 09","ESTE","ZARAGOZA","ESPAÑOLES",4,2,6
" 09","ESTE","ZARAGOZA","EXTRANJEROS",1,1,2
" 09","ESTE","ZARAGOZA","TOTAL POBLACION",5,3,8
" 10","BELLAVISTA-LA PALMERA","- TODOS -","ESPAÑOLES",541,531,1072
" 10","BELLAVISTA-LA PALMERA","- TODOS -","EXTRANJEROS",43,63,106
" 10","BELLAVISTA-LA PALMERA","- TODOS -","TOTAL POBLACION",584,594,1178
" 10","BELLAVISTA-LA PALMERA","ALICANTE","ESPAÑOLES",6,4,10
" 10","BELLAVISTA-LA PALMERA","ALICANTE","EXTRANJEROS",0,1,1
" 10","BELLAVISTA-LA PALMERA","ALICANTE","TOTAL POBLACION",6,5,11
" 10","BELLAVISTA-LA PALMERA","ALMERIA","ESPAÑOLES",5,11,16
" 10","BELLAVISTA-LA PALMERA","ALMERIA","EXTRANJEROS",1,2,3
" 10","BELLAVISTA-LA PALMERA","ALMERIA","TOTAL POBLACION",6,13,19
" 10","BELLAVISTA-LA PALMERA","BADAJOZ","ESPAÑOLES",5,11,16
" 10","BELLAVISTA-LA PALMERA","BADAJOZ","EXTRANJEROS",0,1,1
" 10","BELLAVISTA-LA PALMERA","BADAJOZ","TOTAL POBLACION",5,12,17
" 10","BELLAVISTA-LA PALMERA","BALEARES","ESPAÑOLES",12,8,20
" 10","BELLAVISTA-LA PALMERA","BALEARES","EXTRANJEROS",5,2,7
" 10","BELLAVISTA-LA PALMERA","BALEARES","TOTAL POBLACION",17,10,27
" 10","BELLAVISTA-LA PALMERA","BARCELONA","ESPAÑOLES",12,13,25
" 10","BELLAVISTA-LA PALMERA","BARCELONA","EXTRANJEROS",4,6,10
" 10","BELLAVISTA-LA PALMERA","BARCELONA","TOTAL POBLACION",16,19,35
" 10","BELLAVISTA-LA PALMERA","BIZKAIA","ESPAÑOLES",1,3,4
" 10","BELLAVISTA-LA PALMERA","BIZKAIA","TOTAL POBLACION",1,3,4
" 10","BELLAVISTA-LA PALMERA","BURGOS","ESPAÑOLES",1,1,2
" 10","BELLAVISTA-LA PALMERA","BURGOS","EXTRANJEROS",0,1,1
" 10","BELLAVISTA-LA PALMERA","BURGOS","TOTAL POBLACION",1,2,3
" 10","BELLAVISTA-LA PALMERA","CACERES","ESPAÑOLES",3,4,7
" 10","BELLAVISTA-LA PALMERA","CACERES","TOTAL POBLACION",3,4,7
" 10","BELLAVISTA-LA PALMERA","CADIZ","ESPAÑOLES",32,34,66
" 10","BELLAVISTA-LA PALMERA","CADIZ","EXTRANJEROS",1,3,4
" 10","BELLAVISTA-LA PALMERA","CADIZ","TOTAL POBLACION",33,37,70
" 10","BELLAVISTA-LA PALMERA","CANTABRIA","ESPAÑOLES",2,3,5
" 10","BELLAVISTA-LA PALMERA","CANTABRIA","TOTAL POBLACION",2,3,5
" 10","BELLAVISTA-LA PALMERA","CASTELLON","ESPAÑOLES",1,1,2
" 10","BELLAVISTA-LA PALMERA","CASTELLON","TOTAL POBLACION",1,1,2
" 10","BELLAVISTA-LA PALMERA","CEUTA","ESPAÑOLES",3,1,4
" 10","BELLAVISTA-LA PALMERA","CEUTA","TOTAL POBLACION",3,1,4
" 10","BELLAVISTA-LA PALMERA","CIUDAD REAL","ESPAÑOLES",0,3,3
" 10","BELLAVISTA-LA PALMERA","CIUDAD REAL","EXTRANJEROS",0,1,1
" 10","BELLAVISTA-LA PALMERA","CIUDAD REAL","TOTAL POBLACION",0,4,4
" 10","BELLAVISTA-LA PALMERA","CORDOBA","ESPAÑOLES",8,7,15
" 10","BELLAVISTA-LA PALMERA","CORDOBA","TOTAL POBLACION",8,7,15
" 10","BELLAVISTA-LA PALMERA","CUENCA","EXTRANJEROS",3,1,4
" 10","BELLAVISTA-LA PALMERA","CUENCA","TOTAL POBLACION",3,1,4
" 10","BELLAVISTA-LA PALMERA","EXTRAJERO","ESPAÑOLES",51,49,100
" 10","BELLAVISTA-LA PALMERA","EXTRAJERO","EXTRANJEROS",3,2,5
" 10","BELLAVISTA-LA PALMERA","EXTRAJERO","TOTAL POBLACION",54,51,105
" 10","BELLAVISTA-LA PALMERA","GERONA","ESPAÑOLES",2,0,2
" 10","BELLAVISTA-LA PALMERA","GERONA","TOTAL POBLACION",2,0,2
" 10","BELLAVISTA-LA PALMERA","GIPUZKOA","ESPAÑOLES",2,0,2
" 10","BELLAVISTA-LA PALMERA","GIPUZKOA","EXTRANJEROS",1,0,1
" 10","BELLAVISTA-LA PALMERA","GIPUZKOA","TOTAL POBLACION",3,0,3
" 10","BELLAVISTA-LA PALMERA","GRANADA","ESPAÑOLES",8,9,17
" 10","BELLAVISTA-LA PALMERA","GRANADA","EXTRANJEROS",1,0,1
" 10","BELLAVISTA-LA PALMERA","GRANADA","TOTAL POBLACION",9,9,18
" 10","BELLAVISTA-LA PALMERA","GUADALAJARA","ESPAÑOLES",1,1,2
" 10","BELLAVISTA-LA PALMERA","GUADALAJARA","EXTRANJEROS",1,0,1
" 10","BELLAVISTA-LA PALMERA","GUADALAJARA","TOTAL POBLACION",2,1,3
" 10","BELLAVISTA-LA PALMERA","HUELVA","ESPAÑOLES",22,10,32
" 10","BELLAVISTA-LA PALMERA","HUELVA","EXTRANJEROS",0,2,2
" 10","BELLAVISTA-LA PALMERA","HUELVA","TOTAL POBLACION",22,12,34
" 10","BELLAVISTA-LA PALMERA","HUESCA","EXTRANJEROS",0,1,1
" 10","BELLAVISTA-LA PALMERA","HUESCA","TOTAL POBLACION",0,1,1
" 10","BELLAVISTA-LA PALMERA","JAEN","ESPAÑOLES",3,2,5
" 10","BELLAVISTA-LA PALMERA","JAEN","TOTAL POBLACION",3,2,5
" 10","BELLAVISTA-LA PALMERA","LA CORUÑA","ESPAÑOLES",0,1,1
" 10","BELLAVISTA-LA PALMERA","LA CORUÑA","TOTAL POBLACION",0,1,1
" 10","BELLAVISTA-LA PALMERA","LA RIOJA","ESPAÑOLES",1,1,2
" 10","BELLAVISTA-LA PALMERA","LA RIOJA","EXTRANJEROS",0,1,1
" 10","BELLAVISTA-LA PALMERA","LA RIOJA","TOTAL POBLACION",1,2,3
" 10","BELLAVISTA-LA PALMERA","LAS PALMAS","ESPAÑOLES",9,6,15
" 10","BELLAVISTA-LA PALMERA","LAS PALMAS","EXTRANJEROS",1,2,3
" 10","BELLAVISTA-LA PALMERA","LAS PALMAS","TOTAL POBLACION",10,8,18
" 10","BELLAVISTA-LA PALMERA","LLEIDA","EXTRANJEROS",1,0,1
" 10","BELLAVISTA-LA PALMERA","LLEIDA","TOTAL POBLACION",1,0,1
" 10","BELLAVISTA-LA PALMERA","MADRID","ESPAÑOLES",41,22,63
" 10","BELLAVISTA-LA PALMERA","MADRID","EXTRANJEROS",0,11,11
" 10","BELLAVISTA-LA PALMERA","MADRID","TOTAL POBLACION",41,33,74
" 10","BELLAVISTA-LA PALMERA","MALAGA","ESPAÑOLES",20,31,51
" 10","BELLAVISTA-LA PALMERA","MALAGA","EXTRANJEROS",0,4,4
" 10","BELLAVISTA-LA PALMERA","MALAGA","TOTAL POBLACION",20,35,55
" 10","BELLAVISTA-LA PALMERA","MURCIA","ESPAÑOLES",8,5,13
" 10","BELLAVISTA-LA PALMERA","MURCIA","EXTRANJEROS",1,2,3
" 10","BELLAVISTA-LA PALMERA","MURCIA","TOTAL POBLACION",9,7,16
" 10","BELLAVISTA-LA PALMERA","NAVARRA","EXTRANJEROS",1,0,1
" 10","BELLAVISTA-LA PALMERA","NAVARRA","TOTAL POBLACION",1,0,1
" 10","BELLAVISTA-LA PALMERA","ORENSE","ESPAÑOLES",1,1,2
" 10","BELLAVISTA-LA PALMERA","ORENSE","TOTAL POBLACION",1,1,2
" 10","BELLAVISTA-LA PALMERA","PONTEVEDRA","ESPAÑOLES",2,5,7
" 10","BELLAVISTA-LA PALMERA","PONTEVEDRA","EXTRANJEROS",1,1,2
" 10","BELLAVISTA-LA PALMERA","PONTEVEDRA","TOTAL POBLACION",3,6,9
" 10","BELLAVISTA-LA PALMERA","SALAMANCA","ESPAÑOLES",0,1,1
" 10","BELLAVISTA-LA PALMERA","SALAMANCA","TOTAL POBLACION",0,1,1
" 10","BELLAVISTA-LA PALMERA","SANTA CRUZ DE TENERIFE","ESPAÑOLES",3,6,9
" 10","BELLAVISTA-LA PALMERA","SANTA CRUZ DE TENERIFE","EXTRANJEROS",1,0,1
" 10","BELLAVISTA-LA PALMERA","SANTA CRUZ DE TENERIFE","TOTAL POBLACION",4,6,10
" 10","BELLAVISTA-LA PALMERA","SEVILLA","ESPAÑOLES",268,270,538
" 10","BELLAVISTA-LA PALMERA","SEVILLA","EXTRANJEROS",16,17,33
" 10","BELLAVISTA-LA PALMERA","SEVILLA","TOTAL POBLACION",284,287,571
" 10","BELLAVISTA-LA PALMERA","TERUEL","ESPAÑOLES",1,0,1
" 10","BELLAVISTA-LA PALMERA","TERUEL","EXTRANJEROS",0,1,1
" 10","BELLAVISTA-LA PALMERA","TERUEL","TOTAL POBLACION",1,1,2
" 10","BELLAVISTA-LA PALMERA","TOLEDO","ESPAÑOLES",2,2,4
" 10","BELLAVISTA-LA PALMERA","TOLEDO","EXTRANJEROS",0,1,1
" 10","BELLAVISTA-LA PALMERA","TOLEDO","TOTAL POBLACION",2,3,5
" 10","BELLAVISTA-LA PALMERA","VALENCIA","ESPAÑOLES",4,2,6
" 10","BELLAVISTA-LA PALMERA","VALENCIA","TOTAL POBLACION",4,2,6
" 10","BELLAVISTA-LA PALMERA","VALLADOLID","ESPAÑOLES",0,1,1
" 10","BELLAVISTA-LA PALMERA","VALLADOLID","TOTAL POBLACION",0,1,1
" 10","BELLAVISTA-LA PALMERA","ZARAGOZA","ESPAÑOLES",1,2,3
" 10","BELLAVISTA-LA PALMERA","ZARAGOZA","EXTRANJEROS",1,0,1
" 10","BELLAVISTA-LA PALMERA","ZARAGOZA","TOTAL POBLACION",2,2,4
" 11","LOS REMEDIOS","- TODOS -","ESPAÑOLES",279,315,594
" 11","LOS REMEDIOS","- TODOS -","EXTRANJEROS",16,30,46
" 11","LOS REMEDIOS","- TODOS -","TOTAL POBLACION",295,345,640
" 11","LOS REMEDIOS","ALICANTE","ESPAÑOLES",2,3,5
" 11","LOS REMEDIOS","ALICANTE","TOTAL POBLACION",2,3,5
" 11","LOS REMEDIOS","ALMERIA","ESPAÑOLES",1,5,6
" 11","LOS REMEDIOS","ALMERIA","EXTRANJEROS",0,1,1
" 11","LOS REMEDIOS","ALMERIA","TOTAL POBLACION",1,6,7
" 11","LOS REMEDIOS","ARABA/ALAVA","EXTRANJEROS",0,1,1
" 11","LOS REMEDIOS","ARABA/ALAVA","TOTAL POBLACION",0,1,1
" 11","LOS REMEDIOS","ASTURIAS","ESPAÑOLES",1,0,1
" 11","LOS REMEDIOS","ASTURIAS","TOTAL POBLACION",1,0,1
" 11","LOS REMEDIOS","AVILA","ESPAÑOLES",1,0,1
" 11","LOS REMEDIOS","AVILA","TOTAL POBLACION",1,0,1
" 11","LOS REMEDIOS","BADAJOZ","ESPAÑOLES",3,10,13
" 11","LOS REMEDIOS","BADAJOZ","EXTRANJEROS",2,0,2
" 11","LOS REMEDIOS","BADAJOZ","TOTAL POBLACION",5,10,15
" 11","LOS REMEDIOS","BALEARES","ESPAÑOLES",2,4,6
" 11","LOS REMEDIOS","BALEARES","EXTRANJEROS",2,0,2
" 11","LOS REMEDIOS","BALEARES","TOTAL POBLACION",4,4,8
" 11","LOS REMEDIOS","BARCELONA","ESPAÑOLES",9,6,15
" 11","LOS REMEDIOS","BARCELONA","EXTRANJEROS",1,2,3
" 11","LOS REMEDIOS","BARCELONA","TOTAL POBLACION",10,8,18
" 11","LOS REMEDIOS","BIZKAIA","ESPAÑOLES",1,0,1
" 11","LOS REMEDIOS","BIZKAIA","TOTAL POBLACION",1,0,1
" 11","LOS REMEDIOS","BURGOS","ESPAÑOLES",1,3,4
" 11","LOS REMEDIOS","BURGOS","TOTAL POBLACION",1,3,4
" 11","LOS REMEDIOS","CACERES","ESPAÑOLES",0,2,2
" 11","LOS REMEDIOS","CACERES","TOTAL POBLACION",0,2,2
" 11","LOS REMEDIOS","CADIZ","ESPAÑOLES",13,15,28
" 11","LOS REMEDIOS","CADIZ","EXTRANJEROS",0,2,2
" 11","LOS REMEDIOS","CADIZ","TOTAL POBLACION",13,17,30
" 11","LOS REMEDIOS","CANTABRIA","ESPAÑOLES",1,0,1
" 11","LOS REMEDIOS","CANTABRIA","TOTAL POBLACION",1,0,1
" 11","LOS REMEDIOS","CIUDAD REAL","ESPAÑOLES",1,0,1
" 11","LOS REMEDIOS","CIUDAD REAL","TOTAL POBLACION",1,0,1
" 11","LOS REMEDIOS","CORDOBA","ESPAÑOLES",3,3,6
" 11","LOS REMEDIOS","CORDOBA","TOTAL POBLACION",3,3,6
" 11","LOS REMEDIOS","EXTRAJERO","ESPAÑOLES",33,22,55
" 11","LOS REMEDIOS","EXTRAJERO","EXTRANJEROS",2,1,3
" 11","LOS REMEDIOS","EXTRAJERO","TOTAL POBLACION",35,23,58
" 11","LOS REMEDIOS","GERONA","ESPAÑOLES",2,1,3
" 11","LOS REMEDIOS","GERONA","TOTAL POBLACION",2,1,3
" 11","LOS REMEDIOS","GRANADA","ESPAÑOLES",1,3,4
" 11","LOS REMEDIOS","GRANADA","TOTAL POBLACION",1,3,4
" 11","LOS REMEDIOS","HUELVA","ESPAÑOLES",13,8,21
" 11","LOS REMEDIOS","HUELVA","TOTAL POBLACION",13,8,21
" 11","LOS REMEDIOS","JAEN","ESPAÑOLES",2,2,4
" 11","LOS REMEDIOS","JAEN","TOTAL POBLACION",2,2,4
" 11","LOS REMEDIOS","LA CORUÑA","ESPAÑOLES",1,0,1
" 11","LOS REMEDIOS","LA CORUÑA","TOTAL POBLACION",1,0,1
" 11","LOS REMEDIOS","LA RIOJA","ESPAÑOLES",0,1,1
" 11","LOS REMEDIOS","LA RIOJA","TOTAL POBLACION",0,1,1
" 11","LOS REMEDIOS","LAS PALMAS","ESPAÑOLES",5,4,9
" 11","LOS REMEDIOS","LAS PALMAS","TOTAL POBLACION",5,4,9
" 11","LOS REMEDIOS","LEON","ESPAÑOLES",1,0,1
" 11","LOS REMEDIOS","LEON","TOTAL POBLACION",1,0,1
" 11","LOS REMEDIOS","MADRID","ESPAÑOLES",41,45,86
" 11","LOS REMEDIOS","MADRID","EXTRANJEROS",2,4,6
" 11","LOS REMEDIOS","MADRID","TOTAL POBLACION",43,49,92
" 11","LOS REMEDIOS","MALAGA","ESPAÑOLES",13,20,33
" 11","LOS REMEDIOS","MALAGA","EXTRANJEROS",1,2,3
" 11","LOS REMEDIOS","MALAGA","TOTAL POBLACION",14,22,36
" 11","LOS REMEDIOS","MELILLA","ESPAÑOLES",0,1,1
" 11","LOS REMEDIOS","MELILLA","TOTAL POBLACION",0,1,1
" 11","LOS REMEDIOS","MURCIA","ESPAÑOLES",0,1,1
" 11","LOS REMEDIOS","MURCIA","EXTRANJEROS",0,1,1
" 11","LOS REMEDIOS","MURCIA","TOTAL POBLACION",0,2,2
" 11","LOS REMEDIOS","NAVARRA","ESPAÑOLES",1,0,1
" 11","LOS REMEDIOS","NAVARRA","TOTAL POBLACION",1,0,1
" 11","LOS REMEDIOS","SALAMANCA","ESPAÑOLES",1,0,1
" 11","LOS REMEDIOS","SALAMANCA","TOTAL POBLACION",1,0,1
" 11","LOS REMEDIOS","SANTA CRUZ DE TENERIFE","ESPAÑOLES",4,2,6
" 11","LOS REMEDIOS","SANTA CRUZ DE TENERIFE","TOTAL POBLACION",4,2,6
" 11","LOS REMEDIOS","SEVILLA","ESPAÑOLES",119,152,271
" 11","LOS REMEDIOS","SEVILLA","EXTRANJEROS",6,14,20
" 11","LOS REMEDIOS","SEVILLA","TOTAL POBLACION",125,166,291
" 11","LOS REMEDIOS","TOLEDO","EXTRANJEROS",0,1,1
" 11","LOS REMEDIOS","TOLEDO","TOTAL POBLACION",0,1,1
" 11","LOS REMEDIOS","VALENCIA","ESPAÑOLES",2,0,2
" 11","LOS REMEDIOS","VALENCIA","TOTAL POBLACION",2,0,2
" 11","LOS REMEDIOS","VALLADOLID","ESPAÑOLES",0,1,1
" 11","LOS REMEDIOS","VALLADOLID","TOTAL POBLACION",0,1,1
" 11","LOS REMEDIOS","ZARAGOZA","ESPAÑOLES",1,1,2
" 11","LOS REMEDIOS","ZARAGOZA","EXTRANJEROS",0,1,1
" 11","LOS REMEDIOS","ZARAGOZA","TOTAL POBLACION",1,2,3
