"CD","ND","DESTINO","NACION","HOMBRES","MUJERES","TOTAL"
" 00","TOTAL MUNICIPIO","- TODOS -","ESPAÑOLES",7090,7217,14307
" 00","TOTAL MUNICIPIO","- TODOS -","EXTRANJEROS",997,1097,2094
" 00","TOTAL MUNICIPIO","- TODOS -","NO CONSTA",3,6,9
" 00","TOTAL MUNICIPIO","- TODOS -","TOTAL POBLACION",8090,8320,16410
" 01","CASCO ANTIGUO","- TODOS -","ESPAÑOLES",707,738,1445
" 01","CASCO ANTIGUO","- TODOS -","EXTRANJEROS",107,117,224
" 01","CASCO ANTIGUO","- TODOS -","TOTAL POBLACION",814,855,1669
" 01","CASCO ANTIGUO","ALBACETE","ESPAÑOLES",3,4,7
" 01","CASCO ANTIGUO","ALBACETE","TOTAL POBLACION",3,4,7
" 01","CASCO ANTIGUO","ALICANTE","ESPAÑOLES",2,3,5
" 01","CASCO ANTIGUO","ALICANTE","EXTRANJEROS",2,1,3
" 01","CASCO ANTIGUO","ALICANTE","TOTAL POBLACION",4,4,8
" 01","CASCO ANTIGUO","ALMERIA","ESPAÑOLES",4,7,11
" 01","CASCO ANTIGUO","ALMERIA","TOTAL POBLACION",4,7,11
" 01","CASCO ANTIGUO","ARABA/ALAVA","ESPAÑOLES",0,1,1
" 01","CASCO ANTIGUO","ARABA/ALAVA","TOTAL POBLACION",0,1,1
" 01","CASCO ANTIGUO","ASTURIAS","ESPAÑOLES",5,6,11
" 01","CASCO ANTIGUO","ASTURIAS","TOTAL POBLACION",5,6,11
" 01","CASCO ANTIGUO","AVILA","ESPAÑOLES",1,1,2
" 01","CASCO ANTIGUO","AVILA","TOTAL POBLACION",1,1,2
" 01","CASCO ANTIGUO","BADAJOZ","ESPAÑOLES",6,12,18
" 01","CASCO ANTIGUO","BADAJOZ","EXTRANJEROS",0,3,3
" 01","CASCO ANTIGUO","BADAJOZ","TOTAL POBLACION",6,15,21
" 01","CASCO ANTIGUO","BALEARES","ESPAÑOLES",18,18,36
" 01","CASCO ANTIGUO","BALEARES","EXTRANJEROS",5,3,8
" 01","CASCO ANTIGUO","BALEARES","TOTAL POBLACION",23,21,44
" 01","CASCO ANTIGUO","BARCELONA","ESPAÑOLES",20,24,44
" 01","CASCO ANTIGUO","BARCELONA","EXTRANJEROS",12,16,28
" 01","CASCO ANTIGUO","BARCELONA","TOTAL POBLACION",32,40,72
" 01","CASCO ANTIGUO","BIZKAIA","ESPAÑOLES",1,5,6
" 01","CASCO ANTIGUO","BIZKAIA","EXTRANJEROS",1,0,1
" 01","CASCO ANTIGUO","BIZKAIA","TOTAL POBLACION",2,5,7
" 01","CASCO ANTIGUO","BURGOS","ESPAÑOLES",1,1,2
" 01","CASCO ANTIGUO","BURGOS","EXTRANJEROS",0,1,1
" 01","CASCO ANTIGUO","BURGOS","TOTAL POBLACION",1,2,3
" 01","CASCO ANTIGUO","CACERES","ESPAÑOLES",0,4,4
" 01","CASCO ANTIGUO","CACERES","EXTRANJEROS",0,1,1
" 01","CASCO ANTIGUO","CACERES","TOTAL POBLACION",0,5,5
" 01","CASCO ANTIGUO","CADIZ","ESPAÑOLES",47,47,94
" 01","CASCO ANTIGUO","CADIZ","EXTRANJEROS",4,7,11
" 01","CASCO ANTIGUO","CADIZ","TOTAL POBLACION",51,54,105
" 01","CASCO ANTIGUO","CASTELLON","ESPAÑOLES",1,1,2
" 01","CASCO ANTIGUO","CASTELLON","EXTRANJEROS",1,0,1
" 01","CASCO ANTIGUO","CASTELLON","TOTAL POBLACION",2,1,3
" 01","CASCO ANTIGUO","CEUTA","ESPAÑOLES",3,4,7
" 01","CASCO ANTIGUO","CEUTA","TOTAL POBLACION",3,4,7
" 01","CASCO ANTIGUO","CIUDAD REAL","ESPAÑOLES",1,2,3
" 01","CASCO ANTIGUO","CIUDAD REAL","EXTRANJEROS",2,0,2
" 01","CASCO ANTIGUO","CIUDAD REAL","TOTAL POBLACION",3,2,5
" 01","CASCO ANTIGUO","CORDOBA","ESPAÑOLES",12,15,27
" 01","CASCO ANTIGUO","CORDOBA","EXTRANJEROS",0,1,1
" 01","CASCO ANTIGUO","CORDOBA","TOTAL POBLACION",12,16,28
" 01","CASCO ANTIGUO","EXTRAJERO","ESPAÑOLES",74,70,144
" 01","CASCO ANTIGUO","EXTRAJERO","EXTRANJEROS",8,9,17
" 01","CASCO ANTIGUO","EXTRAJERO","TOTAL POBLACION",82,79,161
" 01","CASCO ANTIGUO","GIPUZKOA","ESPAÑOLES",2,0,2
" 01","CASCO ANTIGUO","GIPUZKOA","TOTAL POBLACION",2,0,2
" 01","CASCO ANTIGUO","GRANADA","ESPAÑOLES",10,5,15
" 01","CASCO ANTIGUO","GRANADA","EXTRANJEROS",0,3,3
" 01","CASCO ANTIGUO","GRANADA","TOTAL POBLACION",10,8,18
" 01","CASCO ANTIGUO","GUADALAJARA","ESPAÑOLES",1,1,2
" 01","CASCO ANTIGUO","GUADALAJARA","TOTAL POBLACION",1,1,2
" 01","CASCO ANTIGUO","HUELVA","ESPAÑOLES",40,41,81
" 01","CASCO ANTIGUO","HUELVA","EXTRANJEROS",5,4,9
" 01","CASCO ANTIGUO","HUELVA","TOTAL POBLACION",45,45,90
" 01","CASCO ANTIGUO","HUESCA","EXTRANJEROS",2,0,2
" 01","CASCO ANTIGUO","HUESCA","TOTAL POBLACION",2,0,2
" 01","CASCO ANTIGUO","JAEN","ESPAÑOLES",3,6,9
" 01","CASCO ANTIGUO","JAEN","EXTRANJEROS",0,1,1
" 01","CASCO ANTIGUO","JAEN","TOTAL POBLACION",3,7,10
" 01","CASCO ANTIGUO","LA CORUÑA","ESPAÑOLES",6,3,9
" 01","CASCO ANTIGUO","LA CORUÑA","EXTRANJEROS",2,0,2
" 01","CASCO ANTIGUO","LA CORUÑA","TOTAL POBLACION",8,3,11
" 01","CASCO ANTIGUO","LA RIOJA","ESPAÑOLES",3,0,3
" 01","CASCO ANTIGUO","LA RIOJA","TOTAL POBLACION",3,0,3
" 01","CASCO ANTIGUO","LAS PALMAS","ESPAÑOLES",11,8,19
" 01","CASCO ANTIGUO","LAS PALMAS","TOTAL POBLACION",11,8,19
" 01","CASCO ANTIGUO","LEON","ESPAÑOLES",3,2,5
" 01","CASCO ANTIGUO","LEON","TOTAL POBLACION",3,2,5
" 01","CASCO ANTIGUO","MADRID","ESPAÑOLES",77,76,153
" 01","CASCO ANTIGUO","MADRID","EXTRANJEROS",19,20,39
" 01","CASCO ANTIGUO","MADRID","TOTAL POBLACION",96,96,192
" 01","CASCO ANTIGUO","MALAGA","ESPAÑOLES",35,26,61
" 01","CASCO ANTIGUO","MALAGA","EXTRANJEROS",11,11,22
" 01","CASCO ANTIGUO","MALAGA","TOTAL POBLACION",46,37,83
" 01","CASCO ANTIGUO","MELILLA","ESPAÑOLES",0,1,1
" 01","CASCO ANTIGUO","MELILLA","TOTAL POBLACION",0,1,1
" 01","CASCO ANTIGUO","MURCIA","ESPAÑOLES",5,4,9
" 01","CASCO ANTIGUO","MURCIA","EXTRANJEROS",1,1,2
" 01","CASCO ANTIGUO","MURCIA","TOTAL POBLACION",6,5,11
" 01","CASCO ANTIGUO","NAVARRA","ESPAÑOLES",0,3,3
" 01","CASCO ANTIGUO","NAVARRA","TOTAL POBLACION",0,3,3
" 01","CASCO ANTIGUO","PONTEVEDRA","ESPAÑOLES",1,0,1
" 01","CASCO ANTIGUO","PONTEVEDRA","EXTRANJEROS",1,0,1
" 01","CASCO ANTIGUO","PONTEVEDRA","TOTAL POBLACION",2,0,2
" 01","CASCO ANTIGUO","SALAMANCA","ESPAÑOLES",1,2,3
" 01","CASCO ANTIGUO","SALAMANCA","TOTAL POBLACION",1,2,3
" 01","CASCO ANTIGUO","SANTA CRUZ DE TENERIFE","ESPAÑOLES",11,6,17
" 01","CASCO ANTIGUO","SANTA CRUZ DE TENERIFE","EXTRANJEROS",1,4,5
" 01","CASCO ANTIGUO","SANTA CRUZ DE TENERIFE","TOTAL POBLACION",12,10,22
" 01","CASCO ANTIGUO","SEGOVIA","ESPAÑOLES",1,4,5
" 01","CASCO ANTIGUO","SEGOVIA","TOTAL POBLACION",1,4,5
" 01","CASCO ANTIGUO","SEVILLA","ESPAÑOLES",288,308,596
" 01","CASCO ANTIGUO","SEVILLA","EXTRANJEROS",28,29,57
" 01","CASCO ANTIGUO","SEVILLA","TOTAL POBLACION",316,337,653
" 01","CASCO ANTIGUO","TARRAGONA","ESPAÑOLES",1,1,2
" 01","CASCO ANTIGUO","TARRAGONA","TOTAL POBLACION",1,1,2
" 01","CASCO ANTIGUO","TOLEDO","ESPAÑOLES",2,1,3
" 01","CASCO ANTIGUO","TOLEDO","EXTRANJEROS",0,1,1
" 01","CASCO ANTIGUO","TOLEDO","TOTAL POBLACION",2,2,4
" 01","CASCO ANTIGUO","VALENCIA","ESPAÑOLES",6,8,14
" 01","CASCO ANTIGUO","VALENCIA","EXTRANJEROS",1,0,1
" 01","CASCO ANTIGUO","VALENCIA","TOTAL POBLACION",7,8,15
" 01","CASCO ANTIGUO","VALLADOLID","ESPAÑOLES",0,2,2
" 01","CASCO ANTIGUO","VALLADOLID","EXTRANJEROS",1,0,1
" 01","CASCO ANTIGUO","VALLADOLID","TOTAL POBLACION",1,2,3
" 01","CASCO ANTIGUO","ZARAGOZA","ESPAÑOLES",1,5,6
" 01","CASCO ANTIGUO","ZARAGOZA","EXTRANJEROS",0,1,1
" 01","CASCO ANTIGUO","ZARAGOZA","TOTAL POBLACION",1,6,7
" 02","MACARENA","- TODOS -","ESPAÑOLES",819,822,1641
" 02","MACARENA","- TODOS -","EXTRANJEROS",184,195,379
" 02","MACARENA","- TODOS -","NO CONSTA",0,2,2
" 02","MACARENA","- TODOS -","TOTAL POBLACION",1003,1019,2022
" 02","MACARENA","ALBACETE","ESPAÑOLES",4,2,6
" 02","MACARENA","ALBACETE","TOTAL POBLACION",4,2,6
" 02","MACARENA","ALICANTE","ESPAÑOLES",9,5,14
" 02","MACARENA","ALICANTE","EXTRANJEROS",2,3,5
" 02","MACARENA","ALICANTE","TOTAL POBLACION",11,8,19
" 02","MACARENA","ALMERIA","ESPAÑOLES",5,4,9
" 02","MACARENA","ALMERIA","EXTRANJEROS",3,4,7
" 02","MACARENA","ALMERIA","TOTAL POBLACION",8,8,16
" 02","MACARENA","ARABA/ALAVA","ESPAÑOLES",2,0,2
" 02","MACARENA","ARABA/ALAVA","EXTRANJEROS",0,1,1
" 02","MACARENA","ARABA/ALAVA","TOTAL POBLACION",2,1,3
" 02","MACARENA","ASTURIAS","ESPAÑOLES",2,2,4
" 02","MACARENA","ASTURIAS","TOTAL POBLACION",2,2,4
" 02","MACARENA","AVILA","ESPAÑOLES",1,0,1
" 02","MACARENA","AVILA","EXTRANJEROS",0,1,1
" 02","MACARENA","AVILA","TOTAL POBLACION",1,1,2
" 02","MACARENA","BADAJOZ","ESPAÑOLES",12,12,24
" 02","MACARENA","BADAJOZ","EXTRANJEROS",4,0,4
" 02","MACARENA","BADAJOZ","TOTAL POBLACION",16,12,28
" 02","MACARENA","BALEARES","ESPAÑOLES",17,29,46
" 02","MACARENA","BALEARES","EXTRANJEROS",4,3,7
" 02","MACARENA","BALEARES","TOTAL POBLACION",21,32,53
" 02","MACARENA","BARCELONA","ESPAÑOLES",23,22,45
" 02","MACARENA","BARCELONA","EXTRANJEROS",19,16,35
" 02","MACARENA","BARCELONA","TOTAL POBLACION",42,38,80
" 02","MACARENA","BIZKAIA","ESPAÑOLES",1,3,4
" 02","MACARENA","BIZKAIA","EXTRANJEROS",2,2,4
" 02","MACARENA","BIZKAIA","TOTAL POBLACION",3,5,8
" 02","MACARENA","CACERES","ESPAÑOLES",2,2,4
" 02","MACARENA","CACERES","EXTRANJEROS",1,1,2
" 02","MACARENA","CACERES","TOTAL POBLACION",3,3,6
" 02","MACARENA","CADIZ","ESPAÑOLES",34,25,59
" 02","MACARENA","CADIZ","EXTRANJEROS",6,2,8
" 02","MACARENA","CADIZ","TOTAL POBLACION",40,27,67
" 02","MACARENA","CANTABRIA","ESPAÑOLES",2,0,2
" 02","MACARENA","CANTABRIA","TOTAL POBLACION",2,0,2
" 02","MACARENA","CASTELLON","ESPAÑOLES",1,1,2
" 02","MACARENA","CASTELLON","EXTRANJEROS",0,1,1
" 02","MACARENA","CASTELLON","TOTAL POBLACION",1,2,3
" 02","MACARENA","CEUTA","ESPAÑOLES",2,3,5
" 02","MACARENA","CEUTA","TOTAL POBLACION",2,3,5
" 02","MACARENA","CIUDAD REAL","ESPAÑOLES",2,0,2
" 02","MACARENA","CIUDAD REAL","TOTAL POBLACION",2,0,2
" 02","MACARENA","CORDOBA","ESPAÑOLES",16,11,27
" 02","MACARENA","CORDOBA","EXTRANJEROS",1,2,3
" 02","MACARENA","CORDOBA","TOTAL POBLACION",17,13,30
" 02","MACARENA","EXTRAJERO","ESPAÑOLES",90,97,187
" 02","MACARENA","EXTRAJERO","EXTRANJEROS",7,11,18
" 02","MACARENA","EXTRAJERO","TOTAL POBLACION",97,108,205
" 02","MACARENA","GERONA","ESPAÑOLES",5,5,10
" 02","MACARENA","GERONA","EXTRANJEROS",4,2,6
" 02","MACARENA","GERONA","TOTAL POBLACION",9,7,16
" 02","MACARENA","GIPUZKOA","ESPAÑOLES",1,4,5
" 02","MACARENA","GIPUZKOA","EXTRANJEROS",1,1,2
" 02","MACARENA","GIPUZKOA","TOTAL POBLACION",2,5,7
" 02","MACARENA","GRANADA","ESPAÑOLES",8,2,10
" 02","MACARENA","GRANADA","EXTRANJEROS",6,4,10
" 02","MACARENA","GRANADA","TOTAL POBLACION",14,6,20
" 02","MACARENA","GUADALAJARA","ESPAÑOLES",0,1,1
" 02","MACARENA","GUADALAJARA","TOTAL POBLACION",0,1,1
" 02","MACARENA","HUELVA","ESPAÑOLES",38,39,77
" 02","MACARENA","HUELVA","EXTRANJEROS",9,9,18
" 02","MACARENA","HUELVA","TOTAL POBLACION",47,48,95
" 02","MACARENA","JAEN","ESPAÑOLES",6,7,13
" 02","MACARENA","JAEN","EXTRANJEROS",2,2,4
" 02","MACARENA","JAEN","TOTAL POBLACION",8,9,17
" 02","MACARENA","LA CORUÑA","ESPAÑOLES",1,2,3
" 02","MACARENA","LA CORUÑA","EXTRANJEROS",1,1,2
" 02","MACARENA","LA CORUÑA","TOTAL POBLACION",2,3,5
" 02","MACARENA","LA RIOJA","ESPAÑOLES",2,5,7
" 02","MACARENA","LA RIOJA","TOTAL POBLACION",2,5,7
" 02","MACARENA","LAS PALMAS","ESPAÑOLES",16,13,29
" 02","MACARENA","LAS PALMAS","EXTRANJEROS",4,4,8
" 02","MACARENA","LAS PALMAS","TOTAL POBLACION",20,17,37
" 02","MACARENA","LEON","ESPAÑOLES",1,2,3
" 02","MACARENA","LEON","TOTAL POBLACION",1,2,3
" 02","MACARENA","LLEIDA","ESPAÑOLES",1,2,3
" 02","MACARENA","LLEIDA","EXTRANJEROS",1,1,2
" 02","MACARENA","LLEIDA","TOTAL POBLACION",2,3,5
" 02","MACARENA","MADRID","ESPAÑOLES",47,46,93
" 02","MACARENA","MADRID","EXTRANJEROS",17,23,40
" 02","MACARENA","MADRID","TOTAL POBLACION",64,69,133
" 02","MACARENA","MALAGA","ESPAÑOLES",20,17,37
" 02","MACARENA","MALAGA","EXTRANJEROS",11,10,21
" 02","MACARENA","MALAGA","TOTAL POBLACION",31,27,58
" 02","MACARENA","MELILLA","ESPAÑOLES",4,2,6
" 02","MACARENA","MELILLA","TOTAL POBLACION",4,2,6
" 02","MACARENA","MURCIA","ESPAÑOLES",11,10,21
" 02","MACARENA","MURCIA","EXTRANJEROS",6,3,9
" 02","MACARENA","MURCIA","TOTAL POBLACION",17,13,30
" 02","MACARENA","NAVARRA","ESPAÑOLES",4,5,9
" 02","MACARENA","NAVARRA","EXTRANJEROS",3,1,4
" 02","MACARENA","NAVARRA","TOTAL POBLACION",7,6,13
" 02","MACARENA","ORENSE","EXTRANJEROS",0,1,1
" 02","MACARENA","ORENSE","TOTAL POBLACION",0,1,1
" 02","MACARENA","PALENCIA","ESPAÑOLES",0,1,1
" 02","MACARENA","PALENCIA","EXTRANJEROS",2,1,3
" 02","MACARENA","PALENCIA","TOTAL POBLACION",2,2,4
" 02","MACARENA","PONTEVEDRA","ESPAÑOLES",1,1,2
" 02","MACARENA","PONTEVEDRA","TOTAL POBLACION",1,1,2
" 02","MACARENA","SALAMANCA","ESPAÑOLES",2,0,2
" 02","MACARENA","SALAMANCA","TOTAL POBLACION",2,0,2
" 02","MACARENA","SANTA CRUZ DE TENERIFE","ESPAÑOLES",12,7,19
" 02","MACARENA","SANTA CRUZ DE TENERIFE","EXTRANJEROS",2,1,3
" 02","MACARENA","SANTA CRUZ DE TENERIFE","TOTAL POBLACION",14,8,22
" 02","MACARENA","SEVILLA","ESPAÑOLES",392,418,810
" 02","MACARENA","SEVILLA","EXTRANJEROS",53,70,123
" 02","MACARENA","SEVILLA","NO CONSTA",0,2,2
" 02","MACARENA","SEVILLA","TOTAL POBLACION",445,490,935
" 02","MACARENA","TARRAGONA","ESPAÑOLES",1,3,4
" 02","MACARENA","TARRAGONA","EXTRANJEROS",1,0,1
" 02","MACARENA","TARRAGONA","TOTAL POBLACION",2,3,5
" 02","MACARENA","TERUEL","ESPAÑOLES",1,0,1
" 02","MACARENA","TERUEL","TOTAL POBLACION",1,0,1
" 02","MACARENA","TOLEDO","ESPAÑOLES",3,4,7
" 02","MACARENA","TOLEDO","EXTRANJEROS",2,4,6
" 02","MACARENA","TOLEDO","TOTAL POBLACION",5,8,13
" 02","MACARENA","VALENCIA","ESPAÑOLES",12,5,17
" 02","MACARENA","VALENCIA","EXTRANJEROS",8,9,17
" 02","MACARENA","VALENCIA","TOTAL POBLACION",20,14,34
" 02","MACARENA","VALLADOLID","ESPAÑOLES",3,0,3
" 02","MACARENA","VALLADOLID","TOTAL POBLACION",3,0,3
" 02","MACARENA","ZARAGOZA","ESPAÑOLES",2,3,5
" 02","MACARENA","ZARAGOZA","EXTRANJEROS",2,1,3
" 02","MACARENA","ZARAGOZA","TOTAL POBLACION",4,4,8
" 03","NERVION","- TODOS -","ESPAÑOLES",515,527,1042
" 03","NERVION","- TODOS -","EXTRANJEROS",45,61,106
" 03","NERVION","- TODOS -","TOTAL POBLACION",560,588,1148
" 03","NERVION","ALBACETE","ESPAÑOLES",1,0,1
" 03","NERVION","ALBACETE","TOTAL POBLACION",1,0,1
" 03","NERVION","ALICANTE","ESPAÑOLES",1,3,4
" 03","NERVION","ALICANTE","EXTRANJEROS",1,1,2
" 03","NERVION","ALICANTE","TOTAL POBLACION",2,4,6
" 03","NERVION","ALMERIA","ESPAÑOLES",5,3,8
" 03","NERVION","ALMERIA","TOTAL POBLACION",5,3,8
" 03","NERVION","ARABA/ALAVA","ESPAÑOLES",2,0,2
" 03","NERVION","ARABA/ALAVA","EXTRANJEROS",1,0,1
" 03","NERVION","ARABA/ALAVA","TOTAL POBLACION",3,0,3
" 03","NERVION","ASTURIAS","ESPAÑOLES",0,3,3
" 03","NERVION","ASTURIAS","TOTAL POBLACION",0,3,3
" 03","NERVION","BADAJOZ","ESPAÑOLES",4,6,10
" 03","NERVION","BADAJOZ","EXTRANJEROS",1,0,1
" 03","NERVION","BADAJOZ","TOTAL POBLACION",5,6,11
" 03","NERVION","BALEARES","ESPAÑOLES",8,9,17
" 03","NERVION","BALEARES","EXTRANJEROS",2,0,2
" 03","NERVION","BALEARES","TOTAL POBLACION",10,9,19
" 03","NERVION","BARCELONA","ESPAÑOLES",11,19,30
" 03","NERVION","BARCELONA","EXTRANJEROS",1,2,3
" 03","NERVION","BARCELONA","TOTAL POBLACION",12,21,33
" 03","NERVION","BIZKAIA","ESPAÑOLES",1,0,1
" 03","NERVION","BIZKAIA","TOTAL POBLACION",1,0,1
" 03","NERVION","BURGOS","ESPAÑOLES",3,3,6
" 03","NERVION","BURGOS","EXTRANJEROS",0,1,1
" 03","NERVION","BURGOS","TOTAL POBLACION",3,4,7
" 03","NERVION","CACERES","ESPAÑOLES",2,4,6
" 03","NERVION","CACERES","TOTAL POBLACION",2,4,6
" 03","NERVION","CADIZ","ESPAÑOLES",22,31,53
" 03","NERVION","CADIZ","EXTRANJEROS",1,2,3
" 03","NERVION","CADIZ","TOTAL POBLACION",23,33,56
" 03","NERVION","CANTABRIA","ESPAÑOLES",0,3,3
" 03","NERVION","CANTABRIA","EXTRANJEROS",1,0,1
" 03","NERVION","CANTABRIA","TOTAL POBLACION",1,3,4
" 03","NERVION","CASTELLON","ESPAÑOLES",0,2,2
" 03","NERVION","CASTELLON","TOTAL POBLACION",0,2,2
" 03","NERVION","CEUTA","ESPAÑOLES",1,0,1
" 03","NERVION","CEUTA","TOTAL POBLACION",1,0,1
" 03","NERVION","CIUDAD REAL","ESPAÑOLES",4,2,6
" 03","NERVION","CIUDAD REAL","EXTRANJEROS",0,1,1
" 03","NERVION","CIUDAD REAL","TOTAL POBLACION",4,3,7
" 03","NERVION","CORDOBA","ESPAÑOLES",4,6,10
" 03","NERVION","CORDOBA","TOTAL POBLACION",4,6,10
" 03","NERVION","EXTRAJERO","ESPAÑOLES",66,64,130
" 03","NERVION","EXTRAJERO","EXTRANJEROS",5,5,10
" 03","NERVION","EXTRAJERO","TOTAL POBLACION",71,69,140
" 03","NERVION","GERONA","ESPAÑOLES",0,1,1
" 03","NERVION","GERONA","TOTAL POBLACION",0,1,1
" 03","NERVION","GIPUZKOA","ESPAÑOLES",0,1,1
" 03","NERVION","GIPUZKOA","EXTRANJEROS",0,1,1
" 03","NERVION","GIPUZKOA","TOTAL POBLACION",0,2,2
" 03","NERVION","GRANADA","ESPAÑOLES",10,9,19
" 03","NERVION","GRANADA","TOTAL POBLACION",10,9,19
" 03","NERVION","GUADALAJARA","ESPAÑOLES",1,0,1
" 03","NERVION","GUADALAJARA","TOTAL POBLACION",1,0,1
" 03","NERVION","HUELVA","ESPAÑOLES",27,14,41
" 03","NERVION","HUELVA","EXTRANJEROS",1,3,4
" 03","NERVION","HUELVA","TOTAL POBLACION",28,17,45
" 03","NERVION","JAEN","ESPAÑOLES",7,5,12
" 03","NERVION","JAEN","TOTAL POBLACION",7,5,12
" 03","NERVION","LA CORUÑA","ESPAÑOLES",1,1,2
" 03","NERVION","LA CORUÑA","EXTRANJEROS",0,1,1
" 03","NERVION","LA CORUÑA","TOTAL POBLACION",1,2,3
" 03","NERVION","LA RIOJA","ESPAÑOLES",1,3,4
" 03","NERVION","LA RIOJA","EXTRANJEROS",0,1,1
" 03","NERVION","LA RIOJA","TOTAL POBLACION",1,4,5
" 03","NERVION","LAS PALMAS","ESPAÑOLES",15,6,21
" 03","NERVION","LAS PALMAS","EXTRANJEROS",1,1,2
" 03","NERVION","LAS PALMAS","TOTAL POBLACION",16,7,23
" 03","NERVION","LEON","ESPAÑOLES",4,1,5
" 03","NERVION","LEON","TOTAL POBLACION",4,1,5
" 03","NERVION","LLEIDA","ESPAÑOLES",2,0,2
" 03","NERVION","LLEIDA","EXTRANJEROS",0,1,1
" 03","NERVION","LLEIDA","TOTAL POBLACION",2,1,3
" 03","NERVION","LUGO","ESPAÑOLES",0,1,1
" 03","NERVION","LUGO","TOTAL POBLACION",0,1,1
" 03","NERVION","MADRID","ESPAÑOLES",67,69,136
" 03","NERVION","MADRID","EXTRANJEROS",8,16,24
" 03","NERVION","MADRID","TOTAL POBLACION",75,85,160
" 03","NERVION","MALAGA","ESPAÑOLES",21,24,45
" 03","NERVION","MALAGA","EXTRANJEROS",0,4,4
" 03","NERVION","MALAGA","TOTAL POBLACION",21,28,49
" 03","NERVION","MELILLA","EXTRANJEROS",0,1,1
" 03","NERVION","MELILLA","TOTAL POBLACION",0,1,1
" 03","NERVION","MURCIA","ESPAÑOLES",1,1,2
" 03","NERVION","MURCIA","TOTAL POBLACION",1,1,2
" 03","NERVION","NAVARRA","ESPAÑOLES",0,2,2
" 03","NERVION","NAVARRA","TOTAL POBLACION",0,2,2
" 03","NERVION","ORENSE","ESPAÑOLES",1,0,1
" 03","NERVION","ORENSE","TOTAL POBLACION",1,0,1
" 03","NERVION","PONTEVEDRA","ESPAÑOLES",0,1,1
" 03","NERVION","PONTEVEDRA","TOTAL POBLACION",0,1,1
" 03","NERVION","SALAMANCA","ESPAÑOLES",2,1,3
" 03","NERVION","SALAMANCA","EXTRANJEROS",2,2,4
" 03","NERVION","SALAMANCA","TOTAL POBLACION",4,3,7
" 03","NERVION","SANTA CRUZ DE TENERIFE","ESPAÑOLES",6,6,12
" 03","NERVION","SANTA CRUZ DE TENERIFE","EXTRANJEROS",1,0,1
" 03","NERVION","SANTA CRUZ DE TENERIFE","TOTAL POBLACION",7,6,13
" 03","NERVION","SEVILLA","ESPAÑOLES",209,209,418
" 03","NERVION","SEVILLA","EXTRANJEROS",14,14,28
" 03","NERVION","SEVILLA","TOTAL POBLACION",223,223,446
" 03","NERVION","TARRAGONA","ESPAÑOLES",0,1,1
" 03","NERVION","TARRAGONA","EXTRANJEROS",1,0,1
" 03","NERVION","TARRAGONA","TOTAL POBLACION",1,1,2
" 03","NERVION","TERUEL","ESPAÑOLES",0,1,1
" 03","NERVION","TERUEL","EXTRANJEROS",1,1,2
" 03","NERVION","TERUEL","TOTAL POBLACION",1,2,3
" 03","NERVION","TOLEDO","ESPAÑOLES",3,4,7
" 03","NERVION","TOLEDO","EXTRANJEROS",0,3,3
" 03","NERVION","TOLEDO","TOTAL POBLACION",3,7,10
" 03","NERVION","VALENCIA","ESPAÑOLES",1,4,5
" 03","NERVION","VALENCIA","EXTRANJEROS",2,0,2
" 03","NERVION","VALENCIA","TOTAL POBLACION",3,4,7
" 03","NERVION","VALLADOLID","ESPAÑOLES",0,1,1
" 03","NERVION","VALLADOLID","EXTRANJEROS",1,0,1
" 03","NERVION","VALLADOLID","TOTAL POBLACION",1,1,2
" 03","NERVION","ZARAGOZA","ESPAÑOLES",1,3,4
" 03","NERVION","ZARAGOZA","TOTAL POBLACION",1,3,4
" 04","CERRO-AMATE","- TODOS -","ESPAÑOLES",833,841,1674
" 04","CERRO-AMATE","- TODOS -","EXTRANJEROS",200,190,390
" 04","CERRO-AMATE","- TODOS -","NO CONSTA",1,1,2
" 04","CERRO-AMATE","- TODOS -","TOTAL POBLACION",1034,1032,2066
" 04","CERRO-AMATE","ALBACETE","ESPAÑOLES",4,4,8
" 04","CERRO-AMATE","ALBACETE","EXTRANJEROS",0,3,3
" 04","CERRO-AMATE","ALBACETE","TOTAL POBLACION",4,7,11
" 04","CERRO-AMATE","ALICANTE","ESPAÑOLES",6,3,9
" 04","CERRO-AMATE","ALICANTE","EXTRANJEROS",9,6,15
" 04","CERRO-AMATE","ALICANTE","TOTAL POBLACION",15,9,24
" 04","CERRO-AMATE","ALMERIA","ESPAÑOLES",4,5,9
" 04","CERRO-AMATE","ALMERIA","EXTRANJEROS",4,6,10
" 04","CERRO-AMATE","ALMERIA","TOTAL POBLACION",8,11,19
" 04","CERRO-AMATE","ARABA/ALAVA","ESPAÑOLES",3,0,3
" 04","CERRO-AMATE","ARABA/ALAVA","EXTRANJEROS",3,3,6
" 04","CERRO-AMATE","ARABA/ALAVA","TOTAL POBLACION",6,3,9
" 04","CERRO-AMATE","ASTURIAS","ESPAÑOLES",4,2,6
" 04","CERRO-AMATE","ASTURIAS","EXTRANJEROS",1,0,1
" 04","CERRO-AMATE","ASTURIAS","TOTAL POBLACION",5,2,7
" 04","CERRO-AMATE","AVILA","ESPAÑOLES",3,1,4
" 04","CERRO-AMATE","AVILA","TOTAL POBLACION",3,1,4
" 04","CERRO-AMATE","BADAJOZ","ESPAÑOLES",8,7,15
" 04","CERRO-AMATE","BADAJOZ","EXTRANJEROS",3,2,5
" 04","CERRO-AMATE","BADAJOZ","TOTAL POBLACION",11,9,20
" 04","CERRO-AMATE","BALEARES","ESPAÑOLES",18,12,30
" 04","CERRO-AMATE","BALEARES","EXTRANJEROS",5,3,8
" 04","CERRO-AMATE","BALEARES","TOTAL POBLACION",23,15,38
" 04","CERRO-AMATE","BARCELONA","ESPAÑOLES",18,21,39
" 04","CERRO-AMATE","BARCELONA","EXTRANJEROS",13,7,20
" 04","CERRO-AMATE","BARCELONA","TOTAL POBLACION",31,28,59
" 04","CERRO-AMATE","BIZKAIA","ESPAÑOLES",3,4,7
" 04","CERRO-AMATE","BIZKAIA","EXTRANJEROS",2,3,5
" 04","CERRO-AMATE","BIZKAIA","TOTAL POBLACION",5,7,12
" 04","CERRO-AMATE","CACERES","ESPAÑOLES",1,1,2
" 04","CERRO-AMATE","CACERES","EXTRANJEROS",1,1,2
" 04","CERRO-AMATE","CACERES","TOTAL POBLACION",2,2,4
" 04","CERRO-AMATE","CADIZ","ESPAÑOLES",55,51,106
" 04","CERRO-AMATE","CADIZ","EXTRANJEROS",11,6,17
" 04","CERRO-AMATE","CADIZ","TOTAL POBLACION",66,57,123
" 04","CERRO-AMATE","CANTABRIA","ESPAÑOLES",1,2,3
" 04","CERRO-AMATE","CANTABRIA","EXTRANJEROS",0,1,1
" 04","CERRO-AMATE","CANTABRIA","TOTAL POBLACION",1,3,4
" 04","CERRO-AMATE","CASTELLON","ESPAÑOLES",1,1,2
" 04","CERRO-AMATE","CASTELLON","EXTRANJEROS",3,1,4
" 04","CERRO-AMATE","CASTELLON","TOTAL POBLACION",4,2,6
" 04","CERRO-AMATE","CEUTA","ESPAÑOLES",5,1,6
" 04","CERRO-AMATE","CEUTA","TOTAL POBLACION",5,1,6
" 04","CERRO-AMATE","CIUDAD REAL","ESPAÑOLES",0,1,1
" 04","CERRO-AMATE","CIUDAD REAL","TOTAL POBLACION",0,1,1
" 04","CERRO-AMATE","CORDOBA","ESPAÑOLES",9,5,14
" 04","CERRO-AMATE","CORDOBA","EXTRANJEROS",0,3,3
" 04","CERRO-AMATE","CORDOBA","TOTAL POBLACION",9,8,17
" 04","CERRO-AMATE","CUENCA","ESPAÑOLES",1,0,1
" 04","CERRO-AMATE","CUENCA","TOTAL POBLACION",1,0,1
" 04","CERRO-AMATE","EXTRAJERO","ESPAÑOLES",44,60,104
" 04","CERRO-AMATE","EXTRAJERO","EXTRANJEROS",11,9,20
" 04","CERRO-AMATE","EXTRAJERO","NO CONSTA",1,0,1
" 04","CERRO-AMATE","EXTRAJERO","TOTAL POBLACION",56,69,125
" 04","CERRO-AMATE","GERONA","ESPAÑOLES",4,1,5
" 04","CERRO-AMATE","GERONA","TOTAL POBLACION",4,1,5
" 04","CERRO-AMATE","GIPUZKOA","ESPAÑOLES",2,1,3
" 04","CERRO-AMATE","GIPUZKOA","EXTRANJEROS",3,6,9
" 04","CERRO-AMATE","GIPUZKOA","TOTAL POBLACION",5,7,12
" 04","CERRO-AMATE","GRANADA","ESPAÑOLES",6,10,16
" 04","CERRO-AMATE","GRANADA","EXTRANJEROS",4,5,9
" 04","CERRO-AMATE","GRANADA","TOTAL POBLACION",10,15,25
" 04","CERRO-AMATE","GUADALAJARA","ESPAÑOLES",4,2,6
" 04","CERRO-AMATE","GUADALAJARA","EXTRANJEROS",1,0,1
" 04","CERRO-AMATE","GUADALAJARA","TOTAL POBLACION",5,2,7
" 04","CERRO-AMATE","HUELVA","ESPAÑOLES",19,26,45
" 04","CERRO-AMATE","HUELVA","EXTRANJEROS",13,14,27
" 04","CERRO-AMATE","HUELVA","TOTAL POBLACION",32,40,72
" 04","CERRO-AMATE","HUESCA","ESPAÑOLES",0,2,2
" 04","CERRO-AMATE","HUESCA","TOTAL POBLACION",0,2,2
" 04","CERRO-AMATE","JAEN","ESPAÑOLES",6,8,14
" 04","CERRO-AMATE","JAEN","EXTRANJEROS",2,7,9
" 04","CERRO-AMATE","JAEN","TOTAL POBLACION",8,15,23
" 04","CERRO-AMATE","LA CORUÑA","ESPAÑOLES",2,1,3
" 04","CERRO-AMATE","LA CORUÑA","TOTAL POBLACION",2,1,3
" 04","CERRO-AMATE","LA RIOJA","ESPAÑOLES",2,4,6
" 04","CERRO-AMATE","LA RIOJA","EXTRANJEROS",1,0,1
" 04","CERRO-AMATE","LA RIOJA","TOTAL POBLACION",3,4,7
" 04","CERRO-AMATE","LAS PALMAS","ESPAÑOLES",11,17,28
" 04","CERRO-AMATE","LAS PALMAS","EXTRANJEROS",3,2,5
" 04","CERRO-AMATE","LAS PALMAS","TOTAL POBLACION",14,19,33
" 04","CERRO-AMATE","LEON","ESPAÑOLES",2,0,2
" 04","CERRO-AMATE","LEON","EXTRANJEROS",1,0,1
" 04","CERRO-AMATE","LEON","TOTAL POBLACION",3,0,3
" 04","CERRO-AMATE","LLEIDA","ESPAÑOLES",0,1,1
" 04","CERRO-AMATE","LLEIDA","EXTRANJEROS",1,0,1
" 04","CERRO-AMATE","LLEIDA","TOTAL POBLACION",1,1,2
" 04","CERRO-AMATE","LUGO","ESPAÑOLES",1,1,2
" 04","CERRO-AMATE","LUGO","TOTAL POBLACION",1,1,2
" 04","CERRO-AMATE","MADRID","ESPAÑOLES",41,38,79
" 04","CERRO-AMATE","MADRID","EXTRANJEROS",21,14,35
" 04","CERRO-AMATE","MADRID","TOTAL POBLACION",62,52,114
" 04","CERRO-AMATE","MALAGA","ESPAÑOLES",19,21,40
" 04","CERRO-AMATE","MALAGA","EXTRANJEROS",11,12,23
" 04","CERRO-AMATE","MALAGA","TOTAL POBLACION",30,33,63
" 04","CERRO-AMATE","MELILLA","ESPAÑOLES",2,1,3
" 04","CERRO-AMATE","MELILLA","TOTAL POBLACION",2,1,3
" 04","CERRO-AMATE","MURCIA","ESPAÑOLES",4,5,9
" 04","CERRO-AMATE","MURCIA","EXTRANJEROS",7,2,9
" 04","CERRO-AMATE","MURCIA","TOTAL POBLACION",11,7,18
" 04","CERRO-AMATE","NAVARRA","ESPAÑOLES",1,0,1
" 04","CERRO-AMATE","NAVARRA","EXTRANJEROS",1,1,2
" 04","CERRO-AMATE","NAVARRA","TOTAL POBLACION",2,1,3
" 04","CERRO-AMATE","ORENSE","ESPAÑOLES",0,2,2
" 04","CERRO-AMATE","ORENSE","EXTRANJEROS",1,0,1
" 04","CERRO-AMATE","ORENSE","TOTAL POBLACION",1,2,3
" 04","CERRO-AMATE","PONTEVEDRA","ESPAÑOLES",2,0,2
" 04","CERRO-AMATE","PONTEVEDRA","EXTRANJEROS",0,3,3
" 04","CERRO-AMATE","PONTEVEDRA","TOTAL POBLACION",2,3,5
" 04","CERRO-AMATE","SANTA CRUZ DE TENERIFE","ESPAÑOLES",12,10,22
" 04","CERRO-AMATE","SANTA CRUZ DE TENERIFE","EXTRANJEROS",5,3,8
" 04","CERRO-AMATE","SANTA CRUZ DE TENERIFE","TOTAL POBLACION",17,13,30
" 04","CERRO-AMATE","SEGOVIA","ESPAÑOLES",1,1,2
" 04","CERRO-AMATE","SEGOVIA","TOTAL POBLACION",1,1,2
" 04","CERRO-AMATE","SEVILLA","ESPAÑOLES",485,482,967
" 04","CERRO-AMATE","SEVILLA","EXTRANJEROS",48,58,106
" 04","CERRO-AMATE","SEVILLA","NO CONSTA",0,1,1
" 04","CERRO-AMATE","SEVILLA","TOTAL POBLACION",533,541,1074
" 04","CERRO-AMATE","SORIA","ESPAÑOLES",1,1,2
" 04","CERRO-AMATE","SORIA","TOTAL POBLACION",1,1,2
" 04","CERRO-AMATE","TARRAGONA","ESPAÑOLES",2,2,4
" 04","CERRO-AMATE","TARRAGONA","EXTRANJEROS",1,0,1
" 04","CERRO-AMATE","TARRAGONA","TOTAL POBLACION",3,2,5
" 04","CERRO-AMATE","TOLEDO","ESPAÑOLES",6,9,15
" 04","CERRO-AMATE","TOLEDO","EXTRANJEROS",1,1,2
" 04","CERRO-AMATE","TOLEDO","TOTAL POBLACION",7,10,17
" 04","CERRO-AMATE","VALENCIA","ESPAÑOLES",7,10,17
" 04","CERRO-AMATE","VALENCIA","EXTRANJEROS",5,6,11
" 04","CERRO-AMATE","VALENCIA","TOTAL POBLACION",12,16,28
" 04","CERRO-AMATE","VALLADOLID","ESPAÑOLES",0,2,2
" 04","CERRO-AMATE","VALLADOLID","EXTRANJEROS",2,2,4
" 04","CERRO-AMATE","VALLADOLID","TOTAL POBLACION",2,4,6
" 04","CERRO-AMATE","ZAMORA","ESPAÑOLES",1,1,2
" 04","CERRO-AMATE","ZAMORA","EXTRANJEROS",1,0,1
" 04","CERRO-AMATE","ZAMORA","TOTAL POBLACION",2,1,3
" 04","CERRO-AMATE","ZARAGOZA","ESPAÑOLES",2,1,3
" 04","CERRO-AMATE","ZARAGOZA","EXTRANJEROS",1,0,1
" 04","CERRO-AMATE","ZARAGOZA","TOTAL POBLACION",3,1,4
" 05","SUR","- TODOS -","ESPAÑOLES",807,786,1593
" 05","SUR","- TODOS -","EXTRANJEROS",87,111,198
" 05","SUR","- TODOS -","TOTAL POBLACION",894,897,1791
" 05","SUR","ALBACETE","ESPAÑOLES",2,1,3
" 05","SUR","ALBACETE","EXTRANJEROS",1,0,1
" 05","SUR","ALBACETE","TOTAL POBLACION",3,1,4
" 05","SUR","ALICANTE","ESPAÑOLES",10,13,23
" 05","SUR","ALICANTE","EXTRANJEROS",1,1,2
" 05","SUR","ALICANTE","TOTAL POBLACION",11,14,25
" 05","SUR","ALMERIA","ESPAÑOLES",4,13,17
" 05","SUR","ALMERIA","EXTRANJEROS",3,2,5
" 05","SUR","ALMERIA","TOTAL POBLACION",7,15,22
" 05","SUR","ARABA/ALAVA","ESPAÑOLES",1,0,1
" 05","SUR","ARABA/ALAVA","TOTAL POBLACION",1,0,1
" 05","SUR","ASTURIAS","ESPAÑOLES",6,8,14
" 05","SUR","ASTURIAS","TOTAL POBLACION",6,8,14
" 05","SUR","AVILA","ESPAÑOLES",0,1,1
" 05","SUR","AVILA","TOTAL POBLACION",0,1,1
" 05","SUR","BADAJOZ","ESPAÑOLES",21,17,38
" 05","SUR","BADAJOZ","EXTRANJEROS",1,2,3
" 05","SUR","BADAJOZ","TOTAL POBLACION",22,19,41
" 05","SUR","BALEARES","ESPAÑOLES",11,14,25
" 05","SUR","BALEARES","EXTRANJEROS",2,1,3
" 05","SUR","BALEARES","TOTAL POBLACION",13,15,28
" 05","SUR","BARCELONA","ESPAÑOLES",22,15,37
" 05","SUR","BARCELONA","EXTRANJEROS",5,11,16
" 05","SUR","BARCELONA","TOTAL POBLACION",27,26,53
" 05","SUR","BIZKAIA","ESPAÑOLES",1,0,1
" 05","SUR","BIZKAIA","EXTRANJEROS",0,1,1
" 05","SUR","BIZKAIA","TOTAL POBLACION",1,1,2
" 05","SUR","BURGOS","ESPAÑOLES",2,4,6
" 05","SUR","BURGOS","EXTRANJEROS",1,0,1
" 05","SUR","BURGOS","TOTAL POBLACION",3,4,7
" 05","SUR","CACERES","ESPAÑOLES",4,1,5
" 05","SUR","CACERES","EXTRANJEROS",2,1,3
" 05","SUR","CACERES","TOTAL POBLACION",6,2,8
" 05","SUR","CADIZ","ESPAÑOLES",56,53,109
" 05","SUR","CADIZ","EXTRANJEROS",7,2,9
" 05","SUR","CADIZ","TOTAL POBLACION",63,55,118
" 05","SUR","CANTABRIA","ESPAÑOLES",0,2,2
" 05","SUR","CANTABRIA","EXTRANJEROS",0,1,1
" 05","SUR","CANTABRIA","TOTAL POBLACION",0,3,3
" 05","SUR","CASTELLON","ESPAÑOLES",1,0,1
" 05","SUR","CASTELLON","TOTAL POBLACION",1,0,1
" 05","SUR","CEUTA","ESPAÑOLES",2,3,5
" 05","SUR","CEUTA","TOTAL POBLACION",2,3,5
" 05","SUR","CIUDAD REAL","ESPAÑOLES",2,4,6
" 05","SUR","CIUDAD REAL","EXTRANJEROS",3,1,4
" 05","SUR","CIUDAD REAL","TOTAL POBLACION",5,5,10
" 05","SUR","CORDOBA","ESPAÑOLES",14,16,30
" 05","SUR","CORDOBA","EXTRANJEROS",2,0,2
" 05","SUR","CORDOBA","TOTAL POBLACION",16,16,32
" 05","SUR","CUENCA","ESPAÑOLES",0,1,1
" 05","SUR","CUENCA","TOTAL POBLACION",0,1,1
" 05","SUR","EXTRAJERO","ESPAÑOLES",68,47,115
" 05","SUR","EXTRAJERO","EXTRANJEROS",5,9,14
" 05","SUR","EXTRAJERO","TOTAL POBLACION",73,56,129
" 05","SUR","GERONA","ESPAÑOLES",1,0,1
" 05","SUR","GERONA","EXTRANJEROS",1,0,1
" 05","SUR","GERONA","TOTAL POBLACION",2,0,2
" 05","SUR","GIPUZKOA","ESPAÑOLES",1,0,1
" 05","SUR","GIPUZKOA","EXTRANJEROS",1,3,4
" 05","SUR","GIPUZKOA","TOTAL POBLACION",2,3,5
" 05","SUR","GRANADA","ESPAÑOLES",13,13,26
" 05","SUR","GRANADA","EXTRANJEROS",2,0,2
" 05","SUR","GRANADA","TOTAL POBLACION",15,13,28
" 05","SUR","GUADALAJARA","ESPAÑOLES",1,1,2
" 05","SUR","GUADALAJARA","TOTAL POBLACION",1,1,2
" 05","SUR","HUELVA","ESPAÑOLES",19,25,44
" 05","SUR","HUELVA","EXTRANJEROS",1,3,4
" 05","SUR","HUELVA","TOTAL POBLACION",20,28,48
" 05","SUR","HUESCA","ESPAÑOLES",3,1,4
" 05","SUR","HUESCA","TOTAL POBLACION",3,1,4
" 05","SUR","JAEN","ESPAÑOLES",3,3,6
" 05","SUR","JAEN","EXTRANJEROS",0,2,2
" 05","SUR","JAEN","TOTAL POBLACION",3,5,8
" 05","SUR","LA CORUÑA","ESPAÑOLES",5,2,7
" 05","SUR","LA CORUÑA","EXTRANJEROS",1,0,1
" 05","SUR","LA CORUÑA","TOTAL POBLACION",6,2,8
" 05","SUR","LA RIOJA","ESPAÑOLES",2,1,3
" 05","SUR","LA RIOJA","EXTRANJEROS",0,1,1
" 05","SUR","LA RIOJA","TOTAL POBLACION",2,2,4
" 05","SUR","LAS PALMAS","ESPAÑOLES",15,16,31
" 05","SUR","LAS PALMAS","EXTRANJEROS",2,3,5
" 05","SUR","LAS PALMAS","TOTAL POBLACION",17,19,36
" 05","SUR","LEON","ESPAÑOLES",1,0,1
" 05","SUR","LEON","TOTAL POBLACION",1,0,1
" 05","SUR","LLEIDA","ESPAÑOLES",1,0,1
" 05","SUR","LLEIDA","TOTAL POBLACION",1,0,1
" 05","SUR","MADRID","ESPAÑOLES",83,85,168
" 05","SUR","MADRID","EXTRANJEROS",10,19,29
" 05","SUR","MADRID","TOTAL POBLACION",93,104,197
" 05","SUR","MALAGA","ESPAÑOLES",34,20,54
" 05","SUR","MALAGA","EXTRANJEROS",4,6,10
" 05","SUR","MALAGA","TOTAL POBLACION",38,26,64
" 05","SUR","MURCIA","ESPAÑOLES",1,0,1
" 05","SUR","MURCIA","EXTRANJEROS",2,2,4
" 05","SUR","MURCIA","TOTAL POBLACION",3,2,5
" 05","SUR","NAVARRA","ESPAÑOLES",1,2,3
" 05","SUR","NAVARRA","EXTRANJEROS",0,3,3
" 05","SUR","NAVARRA","TOTAL POBLACION",1,5,6
" 05","SUR","ORENSE","ESPAÑOLES",1,0,1
" 05","SUR","ORENSE","TOTAL POBLACION",1,0,1
" 05","SUR","PALENCIA","ESPAÑOLES",1,0,1
" 05","SUR","PALENCIA","TOTAL POBLACION",1,0,1
" 05","SUR","PONTEVEDRA","ESPAÑOLES",2,3,5
" 05","SUR","PONTEVEDRA","EXTRANJEROS",1,0,1
" 05","SUR","PONTEVEDRA","TOTAL POBLACION",3,3,6
" 05","SUR","SALAMANCA","ESPAÑOLES",3,4,7
" 05","SUR","SALAMANCA","EXTRANJEROS",0,1,1
" 05","SUR","SALAMANCA","TOTAL POBLACION",3,5,8
" 05","SUR","SANTA CRUZ DE TENERIFE","ESPAÑOLES",4,7,11
" 05","SUR","SANTA CRUZ DE TENERIFE","EXTRANJEROS",1,0,1
" 05","SUR","SANTA CRUZ DE TENERIFE","TOTAL POBLACION",5,7,12
" 05","SUR","SEVILLA","ESPAÑOLES",370,379,749
" 05","SUR","SEVILLA","EXTRANJEROS",21,30,51
" 05","SUR","SEVILLA","TOTAL POBLACION",391,409,800
" 05","SUR","TARRAGONA","ESPAÑOLES",2,0,2
" 05","SUR","TARRAGONA","EXTRANJEROS",0,2,2
" 05","SUR","TARRAGONA","TOTAL POBLACION",2,2,4
" 05","SUR","TOLEDO","ESPAÑOLES",3,2,5
" 05","SUR","TOLEDO","EXTRANJEROS",3,2,5
" 05","SUR","TOLEDO","TOTAL POBLACION",6,4,10
" 05","SUR","VALENCIA","ESPAÑOLES",8,6,14
" 05","SUR","VALENCIA","EXTRANJEROS",3,2,5
" 05","SUR","VALENCIA","TOTAL POBLACION",11,8,19
" 05","SUR","VALLADOLID","ESPAÑOLES",1,0,1
" 05","SUR","VALLADOLID","TOTAL POBLACION",1,0,1
" 05","SUR","ZARAGOZA","ESPAÑOLES",1,3,4
" 05","SUR","ZARAGOZA","EXTRANJEROS",1,0,1
" 05","SUR","ZARAGOZA","TOTAL POBLACION",2,3,5
" 06","TRIANA","- TODOS -","ESPAÑOLES",562,544,1106
" 06","TRIANA","- TODOS -","EXTRANJEROS",64,103,167
" 06","TRIANA","- TODOS -","NO CONSTA",1,0,1
" 06","TRIANA","- TODOS -","TOTAL POBLACION",627,647,1274
" 06","TRIANA","ALBACETE","ESPAÑOLES",0,1,1
" 06","TRIANA","ALBACETE","TOTAL POBLACION",0,1,1
" 06","TRIANA","ALICANTE","ESPAÑOLES",2,2,4
" 06","TRIANA","ALICANTE","TOTAL POBLACION",2,2,4
" 06","TRIANA","ALMERIA","ESPAÑOLES",4,5,9
" 06","TRIANA","ALMERIA","EXTRANJEROS",1,1,2
" 06","TRIANA","ALMERIA","TOTAL POBLACION",5,6,11
" 06","TRIANA","ARABA/ALAVA","ESPAÑOLES",1,0,1
" 06","TRIANA","ARABA/ALAVA","TOTAL POBLACION",1,0,1
" 06","TRIANA","ASTURIAS","ESPAÑOLES",1,2,3
" 06","TRIANA","ASTURIAS","TOTAL POBLACION",1,2,3
" 06","TRIANA","AVILA","ESPAÑOLES",1,1,2
" 06","TRIANA","AVILA","EXTRANJEROS",0,1,1
" 06","TRIANA","AVILA","TOTAL POBLACION",1,2,3
" 06","TRIANA","BADAJOZ","ESPAÑOLES",11,14,25
" 06","TRIANA","BADAJOZ","TOTAL POBLACION",11,14,25
" 06","TRIANA","BALEARES","ESPAÑOLES",14,8,22
" 06","TRIANA","BALEARES","TOTAL POBLACION",14,8,22
" 06","TRIANA","BARCELONA","ESPAÑOLES",14,10,24
" 06","TRIANA","BARCELONA","EXTRANJEROS",6,6,12
" 06","TRIANA","BARCELONA","NO CONSTA",1,0,1
" 06","TRIANA","BARCELONA","TOTAL POBLACION",21,16,37
" 06","TRIANA","BIZKAIA","ESPAÑOLES",0,1,1
" 06","TRIANA","BIZKAIA","EXTRANJEROS",1,0,1
" 06","TRIANA","BIZKAIA","TOTAL POBLACION",1,1,2
" 06","TRIANA","BURGOS","ESPAÑOLES",1,2,3
" 06","TRIANA","BURGOS","TOTAL POBLACION",1,2,3
" 06","TRIANA","CACERES","ESPAÑOLES",2,3,5
" 06","TRIANA","CACERES","TOTAL POBLACION",2,3,5
" 06","TRIANA","CADIZ","ESPAÑOLES",26,25,51
" 06","TRIANA","CADIZ","EXTRANJEROS",3,5,8
" 06","TRIANA","CADIZ","TOTAL POBLACION",29,30,59
" 06","TRIANA","CANTABRIA","ESPAÑOLES",0,2,2
" 06","TRIANA","CANTABRIA","TOTAL POBLACION",0,2,2
" 06","TRIANA","CASTELLON","ESPAÑOLES",0,2,2
" 06","TRIANA","CASTELLON","TOTAL POBLACION",0,2,2
" 06","TRIANA","CEUTA","ESPAÑOLES",3,1,4
" 06","TRIANA","CEUTA","EXTRANJEROS",1,0,1
" 06","TRIANA","CEUTA","TOTAL POBLACION",4,1,5
" 06","TRIANA","CIUDAD REAL","ESPAÑOLES",0,2,2
" 06","TRIANA","CIUDAD REAL","EXTRANJEROS",2,0,2
" 06","TRIANA","CIUDAD REAL","TOTAL POBLACION",2,2,4
" 06","TRIANA","CORDOBA","ESPAÑOLES",7,10,17
" 06","TRIANA","CORDOBA","EXTRANJEROS",2,0,2
" 06","TRIANA","CORDOBA","TOTAL POBLACION",9,10,19
" 06","TRIANA","EXTRAJERO","ESPAÑOLES",45,46,91
" 06","TRIANA","EXTRAJERO","EXTRANJEROS",7,10,17
" 06","TRIANA","EXTRAJERO","TOTAL POBLACION",52,56,108
" 06","TRIANA","GERONA","ESPAÑOLES",1,2,3
" 06","TRIANA","GERONA","TOTAL POBLACION",1,2,3
" 06","TRIANA","GIPUZKOA","EXTRANJEROS",0,1,1
" 06","TRIANA","GIPUZKOA","TOTAL POBLACION",0,1,1
" 06","TRIANA","GRANADA","ESPAÑOLES",15,9,24
" 06","TRIANA","GRANADA","EXTRANJEROS",3,2,5
" 06","TRIANA","GRANADA","TOTAL POBLACION",18,11,29
" 06","TRIANA","GUADALAJARA","ESPAÑOLES",1,0,1
" 06","TRIANA","GUADALAJARA","TOTAL POBLACION",1,0,1
" 06","TRIANA","HUELVA","ESPAÑOLES",22,25,47
" 06","TRIANA","HUELVA","EXTRANJEROS",2,6,8
" 06","TRIANA","HUELVA","TOTAL POBLACION",24,31,55
" 06","TRIANA","HUESCA","ESPAÑOLES",0,1,1
" 06","TRIANA","HUESCA","TOTAL POBLACION",0,1,1
" 06","TRIANA","JAEN","ESPAÑOLES",4,4,8
" 06","TRIANA","JAEN","TOTAL POBLACION",4,4,8
" 06","TRIANA","LA CORUÑA","ESPAÑOLES",2,3,5
" 06","TRIANA","LA CORUÑA","EXTRANJEROS",0,1,1
" 06","TRIANA","LA CORUÑA","TOTAL POBLACION",2,4,6
" 06","TRIANA","LA RIOJA","ESPAÑOLES",0,1,1
" 06","TRIANA","LA RIOJA","TOTAL POBLACION",0,1,1
" 06","TRIANA","LAS PALMAS","ESPAÑOLES",5,5,10
" 06","TRIANA","LAS PALMAS","EXTRANJEROS",0,3,3
" 06","TRIANA","LAS PALMAS","TOTAL POBLACION",5,8,13
" 06","TRIANA","LEON","ESPAÑOLES",1,0,1
" 06","TRIANA","LEON","TOTAL POBLACION",1,0,1
" 06","TRIANA","MADRID","ESPAÑOLES",57,31,88
" 06","TRIANA","MADRID","EXTRANJEROS",3,11,14
" 06","TRIANA","MADRID","TOTAL POBLACION",60,42,102
" 06","TRIANA","MALAGA","ESPAÑOLES",19,15,34
" 06","TRIANA","MALAGA","EXTRANJEROS",5,3,8
" 06","TRIANA","MALAGA","TOTAL POBLACION",24,18,42
" 06","TRIANA","MELILLA","ESPAÑOLES",1,0,1
" 06","TRIANA","MELILLA","TOTAL POBLACION",1,0,1
" 06","TRIANA","MURCIA","ESPAÑOLES",2,3,5
" 06","TRIANA","MURCIA","EXTRANJEROS",0,2,2
" 06","TRIANA","MURCIA","TOTAL POBLACION",2,5,7
" 06","TRIANA","NAVARRA","ESPAÑOLES",1,0,1
" 06","TRIANA","NAVARRA","EXTRANJEROS",1,1,2
" 06","TRIANA","NAVARRA","TOTAL POBLACION",2,1,3
" 06","TRIANA","ORENSE","ESPAÑOLES",0,1,1
" 06","TRIANA","ORENSE","TOTAL POBLACION",0,1,1
" 06","TRIANA","PALENCIA","ESPAÑOLES",1,0,1
" 06","TRIANA","PALENCIA","TOTAL POBLACION",1,0,1
" 06","TRIANA","PONTEVEDRA","ESPAÑOLES",1,0,1
" 06","TRIANA","PONTEVEDRA","TOTAL POBLACION",1,0,1
" 06","TRIANA","SALAMANCA","ESPAÑOLES",0,1,1
" 06","TRIANA","SALAMANCA","EXTRANJEROS",0,1,1
" 06","TRIANA","SALAMANCA","TOTAL POBLACION",0,2,2
" 06","TRIANA","SANTA CRUZ DE TENERIFE","ESPAÑOLES",0,1,1
" 06","TRIANA","SANTA CRUZ DE TENERIFE","TOTAL POBLACION",0,1,1
" 06","TRIANA","SEGOVIA","ESPAÑOLES",0,1,1
" 06","TRIANA","SEGOVIA","TOTAL POBLACION",0,1,1
" 06","TRIANA","SEVILLA","ESPAÑOLES",283,297,580
" 06","TRIANA","SEVILLA","EXTRANJEROS",26,42,68
" 06","TRIANA","SEVILLA","TOTAL POBLACION",309,339,648
" 06","TRIANA","SORIA","ESPAÑOLES",1,0,1
" 06","TRIANA","SORIA","TOTAL POBLACION",1,0,1
" 06","TRIANA","TARRAGONA","ESPAÑOLES",1,0,1
" 06","TRIANA","TARRAGONA","TOTAL POBLACION",1,0,1
" 06","TRIANA","TOLEDO","EXTRANJEROS",0,2,2
" 06","TRIANA","TOLEDO","TOTAL POBLACION",0,2,2
" 06","TRIANA","VALENCIA","ESPAÑOLES",8,5,13
" 06","TRIANA","VALENCIA","EXTRANJEROS",1,3,4
" 06","TRIANA","VALENCIA","TOTAL POBLACION",9,8,17
" 06","TRIANA","ZARAGOZA","ESPAÑOLES",4,2,6
" 06","TRIANA","ZARAGOZA","EXTRANJEROS",0,2,2
" 06","TRIANA","ZARAGOZA","TOTAL POBLACION",4,4,8
" 07","NORTE","- TODOS -","ESPAÑOLES",613,652,1265
" 07","NORTE","- TODOS -","EXTRANJEROS",54,47,101
" 07","NORTE","- TODOS -","TOTAL POBLACION",667,699,1366
" 07","NORTE","ALBACETE","EXTRANJEROS",1,0,1
" 07","NORTE","ALBACETE","TOTAL POBLACION",1,0,1
" 07","NORTE","ALICANTE","ESPAÑOLES",3,3,6
" 07","NORTE","ALICANTE","EXTRANJEROS",1,2,3
" 07","NORTE","ALICANTE","TOTAL POBLACION",4,5,9
" 07","NORTE","ALMERIA","ESPAÑOLES",6,3,9
" 07","NORTE","ALMERIA","EXTRANJEROS",1,0,1
" 07","NORTE","ALMERIA","TOTAL POBLACION",7,3,10
" 07","NORTE","BADAJOZ","ESPAÑOLES",3,8,11
" 07","NORTE","BADAJOZ","TOTAL POBLACION",3,8,11
" 07","NORTE","BALEARES","ESPAÑOLES",14,18,32
" 07","NORTE","BALEARES","EXTRANJEROS",3,1,4
" 07","NORTE","BALEARES","TOTAL POBLACION",17,19,36
" 07","NORTE","BARCELONA","ESPAÑOLES",14,15,29
" 07","NORTE","BARCELONA","EXTRANJEROS",2,1,3
" 07","NORTE","BARCELONA","TOTAL POBLACION",16,16,32
" 07","NORTE","BIZKAIA","ESPAÑOLES",2,2,4
" 07","NORTE","BIZKAIA","EXTRANJEROS",0,2,2
" 07","NORTE","BIZKAIA","TOTAL POBLACION",2,4,6
" 07","NORTE","BURGOS","ESPAÑOLES",0,1,1
" 07","NORTE","BURGOS","TOTAL POBLACION",0,1,1
" 07","NORTE","CACERES","ESPAÑOLES",2,5,7
" 07","NORTE","CACERES","TOTAL POBLACION",2,5,7
" 07","NORTE","CADIZ","ESPAÑOLES",22,24,46
" 07","NORTE","CADIZ","EXTRANJEROS",1,0,1
" 07","NORTE","CADIZ","TOTAL POBLACION",23,24,47
" 07","NORTE","CANTABRIA","ESPAÑOLES",1,1,2
" 07","NORTE","CANTABRIA","TOTAL POBLACION",1,1,2
" 07","NORTE","CASTELLON","ESPAÑOLES",1,3,4
" 07","NORTE","CASTELLON","EXTRANJEROS",1,0,1
" 07","NORTE","CASTELLON","TOTAL POBLACION",2,3,5
" 07","NORTE","CIUDAD REAL","EXTRANJEROS",1,0,1
" 07","NORTE","CIUDAD REAL","TOTAL POBLACION",1,0,1
" 07","NORTE","CORDOBA","ESPAÑOLES",6,5,11
" 07","NORTE","CORDOBA","EXTRANJEROS",2,0,2
" 07","NORTE","CORDOBA","TOTAL POBLACION",8,5,13
" 07","NORTE","EXTRAJERO","ESPAÑOLES",25,28,53
" 07","NORTE","EXTRAJERO","EXTRANJEROS",1,4,5
" 07","NORTE","EXTRAJERO","TOTAL POBLACION",26,32,58
" 07","NORTE","GERONA","ESPAÑOLES",3,3,6
" 07","NORTE","GERONA","TOTAL POBLACION",3,3,6
" 07","NORTE","GIPUZKOA","ESPAÑOLES",1,4,5
" 07","NORTE","GIPUZKOA","EXTRANJEROS",1,1,2
" 07","NORTE","GIPUZKOA","TOTAL POBLACION",2,5,7
" 07","NORTE","GRANADA","ESPAÑOLES",6,7,13
" 07","NORTE","GRANADA","EXTRANJEROS",1,0,1
" 07","NORTE","GRANADA","TOTAL POBLACION",7,7,14
" 07","NORTE","GUADALAJARA","ESPAÑOLES",0,1,1
" 07","NORTE","GUADALAJARA","TOTAL POBLACION",0,1,1
" 07","NORTE","HUELVA","ESPAÑOLES",15,16,31
" 07","NORTE","HUELVA","EXTRANJEROS",4,3,7
" 07","NORTE","HUELVA","TOTAL POBLACION",19,19,38
" 07","NORTE","HUESCA","ESPAÑOLES",1,0,1
" 07","NORTE","HUESCA","TOTAL POBLACION",1,0,1
" 07","NORTE","JAEN","ESPAÑOLES",4,1,5
" 07","NORTE","JAEN","EXTRANJEROS",1,0,1
" 07","NORTE","JAEN","TOTAL POBLACION",5,1,6
" 07","NORTE","LA RIOJA","ESPAÑOLES",1,2,3
" 07","NORTE","LA RIOJA","TOTAL POBLACION",1,2,3
" 07","NORTE","LAS PALMAS","ESPAÑOLES",13,17,30
" 07","NORTE","LAS PALMAS","EXTRANJEROS",0,1,1
" 07","NORTE","LAS PALMAS","TOTAL POBLACION",13,18,31
" 07","NORTE","LEON","ESPAÑOLES",1,0,1
" 07","NORTE","LEON","TOTAL POBLACION",1,0,1
" 07","NORTE","LLEIDA","ESPAÑOLES",0,2,2
" 07","NORTE","LLEIDA","TOTAL POBLACION",0,2,2
" 07","NORTE","MADRID","ESPAÑOLES",42,35,77
" 07","NORTE","MADRID","EXTRANJEROS",7,9,16
" 07","NORTE","MADRID","TOTAL POBLACION",49,44,93
" 07","NORTE","MALAGA","ESPAÑOLES",9,16,25
" 07","NORTE","MALAGA","EXTRANJEROS",3,1,4
" 07","NORTE","MALAGA","TOTAL POBLACION",12,17,29
" 07","NORTE","MURCIA","ESPAÑOLES",6,5,11
" 07","NORTE","MURCIA","EXTRANJEROS",3,0,3
" 07","NORTE","MURCIA","TOTAL POBLACION",9,5,14
" 07","NORTE","NAVARRA","ESPAÑOLES",3,2,5
" 07","NORTE","NAVARRA","TOTAL POBLACION",3,2,5
" 07","NORTE","ORENSE","ESPAÑOLES",2,2,4
" 07","NORTE","ORENSE","TOTAL POBLACION",2,2,4
" 07","NORTE","PALENCIA","EXTRANJEROS",1,0,1
" 07","NORTE","PALENCIA","TOTAL POBLACION",1,0,1
" 07","NORTE","PONTEVEDRA","ESPAÑOLES",2,0,2
" 07","NORTE","PONTEVEDRA","TOTAL POBLACION",2,0,2
" 07","NORTE","SANTA CRUZ DE TENERIFE","ESPAÑOLES",5,4,9
" 07","NORTE","SANTA CRUZ DE TENERIFE","TOTAL POBLACION",5,4,9
" 07","NORTE","SEVILLA","ESPAÑOLES",384,400,784
" 07","NORTE","SEVILLA","EXTRANJEROS",16,21,37
" 07","NORTE","SEVILLA","TOTAL POBLACION",400,421,821
" 07","NORTE","TARRAGONA","ESPAÑOLES",2,5,7
" 07","NORTE","TARRAGONA","TOTAL POBLACION",2,5,7
" 07","NORTE","TOLEDO","ESPAÑOLES",2,2,4
" 07","NORTE","TOLEDO","EXTRANJEROS",2,0,2
" 07","NORTE","TOLEDO","TOTAL POBLACION",4,2,6
" 07","NORTE","VALENCIA","ESPAÑOLES",8,3,11
" 07","NORTE","VALENCIA","EXTRANJEROS",0,1,1
" 07","NORTE","VALENCIA","TOTAL POBLACION",8,4,12
" 07","NORTE","VALLADOLID","ESPAÑOLES",2,7,9
" 07","NORTE","VALLADOLID","TOTAL POBLACION",2,7,9
" 07","NORTE","ZARAGOZA","ESPAÑOLES",2,2,4
" 07","NORTE","ZARAGOZA","EXTRANJEROS",1,0,1
" 07","NORTE","ZARAGOZA","TOTAL POBLACION",3,2,5
" 08","S. PABLO-STA. JUSTA","- TODOS -","ESPAÑOLES",527,563,1090
" 08","S. PABLO-STA. JUSTA","- TODOS -","EXTRANJEROS",63,72,135
" 08","S. PABLO-STA. JUSTA","- TODOS -","NO CONSTA",0,1,1
" 08","S. PABLO-STA. JUSTA","- TODOS -","TOTAL POBLACION",590,636,1226
" 08","S. PABLO-STA. JUSTA","ALBACETE","EXTRANJEROS",1,0,1
" 08","S. PABLO-STA. JUSTA","ALBACETE","TOTAL POBLACION",1,0,1
" 08","S. PABLO-STA. JUSTA","ALICANTE","ESPAÑOLES",4,5,9
" 08","S. PABLO-STA. JUSTA","ALICANTE","EXTRANJEROS",3,4,7
" 08","S. PABLO-STA. JUSTA","ALICANTE","TOTAL POBLACION",7,9,16
" 08","S. PABLO-STA. JUSTA","ALMERIA","ESPAÑOLES",2,0,2
" 08","S. PABLO-STA. JUSTA","ALMERIA","EXTRANJEROS",1,0,1
" 08","S. PABLO-STA. JUSTA","ALMERIA","TOTAL POBLACION",3,0,3
" 08","S. PABLO-STA. JUSTA","ARABA/ALAVA","ESPAÑOLES",2,3,5
" 08","S. PABLO-STA. JUSTA","ARABA/ALAVA","TOTAL POBLACION",2,3,5
" 08","S. PABLO-STA. JUSTA","ASTURIAS","ESPAÑOLES",2,3,5
" 08","S. PABLO-STA. JUSTA","ASTURIAS","TOTAL POBLACION",2,3,5
" 08","S. PABLO-STA. JUSTA","BADAJOZ","ESPAÑOLES",5,5,10
" 08","S. PABLO-STA. JUSTA","BADAJOZ","EXTRANJEROS",1,0,1
" 08","S. PABLO-STA. JUSTA","BADAJOZ","TOTAL POBLACION",6,5,11
" 08","S. PABLO-STA. JUSTA","BALEARES","ESPAÑOLES",19,9,28
" 08","S. PABLO-STA. JUSTA","BALEARES","EXTRANJEROS",3,1,4
" 08","S. PABLO-STA. JUSTA","BALEARES","TOTAL POBLACION",22,10,32
" 08","S. PABLO-STA. JUSTA","BARCELONA","ESPAÑOLES",14,12,26
" 08","S. PABLO-STA. JUSTA","BARCELONA","EXTRANJEROS",2,4,6
" 08","S. PABLO-STA. JUSTA","BARCELONA","TOTAL POBLACION",16,16,32
" 08","S. PABLO-STA. JUSTA","BIZKAIA","ESPAÑOLES",1,1,2
" 08","S. PABLO-STA. JUSTA","BIZKAIA","EXTRANJEROS",1,1,2
" 08","S. PABLO-STA. JUSTA","BIZKAIA","TOTAL POBLACION",2,2,4
" 08","S. PABLO-STA. JUSTA","CACERES","ESPAÑOLES",1,0,1
" 08","S. PABLO-STA. JUSTA","CACERES","TOTAL POBLACION",1,0,1
" 08","S. PABLO-STA. JUSTA","CADIZ","ESPAÑOLES",33,42,75
" 08","S. PABLO-STA. JUSTA","CADIZ","EXTRANJEROS",1,1,2
" 08","S. PABLO-STA. JUSTA","CADIZ","TOTAL POBLACION",34,43,77
" 08","S. PABLO-STA. JUSTA","CANTABRIA","ESPAÑOLES",1,1,2
" 08","S. PABLO-STA. JUSTA","CANTABRIA","EXTRANJEROS",1,2,3
" 08","S. PABLO-STA. JUSTA","CANTABRIA","TOTAL POBLACION",2,3,5
" 08","S. PABLO-STA. JUSTA","CASTELLON","ESPAÑOLES",0,1,1
" 08","S. PABLO-STA. JUSTA","CASTELLON","TOTAL POBLACION",0,1,1
" 08","S. PABLO-STA. JUSTA","CIUDAD REAL","ESPAÑOLES",2,4,6
" 08","S. PABLO-STA. JUSTA","CIUDAD REAL","TOTAL POBLACION",2,4,6
" 08","S. PABLO-STA. JUSTA","CORDOBA","ESPAÑOLES",6,3,9
" 08","S. PABLO-STA. JUSTA","CORDOBA","EXTRANJEROS",0,1,1
" 08","S. PABLO-STA. JUSTA","CORDOBA","TOTAL POBLACION",6,4,10
" 08","S. PABLO-STA. JUSTA","CUENCA","ESPAÑOLES",1,0,1
" 08","S. PABLO-STA. JUSTA","CUENCA","TOTAL POBLACION",1,0,1
" 08","S. PABLO-STA. JUSTA","EXTRAJERO","ESPAÑOLES",52,52,104
" 08","S. PABLO-STA. JUSTA","EXTRAJERO","EXTRANJEROS",6,8,14
" 08","S. PABLO-STA. JUSTA","EXTRAJERO","TOTAL POBLACION",58,60,118
" 08","S. PABLO-STA. JUSTA","GERONA","ESPAÑOLES",1,3,4
" 08","S. PABLO-STA. JUSTA","GERONA","EXTRANJEROS",0,1,1
" 08","S. PABLO-STA. JUSTA","GERONA","TOTAL POBLACION",1,4,5
" 08","S. PABLO-STA. JUSTA","GIPUZKOA","ESPAÑOLES",1,0,1
" 08","S. PABLO-STA. JUSTA","GIPUZKOA","TOTAL POBLACION",1,0,1
" 08","S. PABLO-STA. JUSTA","GRANADA","ESPAÑOLES",5,9,14
" 08","S. PABLO-STA. JUSTA","GRANADA","EXTRANJEROS",2,1,3
" 08","S. PABLO-STA. JUSTA","GRANADA","TOTAL POBLACION",7,10,17
" 08","S. PABLO-STA. JUSTA","GUADALAJARA","ESPAÑOLES",0,1,1
" 08","S. PABLO-STA. JUSTA","GUADALAJARA","TOTAL POBLACION",0,1,1
" 08","S. PABLO-STA. JUSTA","HUELVA","ESPAÑOLES",20,19,39
" 08","S. PABLO-STA. JUSTA","HUELVA","EXTRANJEROS",0,1,1
" 08","S. PABLO-STA. JUSTA","HUELVA","TOTAL POBLACION",20,20,40
" 08","S. PABLO-STA. JUSTA","HUESCA","ESPAÑOLES",0,1,1
" 08","S. PABLO-STA. JUSTA","HUESCA","EXTRANJEROS",1,0,1
" 08","S. PABLO-STA. JUSTA","HUESCA","TOTAL POBLACION",1,1,2
" 08","S. PABLO-STA. JUSTA","JAEN","ESPAÑOLES",3,3,6
" 08","S. PABLO-STA. JUSTA","JAEN","EXTRANJEROS",2,3,5
" 08","S. PABLO-STA. JUSTA","JAEN","TOTAL POBLACION",5,6,11
" 08","S. PABLO-STA. JUSTA","LA CORUÑA","ESPAÑOLES",3,3,6
" 08","S. PABLO-STA. JUSTA","LA CORUÑA","TOTAL POBLACION",3,3,6
" 08","S. PABLO-STA. JUSTA","LA RIOJA","ESPAÑOLES",0,1,1
" 08","S. PABLO-STA. JUSTA","LA RIOJA","TOTAL POBLACION",0,1,1
" 08","S. PABLO-STA. JUSTA","LAS PALMAS","ESPAÑOLES",18,9,27
" 08","S. PABLO-STA. JUSTA","LAS PALMAS","TOTAL POBLACION",18,9,27
" 08","S. PABLO-STA. JUSTA","LEON","ESPAÑOLES",2,0,2
" 08","S. PABLO-STA. JUSTA","LEON","TOTAL POBLACION",2,0,2
" 08","S. PABLO-STA. JUSTA","MADRID","ESPAÑOLES",45,43,88
" 08","S. PABLO-STA. JUSTA","MADRID","EXTRANJEROS",13,16,29
" 08","S. PABLO-STA. JUSTA","MADRID","NO CONSTA",0,1,1
" 08","S. PABLO-STA. JUSTA","MADRID","TOTAL POBLACION",58,60,118
" 08","S. PABLO-STA. JUSTA","MALAGA","ESPAÑOLES",20,16,36
" 08","S. PABLO-STA. JUSTA","MALAGA","EXTRANJEROS",7,6,13
" 08","S. PABLO-STA. JUSTA","MALAGA","TOTAL POBLACION",27,22,49
" 08","S. PABLO-STA. JUSTA","MURCIA","ESPAÑOLES",0,3,3
" 08","S. PABLO-STA. JUSTA","MURCIA","EXTRANJEROS",1,0,1
" 08","S. PABLO-STA. JUSTA","MURCIA","TOTAL POBLACION",1,3,4
" 08","S. PABLO-STA. JUSTA","ORENSE","ESPAÑOLES",1,1,2
" 08","S. PABLO-STA. JUSTA","ORENSE","TOTAL POBLACION",1,1,2
" 08","S. PABLO-STA. JUSTA","PONTEVEDRA","ESPAÑOLES",1,0,1
" 08","S. PABLO-STA. JUSTA","PONTEVEDRA","TOTAL POBLACION",1,0,1
" 08","S. PABLO-STA. JUSTA","SALAMANCA","ESPAÑOLES",3,3,6
" 08","S. PABLO-STA. JUSTA","SALAMANCA","TOTAL POBLACION",3,3,6
" 08","S. PABLO-STA. JUSTA","SANTA CRUZ DE TENERIFE","ESPAÑOLES",4,3,7
" 08","S. PABLO-STA. JUSTA","SANTA CRUZ DE TENERIFE","EXTRANJEROS",2,0,2
" 08","S. PABLO-STA. JUSTA","SANTA CRUZ DE TENERIFE","TOTAL POBLACION",6,3,9
" 08","S. PABLO-STA. JUSTA","SEVILLA","ESPAÑOLES",246,294,540
" 08","S. PABLO-STA. JUSTA","SEVILLA","EXTRANJEROS",11,18,29
" 08","S. PABLO-STA. JUSTA","SEVILLA","TOTAL POBLACION",257,312,569
" 08","S. PABLO-STA. JUSTA","TARRAGONA","ESPAÑOLES",1,0,1
" 08","S. PABLO-STA. JUSTA","TARRAGONA","EXTRANJEROS",1,0,1
" 08","S. PABLO-STA. JUSTA","TARRAGONA","TOTAL POBLACION",2,0,2
" 08","S. PABLO-STA. JUSTA","TOLEDO","ESPAÑOLES",2,2,4
" 08","S. PABLO-STA. JUSTA","TOLEDO","EXTRANJEROS",2,0,2
" 08","S. PABLO-STA. JUSTA","TOLEDO","TOTAL POBLACION",4,2,6
" 08","S. PABLO-STA. JUSTA","VALENCIA","ESPAÑOLES",4,6,10
" 08","S. PABLO-STA. JUSTA","VALENCIA","EXTRANJEROS",1,2,3
" 08","S. PABLO-STA. JUSTA","VALENCIA","TOTAL POBLACION",5,8,13
" 08","S. PABLO-STA. JUSTA","ZARAGOZA","ESPAÑOLES",2,2,4
" 08","S. PABLO-STA. JUSTA","ZARAGOZA","EXTRANJEROS",0,2,2
" 08","S. PABLO-STA. JUSTA","ZARAGOZA","TOTAL POBLACION",2,4,6
" 09","ESTE","- TODOS -","ESPAÑOLES",916,922,1838
" 09","ESTE","- TODOS -","EXTRANJEROS",120,93,213
" 09","ESTE","- TODOS -","NO CONSTA",1,0,1
" 09","ESTE","- TODOS -","TOTAL POBLACION",1037,1015,2052
" 09","ESTE","ALBACETE","ESPAÑOLES",1,0,1
" 09","ESTE","ALBACETE","EXTRANJEROS",1,0,1
" 09","ESTE","ALBACETE","TOTAL POBLACION",2,0,2
" 09","ESTE","ALICANTE","ESPAÑOLES",10,11,21
" 09","ESTE","ALICANTE","EXTRANJEROS",5,8,13
" 09","ESTE","ALICANTE","NO CONSTA",1,0,1
" 09","ESTE","ALICANTE","TOTAL POBLACION",16,19,35
" 09","ESTE","ALMERIA","ESPAÑOLES",9,7,16
" 09","ESTE","ALMERIA","EXTRANJEROS",1,1,2
" 09","ESTE","ALMERIA","TOTAL POBLACION",10,8,18
" 09","ESTE","ARABA/ALAVA","ESPAÑOLES",3,1,4
" 09","ESTE","ARABA/ALAVA","EXTRANJEROS",3,3,6
" 09","ESTE","ARABA/ALAVA","TOTAL POBLACION",6,4,10
" 09","ESTE","ASTURIAS","ESPAÑOLES",3,3,6
" 09","ESTE","ASTURIAS","EXTRANJEROS",0,1,1
" 09","ESTE","ASTURIAS","TOTAL POBLACION",3,4,7
" 09","ESTE","BADAJOZ","ESPAÑOLES",6,7,13
" 09","ESTE","BADAJOZ","EXTRANJEROS",1,1,2
" 09","ESTE","BADAJOZ","TOTAL POBLACION",7,8,15
" 09","ESTE","BALEARES","ESPAÑOLES",28,33,61
" 09","ESTE","BALEARES","EXTRANJEROS",4,0,4
" 09","ESTE","BALEARES","TOTAL POBLACION",32,33,65
" 09","ESTE","BARCELONA","ESPAÑOLES",23,15,38
" 09","ESTE","BARCELONA","EXTRANJEROS",12,13,25
" 09","ESTE","BARCELONA","TOTAL POBLACION",35,28,63
" 09","ESTE","BIZKAIA","ESPAÑOLES",4,0,4
" 09","ESTE","BIZKAIA","TOTAL POBLACION",4,0,4
" 09","ESTE","BURGOS","ESPAÑOLES",3,4,7
" 09","ESTE","BURGOS","TOTAL POBLACION",3,4,7
" 09","ESTE","CACERES","ESPAÑOLES",2,6,8
" 09","ESTE","CACERES","EXTRANJEROS",0,1,1
" 09","ESTE","CACERES","TOTAL POBLACION",2,7,9
" 09","ESTE","CADIZ","ESPAÑOLES",44,39,83
" 09","ESTE","CADIZ","EXTRANJEROS",3,3,6
" 09","ESTE","CADIZ","TOTAL POBLACION",47,42,89
" 09","ESTE","CANTABRIA","ESPAÑOLES",2,1,3
" 09","ESTE","CANTABRIA","EXTRANJEROS",0,1,1
" 09","ESTE","CANTABRIA","TOTAL POBLACION",2,2,4
" 09","ESTE","CASTELLON","ESPAÑOLES",2,1,3
" 09","ESTE","CASTELLON","EXTRANJEROS",4,1,5
" 09","ESTE","CASTELLON","TOTAL POBLACION",6,2,8
" 09","ESTE","CEUTA","ESPAÑOLES",1,0,1
" 09","ESTE","CEUTA","TOTAL POBLACION",1,0,1
" 09","ESTE","CIUDAD REAL","ESPAÑOLES",1,3,4
" 09","ESTE","CIUDAD REAL","EXTRANJEROS",1,0,1
" 09","ESTE","CIUDAD REAL","TOTAL POBLACION",2,3,5
" 09","ESTE","CORDOBA","ESPAÑOLES",20,19,39
" 09","ESTE","CORDOBA","TOTAL POBLACION",20,19,39
" 09","ESTE","EXTRAJERO","ESPAÑOLES",54,60,114
" 09","ESTE","EXTRAJERO","EXTRANJEROS",6,1,7
" 09","ESTE","EXTRAJERO","TOTAL POBLACION",60,61,121
" 09","ESTE","GERONA","ESPAÑOLES",0,1,1
" 09","ESTE","GERONA","EXTRANJEROS",1,0,1
" 09","ESTE","GERONA","TOTAL POBLACION",1,1,2
" 09","ESTE","GIPUZKOA","ESPAÑOLES",3,2,5
" 09","ESTE","GIPUZKOA","EXTRANJEROS",2,1,3
" 09","ESTE","GIPUZKOA","TOTAL POBLACION",5,3,8
" 09","ESTE","GRANADA","ESPAÑOLES",8,9,17
" 09","ESTE","GRANADA","EXTRANJEROS",3,0,3
" 09","ESTE","GRANADA","TOTAL POBLACION",11,9,20
" 09","ESTE","GUADALAJARA","ESPAÑOLES",2,3,5
" 09","ESTE","GUADALAJARA","TOTAL POBLACION",2,3,5
" 09","ESTE","HUELVA","ESPAÑOLES",34,30,64
" 09","ESTE","HUELVA","EXTRANJEROS",5,3,8
" 09","ESTE","HUELVA","TOTAL POBLACION",39,33,72
" 09","ESTE","JAEN","ESPAÑOLES",8,12,20
" 09","ESTE","JAEN","EXTRANJEROS",2,0,2
" 09","ESTE","JAEN","TOTAL POBLACION",10,12,22
" 09","ESTE","LA CORUÑA","ESPAÑOLES",3,6,9
" 09","ESTE","LA CORUÑA","EXTRANJEROS",0,1,1
" 09","ESTE","LA CORUÑA","TOTAL POBLACION",3,7,10
" 09","ESTE","LA RIOJA","ESPAÑOLES",1,1,2
" 09","ESTE","LA RIOJA","EXTRANJEROS",1,0,1
" 09","ESTE","LA RIOJA","TOTAL POBLACION",2,1,3
" 09","ESTE","LAS PALMAS","ESPAÑOLES",19,17,36
" 09","ESTE","LAS PALMAS","EXTRANJEROS",1,1,2
" 09","ESTE","LAS PALMAS","TOTAL POBLACION",20,18,38
" 09","ESTE","LEON","ESPAÑOLES",1,2,3
" 09","ESTE","LEON","TOTAL POBLACION",1,2,3
" 09","ESTE","LLEIDA","ESPAÑOLES",1,0,1
" 09","ESTE","LLEIDA","EXTRANJEROS",0,1,1
" 09","ESTE","LLEIDA","TOTAL POBLACION",1,1,2
" 09","ESTE","LUGO","ESPAÑOLES",0,1,1
" 09","ESTE","LUGO","TOTAL POBLACION",0,1,1
" 09","ESTE","MADRID","ESPAÑOLES",69,51,120
" 09","ESTE","MADRID","EXTRANJEROS",17,16,33
" 09","ESTE","MADRID","TOTAL POBLACION",86,67,153
" 09","ESTE","MALAGA","ESPAÑOLES",18,26,44
" 09","ESTE","MALAGA","EXTRANJEROS",7,4,11
" 09","ESTE","MALAGA","TOTAL POBLACION",25,30,55
" 09","ESTE","MELILLA","ESPAÑOLES",1,0,1
" 09","ESTE","MELILLA","TOTAL POBLACION",1,0,1
" 09","ESTE","MURCIA","ESPAÑOLES",2,2,4
" 09","ESTE","MURCIA","EXTRANJEROS",1,1,2
" 09","ESTE","MURCIA","TOTAL POBLACION",3,3,6
" 09","ESTE","ORENSE","ESPAÑOLES",5,2,7
" 09","ESTE","ORENSE","TOTAL POBLACION",5,2,7
" 09","ESTE","PALENCIA","ESPAÑOLES",0,2,2
" 09","ESTE","PALENCIA","TOTAL POBLACION",0,2,2
" 09","ESTE","PONTEVEDRA","ESPAÑOLES",0,1,1
" 09","ESTE","PONTEVEDRA","EXTRANJEROS",1,2,3
" 09","ESTE","PONTEVEDRA","TOTAL POBLACION",1,3,4
" 09","ESTE","SALAMANCA","ESPAÑOLES",1,2,3
" 09","ESTE","SALAMANCA","TOTAL POBLACION",1,2,3
" 09","ESTE","SANTA CRUZ DE TENERIFE","ESPAÑOLES",19,17,36
" 09","ESTE","SANTA CRUZ DE TENERIFE","EXTRANJEROS",2,1,3
" 09","ESTE","SANTA CRUZ DE TENERIFE","TOTAL POBLACION",21,18,39
" 09","ESTE","SEVILLA","ESPAÑOLES",485,502,987
" 09","ESTE","SEVILLA","EXTRANJEROS",26,24,50
" 09","ESTE","SEVILLA","TOTAL POBLACION",511,526,1037
" 09","ESTE","TARRAGONA","ESPAÑOLES",2,2,4
" 09","ESTE","TARRAGONA","TOTAL POBLACION",2,2,4
" 09","ESTE","TERUEL","ESPAÑOLES",0,1,1
" 09","ESTE","TERUEL","TOTAL POBLACION",0,1,1
" 09","ESTE","TOLEDO","ESPAÑOLES",1,0,1
" 09","ESTE","TOLEDO","TOTAL POBLACION",1,0,1
" 09","ESTE","VALENCIA","ESPAÑOLES",7,10,17
" 09","ESTE","VALENCIA","EXTRANJEROS",9,4,13
" 09","ESTE","VALENCIA","TOTAL POBLACION",16,14,30
" 09","ESTE","VALLADOLID","ESPAÑOLES",3,3,6
" 09","ESTE","VALLADOLID","TOTAL POBLACION",3,3,6
" 09","ESTE","ZAMORA","ESPAÑOLES",0,1,1
" 09","ESTE","ZAMORA","TOTAL POBLACION",0,1,1
" 09","ESTE","ZARAGOZA","ESPAÑOLES",7,6,13
" 09","ESTE","ZARAGOZA","EXTRANJEROS",1,0,1
" 09","ESTE","ZARAGOZA","TOTAL POBLACION",8,6,14
" 10","BELLAVISTA-LA PALMERA","- TODOS -","ESPAÑOLES",488,531,1019
" 10","BELLAVISTA-LA PALMERA","- TODOS -","EXTRANJEROS",51,60,111
" 10","BELLAVISTA-LA PALMERA","- TODOS -","NO CONSTA",0,2,2
" 10","BELLAVISTA-LA PALMERA","- TODOS -","TOTAL POBLACION",539,593,1132
" 10","BELLAVISTA-LA PALMERA","ALBACETE","ESPAÑOLES",2,0,2
" 10","BELLAVISTA-LA PALMERA","ALBACETE","TOTAL POBLACION",2,0,2
" 10","BELLAVISTA-LA PALMERA","ALICANTE","ESPAÑOLES",3,5,8
" 10","BELLAVISTA-LA PALMERA","ALICANTE","EXTRANJEROS",2,1,3
" 10","BELLAVISTA-LA PALMERA","ALICANTE","TOTAL POBLACION",5,6,11
" 10","BELLAVISTA-LA PALMERA","ALMERIA","ESPAÑOLES",2,4,6
" 10","BELLAVISTA-LA PALMERA","ALMERIA","EXTRANJEROS",0,1,1
" 10","BELLAVISTA-LA PALMERA","ALMERIA","TOTAL POBLACION",2,5,7
" 10","BELLAVISTA-LA PALMERA","ASTURIAS","ESPAÑOLES",0,1,1
" 10","BELLAVISTA-LA PALMERA","ASTURIAS","TOTAL POBLACION",0,1,1
" 10","BELLAVISTA-LA PALMERA","BADAJOZ","ESPAÑOLES",7,7,14
" 10","BELLAVISTA-LA PALMERA","BADAJOZ","EXTRANJEROS",1,1,2
" 10","BELLAVISTA-LA PALMERA","BADAJOZ","TOTAL POBLACION",8,8,16
" 10","BELLAVISTA-LA PALMERA","BALEARES","ESPAÑOLES",9,9,18
" 10","BELLAVISTA-LA PALMERA","BALEARES","EXTRANJEROS",1,2,3
" 10","BELLAVISTA-LA PALMERA","BALEARES","TOTAL POBLACION",10,11,21
" 10","BELLAVISTA-LA PALMERA","BARCELONA","ESPAÑOLES",12,10,22
" 10","BELLAVISTA-LA PALMERA","BARCELONA","EXTRANJEROS",4,6,10
" 10","BELLAVISTA-LA PALMERA","BARCELONA","TOTAL POBLACION",16,16,32
" 10","BELLAVISTA-LA PALMERA","BIZKAIA","ESPAÑOLES",1,0,1
" 10","BELLAVISTA-LA PALMERA","BIZKAIA","EXTRANJEROS",1,1,2
" 10","BELLAVISTA-LA PALMERA","BIZKAIA","TOTAL POBLACION",2,1,3
" 10","BELLAVISTA-LA PALMERA","BURGOS","ESPAÑOLES",2,2,4
" 10","BELLAVISTA-LA PALMERA","BURGOS","TOTAL POBLACION",2,2,4
" 10","BELLAVISTA-LA PALMERA","CACERES","ESPAÑOLES",3,1,4
" 10","BELLAVISTA-LA PALMERA","CACERES","TOTAL POBLACION",3,1,4
" 10","BELLAVISTA-LA PALMERA","CADIZ","ESPAÑOLES",33,34,67
" 10","BELLAVISTA-LA PALMERA","CADIZ","EXTRANJEROS",1,4,5
" 10","BELLAVISTA-LA PALMERA","CADIZ","TOTAL POBLACION",34,38,72
" 10","BELLAVISTA-LA PALMERA","CANTABRIA","ESPAÑOLES",0,2,2
" 10","BELLAVISTA-LA PALMERA","CANTABRIA","EXTRANJEROS",0,1,1
" 10","BELLAVISTA-LA PALMERA","CANTABRIA","TOTAL POBLACION",0,3,3
" 10","BELLAVISTA-LA PALMERA","CASTELLON","ESPAÑOLES",2,1,3
" 10","BELLAVISTA-LA PALMERA","CASTELLON","TOTAL POBLACION",2,1,3
" 10","BELLAVISTA-LA PALMERA","CEUTA","ESPAÑOLES",1,1,2
" 10","BELLAVISTA-LA PALMERA","CEUTA","EXTRANJEROS",1,0,1
" 10","BELLAVISTA-LA PALMERA","CEUTA","TOTAL POBLACION",2,1,3
" 10","BELLAVISTA-LA PALMERA","CIUDAD REAL","ESPAÑOLES",3,1,4
" 10","BELLAVISTA-LA PALMERA","CIUDAD REAL","TOTAL POBLACION",3,1,4
" 10","BELLAVISTA-LA PALMERA","CORDOBA","ESPAÑOLES",11,13,24
" 10","BELLAVISTA-LA PALMERA","CORDOBA","TOTAL POBLACION",11,13,24
" 10","BELLAVISTA-LA PALMERA","EXTRAJERO","ESPAÑOLES",42,48,90
" 10","BELLAVISTA-LA PALMERA","EXTRAJERO","EXTRANJEROS",2,4,6
" 10","BELLAVISTA-LA PALMERA","EXTRAJERO","TOTAL POBLACION",44,52,96
" 10","BELLAVISTA-LA PALMERA","GERONA","ESPAÑOLES",1,2,3
" 10","BELLAVISTA-LA PALMERA","GERONA","TOTAL POBLACION",1,2,3
" 10","BELLAVISTA-LA PALMERA","GIPUZKOA","ESPAÑOLES",1,2,3
" 10","BELLAVISTA-LA PALMERA","GIPUZKOA","EXTRANJEROS",1,0,1
" 10","BELLAVISTA-LA PALMERA","GIPUZKOA","TOTAL POBLACION",2,2,4
" 10","BELLAVISTA-LA PALMERA","GRANADA","ESPAÑOLES",6,11,17
" 10","BELLAVISTA-LA PALMERA","GRANADA","EXTRANJEROS",2,1,3
" 10","BELLAVISTA-LA PALMERA","GRANADA","TOTAL POBLACION",8,12,20
" 10","BELLAVISTA-LA PALMERA","GUADALAJARA","ESPAÑOLES",0,2,2
" 10","BELLAVISTA-LA PALMERA","GUADALAJARA","TOTAL POBLACION",0,2,2
" 10","BELLAVISTA-LA PALMERA","HUELVA","ESPAÑOLES",18,13,31
" 10","BELLAVISTA-LA PALMERA","HUELVA","EXTRANJEROS",2,1,3
" 10","BELLAVISTA-LA PALMERA","HUELVA","TOTAL POBLACION",20,14,34
" 10","BELLAVISTA-LA PALMERA","HUESCA","EXTRANJEROS",2,1,3
" 10","BELLAVISTA-LA PALMERA","HUESCA","TOTAL POBLACION",2,1,3
" 10","BELLAVISTA-LA PALMERA","JAEN","ESPAÑOLES",3,2,5
" 10","BELLAVISTA-LA PALMERA","JAEN","TOTAL POBLACION",3,2,5
" 10","BELLAVISTA-LA PALMERA","LAS PALMAS","ESPAÑOLES",7,2,9
" 10","BELLAVISTA-LA PALMERA","LAS PALMAS","TOTAL POBLACION",7,2,9
" 10","BELLAVISTA-LA PALMERA","LLEIDA","ESPAÑOLES",1,0,1
" 10","BELLAVISTA-LA PALMERA","LLEIDA","TOTAL POBLACION",1,0,1
" 10","BELLAVISTA-LA PALMERA","LUGO","ESPAÑOLES",1,1,2
" 10","BELLAVISTA-LA PALMERA","LUGO","TOTAL POBLACION",1,1,2
" 10","BELLAVISTA-LA PALMERA","MADRID","ESPAÑOLES",55,68,123
" 10","BELLAVISTA-LA PALMERA","MADRID","EXTRANJEROS",8,8,16
" 10","BELLAVISTA-LA PALMERA","MADRID","NO CONSTA",0,1,1
" 10","BELLAVISTA-LA PALMERA","MADRID","TOTAL POBLACION",63,77,140
" 10","BELLAVISTA-LA PALMERA","MALAGA","ESPAÑOLES",21,14,35
" 10","BELLAVISTA-LA PALMERA","MALAGA","EXTRANJEROS",2,1,3
" 10","BELLAVISTA-LA PALMERA","MALAGA","TOTAL POBLACION",23,15,38
" 10","BELLAVISTA-LA PALMERA","MELILLA","ESPAÑOLES",1,4,5
" 10","BELLAVISTA-LA PALMERA","MELILLA","TOTAL POBLACION",1,4,5
" 10","BELLAVISTA-LA PALMERA","MURCIA","ESPAÑOLES",3,2,5
" 10","BELLAVISTA-LA PALMERA","MURCIA","EXTRANJEROS",1,1,2
" 10","BELLAVISTA-LA PALMERA","MURCIA","TOTAL POBLACION",4,3,7
" 10","BELLAVISTA-LA PALMERA","NAVARRA","ESPAÑOLES",0,2,2
" 10","BELLAVISTA-LA PALMERA","NAVARRA","TOTAL POBLACION",0,2,2
" 10","BELLAVISTA-LA PALMERA","ORENSE","ESPAÑOLES",1,1,2
" 10","BELLAVISTA-LA PALMERA","ORENSE","TOTAL POBLACION",1,1,2
" 10","BELLAVISTA-LA PALMERA","PALENCIA","ESPAÑOLES",1,0,1
" 10","BELLAVISTA-LA PALMERA","PALENCIA","TOTAL POBLACION",1,0,1
" 10","BELLAVISTA-LA PALMERA","PONTEVEDRA","ESPAÑOLES",1,3,4
" 10","BELLAVISTA-LA PALMERA","PONTEVEDRA","TOTAL POBLACION",1,3,4
" 10","BELLAVISTA-LA PALMERA","SANTA CRUZ DE TENERIFE","ESPAÑOLES",4,3,7
" 10","BELLAVISTA-LA PALMERA","SANTA CRUZ DE TENERIFE","EXTRANJEROS",1,2,3
" 10","BELLAVISTA-LA PALMERA","SANTA CRUZ DE TENERIFE","TOTAL POBLACION",5,5,10
" 10","BELLAVISTA-LA PALMERA","SEVILLA","ESPAÑOLES",220,253,473
" 10","BELLAVISTA-LA PALMERA","SEVILLA","EXTRANJEROS",15,21,36
" 10","BELLAVISTA-LA PALMERA","SEVILLA","NO CONSTA",0,1,1
" 10","BELLAVISTA-LA PALMERA","SEVILLA","TOTAL POBLACION",235,275,510
" 10","BELLAVISTA-LA PALMERA","SORIA","ESPAÑOLES",1,0,1
" 10","BELLAVISTA-LA PALMERA","SORIA","TOTAL POBLACION",1,0,1
" 10","BELLAVISTA-LA PALMERA","TARRAGONA","EXTRANJEROS",1,0,1
" 10","BELLAVISTA-LA PALMERA","TARRAGONA","TOTAL POBLACION",1,0,1
" 10","BELLAVISTA-LA PALMERA","TOLEDO","EXTRANJEROS",0,1,1
" 10","BELLAVISTA-LA PALMERA","TOLEDO","TOTAL POBLACION",0,1,1
" 10","BELLAVISTA-LA PALMERA","VALENCIA","ESPAÑOLES",5,5,10
" 10","BELLAVISTA-LA PALMERA","VALENCIA","EXTRANJEROS",2,1,3
" 10","BELLAVISTA-LA PALMERA","VALENCIA","TOTAL POBLACION",7,6,13
" 10","BELLAVISTA-LA PALMERA","VALLADOLID","ESPAÑOLES",1,1,2
" 10","BELLAVISTA-LA PALMERA","VALLADOLID","EXTRANJEROS",1,0,1
" 10","BELLAVISTA-LA PALMERA","VALLADOLID","TOTAL POBLACION",2,1,3
" 10","BELLAVISTA-LA PALMERA","ZARAGOZA","ESPAÑOLES",3,1,4
" 10","BELLAVISTA-LA PALMERA","ZARAGOZA","EXTRANJEROS",0,1,1
" 10","BELLAVISTA-LA PALMERA","ZARAGOZA","TOTAL POBLACION",3,2,5
" 11","LOS REMEDIOS","- TODOS -","ESPAÑOLES",303,291,594
" 11","LOS REMEDIOS","- TODOS -","EXTRANJEROS",22,48,70
" 11","LOS REMEDIOS","- TODOS -","TOTAL POBLACION",325,339,664
" 11","LOS REMEDIOS","ALBACETE","ESPAÑOLES",0,1,1
" 11","LOS REMEDIOS","ALBACETE","EXTRANJEROS",0,1,1
" 11","LOS REMEDIOS","ALBACETE","TOTAL POBLACION",0,2,2
" 11","LOS REMEDIOS","ALICANTE","ESPAÑOLES",2,1,3
" 11","LOS REMEDIOS","ALICANTE","EXTRANJEROS",0,2,2
" 11","LOS REMEDIOS","ALICANTE","TOTAL POBLACION",2,3,5
" 11","LOS REMEDIOS","ALMERIA","ESPAÑOLES",6,1,7
" 11","LOS REMEDIOS","ALMERIA","TOTAL POBLACION",6,1,7
" 11","LOS REMEDIOS","ASTURIAS","ESPAÑOLES",0,2,2
" 11","LOS REMEDIOS","ASTURIAS","TOTAL POBLACION",0,2,2
" 11","LOS REMEDIOS","BADAJOZ","ESPAÑOLES",5,9,14
" 11","LOS REMEDIOS","BADAJOZ","EXTRANJEROS",0,1,1
" 11","LOS REMEDIOS","BADAJOZ","TOTAL POBLACION",5,10,15
" 11","LOS REMEDIOS","BALEARES","ESPAÑOLES",3,6,9
" 11","LOS REMEDIOS","BALEARES","EXTRANJEROS",1,2,3
" 11","LOS REMEDIOS","BALEARES","TOTAL POBLACION",4,8,12
" 11","LOS REMEDIOS","BARCELONA","ESPAÑOLES",4,7,11
" 11","LOS REMEDIOS","BARCELONA","EXTRANJEROS",1,2,3
" 11","LOS REMEDIOS","BARCELONA","TOTAL POBLACION",5,9,14
" 11","LOS REMEDIOS","BIZKAIA","ESPAÑOLES",2,3,5
" 11","LOS REMEDIOS","BIZKAIA","TOTAL POBLACION",2,3,5
" 11","LOS REMEDIOS","BURGOS","EXTRANJEROS",1,0,1
" 11","LOS REMEDIOS","BURGOS","TOTAL POBLACION",1,0,1
" 11","LOS REMEDIOS","CACERES","ESPAÑOLES",1,1,2
" 11","LOS REMEDIOS","CACERES","TOTAL POBLACION",1,1,2
" 11","LOS REMEDIOS","CADIZ","ESPAÑOLES",19,13,32
" 11","LOS REMEDIOS","CADIZ","TOTAL POBLACION",19,13,32
" 11","LOS REMEDIOS","CANTABRIA","EXTRANJEROS",0,1,1
" 11","LOS REMEDIOS","CANTABRIA","TOTAL POBLACION",0,1,1
" 11","LOS REMEDIOS","CASTELLON","ESPAÑOLES",7,3,10
" 11","LOS REMEDIOS","CASTELLON","TOTAL POBLACION",7,3,10
" 11","LOS REMEDIOS","CIUDAD REAL","EXTRANJEROS",0,1,1
" 11","LOS REMEDIOS","CIUDAD REAL","TOTAL POBLACION",0,1,1
" 11","LOS REMEDIOS","CORDOBA","ESPAÑOLES",5,7,12
" 11","LOS REMEDIOS","CORDOBA","TOTAL POBLACION",5,7,12
" 11","LOS REMEDIOS","CUENCA","ESPAÑOLES",0,1,1
" 11","LOS REMEDIOS","CUENCA","TOTAL POBLACION",0,1,1
" 11","LOS REMEDIOS","EXTRAJERO","ESPAÑOLES",34,36,70
" 11","LOS REMEDIOS","EXTRAJERO","EXTRANJEROS",2,3,5
" 11","LOS REMEDIOS","EXTRAJERO","TOTAL POBLACION",36,39,75
" 11","LOS REMEDIOS","GERONA","ESPAÑOLES",0,1,1
" 11","LOS REMEDIOS","GERONA","EXTRANJEROS",1,0,1
" 11","LOS REMEDIOS","GERONA","TOTAL POBLACION",1,1,2
" 11","LOS REMEDIOS","GIPUZKOA","ESPAÑOLES",1,0,1
" 11","LOS REMEDIOS","GIPUZKOA","TOTAL POBLACION",1,0,1
" 11","LOS REMEDIOS","GRANADA","ESPAÑOLES",4,6,10
" 11","LOS REMEDIOS","GRANADA","EXTRANJEROS",0,1,1
" 11","LOS REMEDIOS","GRANADA","TOTAL POBLACION",4,7,11
" 11","LOS REMEDIOS","GUADALAJARA","ESPAÑOLES",0,1,1
" 11","LOS REMEDIOS","GUADALAJARA","TOTAL POBLACION",0,1,1
" 11","LOS REMEDIOS","HUELVA","ESPAÑOLES",6,5,11
" 11","LOS REMEDIOS","HUELVA","EXTRANJEROS",0,1,1
" 11","LOS REMEDIOS","HUELVA","TOTAL POBLACION",6,6,12
" 11","LOS REMEDIOS","HUESCA","ESPAÑOLES",1,1,2
" 11","LOS REMEDIOS","HUESCA","TOTAL POBLACION",1,1,2
" 11","LOS REMEDIOS","JAEN","ESPAÑOLES",0,1,1
" 11","LOS REMEDIOS","JAEN","TOTAL POBLACION",0,1,1
" 11","LOS REMEDIOS","LA CORUÑA","ESPAÑOLES",0,2,2
" 11","LOS REMEDIOS","LA CORUÑA","TOTAL POBLACION",0,2,2
" 11","LOS REMEDIOS","LAS PALMAS","ESPAÑOLES",5,6,11
" 11","LOS REMEDIOS","LAS PALMAS","TOTAL POBLACION",5,6,11
" 11","LOS REMEDIOS","LEON","ESPAÑOLES",2,0,2
" 11","LOS REMEDIOS","LEON","TOTAL POBLACION",2,0,2
" 11","LOS REMEDIOS","MADRID","ESPAÑOLES",32,30,62
" 11","LOS REMEDIOS","MADRID","EXTRANJEROS",3,5,8
" 11","LOS REMEDIOS","MADRID","TOTAL POBLACION",35,35,70
" 11","LOS REMEDIOS","MALAGA","ESPAÑOLES",7,13,20
" 11","LOS REMEDIOS","MALAGA","EXTRANJEROS",2,1,3
" 11","LOS REMEDIOS","MALAGA","TOTAL POBLACION",9,14,23
" 11","LOS REMEDIOS","MELILLA","ESPAÑOLES",1,0,1
" 11","LOS REMEDIOS","MELILLA","TOTAL POBLACION",1,0,1
" 11","LOS REMEDIOS","MURCIA","ESPAÑOLES",1,0,1
" 11","LOS REMEDIOS","MURCIA","EXTRANJEROS",0,1,1
" 11","LOS REMEDIOS","MURCIA","TOTAL POBLACION",1,1,2
" 11","LOS REMEDIOS","NAVARRA","ESPAÑOLES",1,0,1
" 11","LOS REMEDIOS","NAVARRA","TOTAL POBLACION",1,0,1
" 11","LOS REMEDIOS","PONTEVEDRA","ESPAÑOLES",1,1,2
" 11","LOS REMEDIOS","PONTEVEDRA","TOTAL POBLACION",1,1,2
" 11","LOS REMEDIOS","SANTA CRUZ DE TENERIFE","ESPAÑOLES",2,3,5
" 11","LOS REMEDIOS","SANTA CRUZ DE TENERIFE","TOTAL POBLACION",2,3,5
" 11","LOS REMEDIOS","SEVILLA","ESPAÑOLES",147,126,273
" 11","LOS REMEDIOS","SEVILLA","EXTRANJEROS",11,25,36
" 11","LOS REMEDIOS","SEVILLA","TOTAL POBLACION",158,151,309
" 11","LOS REMEDIOS","VALENCIA","ESPAÑOLES",2,2,4
" 11","LOS REMEDIOS","VALENCIA","EXTRANJEROS",0,1,1
" 11","LOS REMEDIOS","VALENCIA","TOTAL POBLACION",2,3,5
" 11","LOS REMEDIOS","ZAMORA","ESPAÑOLES",0,1,1
" 11","LOS REMEDIOS","ZAMORA","TOTAL POBLACION",0,1,1
" 11","LOS REMEDIOS","ZARAGOZA","ESPAÑOLES",2,1,3
" 11","LOS REMEDIOS","ZARAGOZA","TOTAL POBLACION",2,1,3
