"CD","ND","DESTINO","NACION","HOMBRES","MUJERES","TOTAL"
" 00","TOTAL MUNICIPIO","- TODOS -","ESPAÑOLES",7060,7317,14377
" 00","TOTAL MUNICIPIO","- TODOS -","EXTRANJEROS",1027,1221,2248
" 00","TOTAL MUNICIPIO","- TODOS -","NO CONSTA",5,3,8
" 00","TOTAL MUNICIPIO","- TODOS -","TOTAL POBLACION",8092,8541,16633
" 01","CASCO ANTIGUO","- TODOS -","ESPAÑOLES",685,736,1421
" 01","CASCO ANTIGUO","- TODOS -","EXTRANJEROS",109,125,234
" 01","CASCO ANTIGUO","- TODOS -","TOTAL POBLACION",794,861,1655
" 01","CASCO ANTIGUO","ALBACETE","ESPAÑOLES",1,0,1
" 01","CASCO ANTIGUO","ALBACETE","TOTAL POBLACION",1,0,1
" 01","CASCO ANTIGUO","ALICANTE","ESPAÑOLES",2,4,6
" 01","CASCO ANTIGUO","ALICANTE","EXTRANJEROS",1,0,1
" 01","CASCO ANTIGUO","ALICANTE","TOTAL POBLACION",3,4,7
" 01","CASCO ANTIGUO","ALMERIA","ESPAÑOLES",4,4,8
" 01","CASCO ANTIGUO","ALMERIA","EXTRANJEROS",2,1,3
" 01","CASCO ANTIGUO","ALMERIA","TOTAL POBLACION",6,5,11
" 01","CASCO ANTIGUO","ARABA/ALAVA","ESPAÑOLES",0,2,2
" 01","CASCO ANTIGUO","ARABA/ALAVA","EXTRANJEROS",1,0,1
" 01","CASCO ANTIGUO","ARABA/ALAVA","TOTAL POBLACION",1,2,3
" 01","CASCO ANTIGUO","ASTURIAS","ESPAÑOLES",1,3,4
" 01","CASCO ANTIGUO","ASTURIAS","TOTAL POBLACION",1,3,4
" 01","CASCO ANTIGUO","AVILA","ESPAÑOLES",3,2,5
" 01","CASCO ANTIGUO","AVILA","TOTAL POBLACION",3,2,5
" 01","CASCO ANTIGUO","BADAJOZ","ESPAÑOLES",11,11,22
" 01","CASCO ANTIGUO","BADAJOZ","EXTRANJEROS",1,0,1
" 01","CASCO ANTIGUO","BADAJOZ","TOTAL POBLACION",12,11,23
" 01","CASCO ANTIGUO","BALEARES","ESPAÑOLES",9,7,16
" 01","CASCO ANTIGUO","BALEARES","EXTRANJEROS",3,1,4
" 01","CASCO ANTIGUO","BALEARES","TOTAL POBLACION",12,8,20
" 01","CASCO ANTIGUO","BARCELONA","ESPAÑOLES",22,22,44
" 01","CASCO ANTIGUO","BARCELONA","EXTRANJEROS",9,15,24
" 01","CASCO ANTIGUO","BARCELONA","TOTAL POBLACION",31,37,68
" 01","CASCO ANTIGUO","BIZKAIA","ESPAÑOLES",4,11,15
" 01","CASCO ANTIGUO","BIZKAIA","TOTAL POBLACION",4,11,15
" 01","CASCO ANTIGUO","BURGOS","ESPAÑOLES",1,0,1
" 01","CASCO ANTIGUO","BURGOS","EXTRANJEROS",0,1,1
" 01","CASCO ANTIGUO","BURGOS","TOTAL POBLACION",1,1,2
" 01","CASCO ANTIGUO","CACERES","ESPAÑOLES",3,2,5
" 01","CASCO ANTIGUO","CACERES","EXTRANJEROS",3,0,3
" 01","CASCO ANTIGUO","CACERES","TOTAL POBLACION",6,2,8
" 01","CASCO ANTIGUO","CADIZ","ESPAÑOLES",44,61,105
" 01","CASCO ANTIGUO","CADIZ","EXTRANJEROS",5,6,11
" 01","CASCO ANTIGUO","CADIZ","TOTAL POBLACION",49,67,116
" 01","CASCO ANTIGUO","CANTABRIA","ESPAÑOLES",2,1,3
" 01","CASCO ANTIGUO","CANTABRIA","EXTRANJEROS",1,1,2
" 01","CASCO ANTIGUO","CANTABRIA","TOTAL POBLACION",3,2,5
" 01","CASCO ANTIGUO","CASTELLON","ESPAÑOLES",2,2,4
" 01","CASCO ANTIGUO","CASTELLON","EXTRANJEROS",0,1,1
" 01","CASCO ANTIGUO","CASTELLON","TOTAL POBLACION",2,3,5
" 01","CASCO ANTIGUO","CEUTA","ESPAÑOLES",6,3,9
" 01","CASCO ANTIGUO","CEUTA","TOTAL POBLACION",6,3,9
" 01","CASCO ANTIGUO","CIUDAD REAL","ESPAÑOLES",2,1,3
" 01","CASCO ANTIGUO","CIUDAD REAL","TOTAL POBLACION",2,1,3
" 01","CASCO ANTIGUO","CORDOBA","ESPAÑOLES",7,11,18
" 01","CASCO ANTIGUO","CORDOBA","EXTRANJEROS",1,3,4
" 01","CASCO ANTIGUO","CORDOBA","TOTAL POBLACION",8,14,22
" 01","CASCO ANTIGUO","CUENCA","EXTRANJEROS",1,0,1
" 01","CASCO ANTIGUO","CUENCA","TOTAL POBLACION",1,0,1
" 01","CASCO ANTIGUO","EXTRAJERO","ESPAÑOLES",70,76,146
" 01","CASCO ANTIGUO","EXTRAJERO","EXTRANJEROS",19,17,36
" 01","CASCO ANTIGUO","EXTRAJERO","TOTAL POBLACION",89,93,182
" 01","CASCO ANTIGUO","GERONA","ESPAÑOLES",0,1,1
" 01","CASCO ANTIGUO","GERONA","TOTAL POBLACION",0,1,1
" 01","CASCO ANTIGUO","GIPUZKOA","ESPAÑOLES",2,4,6
" 01","CASCO ANTIGUO","GIPUZKOA","EXTRANJEROS",5,2,7
" 01","CASCO ANTIGUO","GIPUZKOA","TOTAL POBLACION",7,6,13
" 01","CASCO ANTIGUO","GRANADA","ESPAÑOLES",7,17,24
" 01","CASCO ANTIGUO","GRANADA","EXTRANJEROS",2,3,5
" 01","CASCO ANTIGUO","GRANADA","TOTAL POBLACION",9,20,29
" 01","CASCO ANTIGUO","GUADALAJARA","ESPAÑOLES",1,0,1
" 01","CASCO ANTIGUO","GUADALAJARA","TOTAL POBLACION",1,0,1
" 01","CASCO ANTIGUO","HUELVA","ESPAÑOLES",47,32,79
" 01","CASCO ANTIGUO","HUELVA","EXTRANJEROS",3,1,4
" 01","CASCO ANTIGUO","HUELVA","TOTAL POBLACION",50,33,83
" 01","CASCO ANTIGUO","JAEN","ESPAÑOLES",5,3,8
" 01","CASCO ANTIGUO","JAEN","EXTRANJEROS",0,1,1
" 01","CASCO ANTIGUO","JAEN","TOTAL POBLACION",5,4,9
" 01","CASCO ANTIGUO","LA CORUÑA","ESPAÑOLES",3,5,8
" 01","CASCO ANTIGUO","LA CORUÑA","TOTAL POBLACION",3,5,8
" 01","CASCO ANTIGUO","LA RIOJA","ESPAÑOLES",2,0,2
" 01","CASCO ANTIGUO","LA RIOJA","EXTRANJEROS",0,1,1
" 01","CASCO ANTIGUO","LA RIOJA","TOTAL POBLACION",2,1,3
" 01","CASCO ANTIGUO","LAS PALMAS","ESPAÑOLES",8,10,18
" 01","CASCO ANTIGUO","LAS PALMAS","TOTAL POBLACION",8,10,18
" 01","CASCO ANTIGUO","LEON","ESPAÑOLES",1,2,3
" 01","CASCO ANTIGUO","LEON","TOTAL POBLACION",1,2,3
" 01","CASCO ANTIGUO","LLEIDA","ESPAÑOLES",1,0,1
" 01","CASCO ANTIGUO","LLEIDA","EXTRANJEROS",1,1,2
" 01","CASCO ANTIGUO","LLEIDA","TOTAL POBLACION",2,1,3
" 01","CASCO ANTIGUO","LUGO","ESPAÑOLES",0,1,1
" 01","CASCO ANTIGUO","LUGO","TOTAL POBLACION",0,1,1
" 01","CASCO ANTIGUO","MADRID","ESPAÑOLES",80,85,165
" 01","CASCO ANTIGUO","MADRID","EXTRANJEROS",13,14,27
" 01","CASCO ANTIGUO","MADRID","TOTAL POBLACION",93,99,192
" 01","CASCO ANTIGUO","MALAGA","ESPAÑOLES",29,30,59
" 01","CASCO ANTIGUO","MALAGA","EXTRANJEROS",3,12,15
" 01","CASCO ANTIGUO","MALAGA","TOTAL POBLACION",32,42,74
" 01","CASCO ANTIGUO","MELILLA","ESPAÑOLES",1,1,2
" 01","CASCO ANTIGUO","MELILLA","TOTAL POBLACION",1,1,2
" 01","CASCO ANTIGUO","MURCIA","ESPAÑOLES",3,2,5
" 01","CASCO ANTIGUO","MURCIA","EXTRANJEROS",1,1,2
" 01","CASCO ANTIGUO","MURCIA","TOTAL POBLACION",4,3,7
" 01","CASCO ANTIGUO","NAVARRA","ESPAÑOLES",2,3,5
" 01","CASCO ANTIGUO","NAVARRA","EXTRANJEROS",0,1,1
" 01","CASCO ANTIGUO","NAVARRA","TOTAL POBLACION",2,4,6
" 01","CASCO ANTIGUO","ORENSE","ESPAÑOLES",1,0,1
" 01","CASCO ANTIGUO","ORENSE","TOTAL POBLACION",1,0,1
" 01","CASCO ANTIGUO","PALENCIA","ESPAÑOLES",1,0,1
" 01","CASCO ANTIGUO","PALENCIA","TOTAL POBLACION",1,0,1
" 01","CASCO ANTIGUO","PONTEVEDRA","ESPAÑOLES",2,2,4
" 01","CASCO ANTIGUO","PONTEVEDRA","EXTRANJEROS",1,0,1
" 01","CASCO ANTIGUO","PONTEVEDRA","TOTAL POBLACION",3,2,5
" 01","CASCO ANTIGUO","SALAMANCA","ESPAÑOLES",2,1,3
" 01","CASCO ANTIGUO","SALAMANCA","TOTAL POBLACION",2,1,3
" 01","CASCO ANTIGUO","SANTA CRUZ DE TENERIFE","ESPAÑOLES",4,9,13
" 01","CASCO ANTIGUO","SANTA CRUZ DE TENERIFE","EXTRANJEROS",4,4,8
" 01","CASCO ANTIGUO","SANTA CRUZ DE TENERIFE","TOTAL POBLACION",8,13,21
" 01","CASCO ANTIGUO","SEVILLA","ESPAÑOLES",280,301,581
" 01","CASCO ANTIGUO","SEVILLA","EXTRANJEROS",27,33,60
" 01","CASCO ANTIGUO","SEVILLA","TOTAL POBLACION",307,334,641
" 01","CASCO ANTIGUO","TARRAGONA","ESPAÑOLES",2,0,2
" 01","CASCO ANTIGUO","TARRAGONA","EXTRANJEROS",0,1,1
" 01","CASCO ANTIGUO","TARRAGONA","TOTAL POBLACION",2,1,3
" 01","CASCO ANTIGUO","TOLEDO","ESPAÑOLES",4,0,4
" 01","CASCO ANTIGUO","TOLEDO","EXTRANJEROS",1,0,1
" 01","CASCO ANTIGUO","TOLEDO","TOTAL POBLACION",5,0,5
" 01","CASCO ANTIGUO","VALENCIA","ESPAÑOLES",2,3,5
" 01","CASCO ANTIGUO","VALENCIA","EXTRANJEROS",0,2,2
" 01","CASCO ANTIGUO","VALENCIA","TOTAL POBLACION",2,5,7
" 01","CASCO ANTIGUO","VALLADOLID","EXTRANJEROS",1,0,1
" 01","CASCO ANTIGUO","VALLADOLID","TOTAL POBLACION",1,0,1
" 01","CASCO ANTIGUO","ZAMORA","ESPAÑOLES",0,1,1
" 01","CASCO ANTIGUO","ZAMORA","EXTRANJEROS",0,1,1
" 01","CASCO ANTIGUO","ZAMORA","TOTAL POBLACION",0,2,2
" 01","CASCO ANTIGUO","ZARAGOZA","ESPAÑOLES",1,0,1
" 01","CASCO ANTIGUO","ZARAGOZA","EXTRANJEROS",0,1,1
" 01","CASCO ANTIGUO","ZARAGOZA","TOTAL POBLACION",1,1,2
" 02","MACARENA","- TODOS -","ESPAÑOLES",823,800,1623
" 02","MACARENA","- TODOS -","EXTRANJEROS",190,196,386
" 02","MACARENA","- TODOS -","NO CONSTA",2,0,2
" 02","MACARENA","- TODOS -","TOTAL POBLACION",1015,996,2011
" 02","MACARENA","ALICANTE","ESPAÑOLES",4,8,12
" 02","MACARENA","ALICANTE","EXTRANJEROS",2,1,3
" 02","MACARENA","ALICANTE","TOTAL POBLACION",6,9,15
" 02","MACARENA","ALMERIA","ESPAÑOLES",6,5,11
" 02","MACARENA","ALMERIA","EXTRANJEROS",2,2,4
" 02","MACARENA","ALMERIA","TOTAL POBLACION",8,7,15
" 02","MACARENA","ARABA/ALAVA","ESPAÑOLES",1,2,3
" 02","MACARENA","ARABA/ALAVA","EXTRANJEROS",1,0,1
" 02","MACARENA","ARABA/ALAVA","TOTAL POBLACION",2,2,4
" 02","MACARENA","ASTURIAS","ESPAÑOLES",3,0,3
" 02","MACARENA","ASTURIAS","TOTAL POBLACION",3,0,3
" 02","MACARENA","AVILA","ESPAÑOLES",0,2,2
" 02","MACARENA","AVILA","EXTRANJEROS",1,1,2
" 02","MACARENA","AVILA","TOTAL POBLACION",1,3,4
" 02","MACARENA","BADAJOZ","ESPAÑOLES",19,11,30
" 02","MACARENA","BADAJOZ","EXTRANJEROS",1,2,3
" 02","MACARENA","BADAJOZ","TOTAL POBLACION",20,13,33
" 02","MACARENA","BALEARES","ESPAÑOLES",28,19,47
" 02","MACARENA","BALEARES","EXTRANJEROS",10,5,15
" 02","MACARENA","BALEARES","TOTAL POBLACION",38,24,62
" 02","MACARENA","BARCELONA","ESPAÑOLES",20,28,48
" 02","MACARENA","BARCELONA","EXTRANJEROS",13,12,25
" 02","MACARENA","BARCELONA","TOTAL POBLACION",33,40,73
" 02","MACARENA","BIZKAIA","ESPAÑOLES",8,2,10
" 02","MACARENA","BIZKAIA","EXTRANJEROS",6,6,12
" 02","MACARENA","BIZKAIA","TOTAL POBLACION",14,8,22
" 02","MACARENA","BURGOS","ESPAÑOLES",1,0,1
" 02","MACARENA","BURGOS","EXTRANJEROS",0,2,2
" 02","MACARENA","BURGOS","TOTAL POBLACION",1,2,3
" 02","MACARENA","CACERES","ESPAÑOLES",0,1,1
" 02","MACARENA","CACERES","EXTRANJEROS",1,1,2
" 02","MACARENA","CACERES","TOTAL POBLACION",1,2,3
" 02","MACARENA","CADIZ","ESPAÑOLES",34,36,70
" 02","MACARENA","CADIZ","EXTRANJEROS",5,9,14
" 02","MACARENA","CADIZ","TOTAL POBLACION",39,45,84
" 02","MACARENA","CANTABRIA","ESPAÑOLES",5,4,9
" 02","MACARENA","CANTABRIA","EXTRANJEROS",2,1,3
" 02","MACARENA","CANTABRIA","TOTAL POBLACION",7,5,12
" 02","MACARENA","CASTELLON","ESPAÑOLES",1,1,2
" 02","MACARENA","CASTELLON","TOTAL POBLACION",1,1,2
" 02","MACARENA","CEUTA","ESPAÑOLES",1,0,1
" 02","MACARENA","CEUTA","TOTAL POBLACION",1,0,1
" 02","MACARENA","CIUDAD REAL","ESPAÑOLES",4,3,7
" 02","MACARENA","CIUDAD REAL","EXTRANJEROS",0,1,1
" 02","MACARENA","CIUDAD REAL","TOTAL POBLACION",4,4,8
" 02","MACARENA","CORDOBA","ESPAÑOLES",8,13,21
" 02","MACARENA","CORDOBA","EXTRANJEROS",2,4,6
" 02","MACARENA","CORDOBA","TOTAL POBLACION",10,17,27
" 02","MACARENA","EXTRAJERO","ESPAÑOLES",87,80,167
" 02","MACARENA","EXTRAJERO","EXTRANJEROS",12,6,18
" 02","MACARENA","EXTRAJERO","TOTAL POBLACION",99,86,185
" 02","MACARENA","GERONA","ESPAÑOLES",4,2,6
" 02","MACARENA","GERONA","TOTAL POBLACION",4,2,6
" 02","MACARENA","GIPUZKOA","ESPAÑOLES",2,2,4
" 02","MACARENA","GIPUZKOA","EXTRANJEROS",3,0,3
" 02","MACARENA","GIPUZKOA","TOTAL POBLACION",5,2,7
" 02","MACARENA","GRANADA","ESPAÑOLES",6,6,12
" 02","MACARENA","GRANADA","EXTRANJEROS",4,1,5
" 02","MACARENA","GRANADA","TOTAL POBLACION",10,7,17
" 02","MACARENA","GUADALAJARA","ESPAÑOLES",0,1,1
" 02","MACARENA","GUADALAJARA","TOTAL POBLACION",0,1,1
" 02","MACARENA","HUELVA","ESPAÑOLES",23,37,60
" 02","MACARENA","HUELVA","EXTRANJEROS",8,5,13
" 02","MACARENA","HUELVA","NO CONSTA",1,0,1
" 02","MACARENA","HUELVA","TOTAL POBLACION",32,42,74
" 02","MACARENA","HUESCA","ESPAÑOLES",2,0,2
" 02","MACARENA","HUESCA","TOTAL POBLACION",2,0,2
" 02","MACARENA","JAEN","ESPAÑOLES",4,3,7
" 02","MACARENA","JAEN","EXTRANJEROS",2,1,3
" 02","MACARENA","JAEN","TOTAL POBLACION",6,4,10
" 02","MACARENA","LA CORUÑA","ESPAÑOLES",4,2,6
" 02","MACARENA","LA CORUÑA","EXTRANJEROS",1,0,1
" 02","MACARENA","LA CORUÑA","TOTAL POBLACION",5,2,7
" 02","MACARENA","LA RIOJA","ESPAÑOLES",1,1,2
" 02","MACARENA","LA RIOJA","EXTRANJEROS",1,0,1
" 02","MACARENA","LA RIOJA","TOTAL POBLACION",2,1,3
" 02","MACARENA","LAS PALMAS","ESPAÑOLES",15,14,29
" 02","MACARENA","LAS PALMAS","EXTRANJEROS",2,0,2
" 02","MACARENA","LAS PALMAS","TOTAL POBLACION",17,14,31
" 02","MACARENA","LEON","ESPAÑOLES",1,0,1
" 02","MACARENA","LEON","TOTAL POBLACION",1,0,1
" 02","MACARENA","LUGO","EXTRANJEROS",0,1,1
" 02","MACARENA","LUGO","TOTAL POBLACION",0,1,1
" 02","MACARENA","MADRID","ESPAÑOLES",66,34,100
" 02","MACARENA","MADRID","EXTRANJEROS",26,27,53
" 02","MACARENA","MADRID","TOTAL POBLACION",92,61,153
" 02","MACARENA","MALAGA","ESPAÑOLES",22,17,39
" 02","MACARENA","MALAGA","EXTRANJEROS",7,8,15
" 02","MACARENA","MALAGA","TOTAL POBLACION",29,25,54
" 02","MACARENA","MELILLA","ESPAÑOLES",3,4,7
" 02","MACARENA","MELILLA","TOTAL POBLACION",3,4,7
" 02","MACARENA","MURCIA","ESPAÑOLES",7,11,18
" 02","MACARENA","MURCIA","EXTRANJEROS",5,1,6
" 02","MACARENA","MURCIA","TOTAL POBLACION",12,12,24
" 02","MACARENA","NAVARRA","ESPAÑOLES",5,4,9
" 02","MACARENA","NAVARRA","EXTRANJEROS",5,4,9
" 02","MACARENA","NAVARRA","TOTAL POBLACION",10,8,18
" 02","MACARENA","ORENSE","ESPAÑOLES",0,1,1
" 02","MACARENA","ORENSE","TOTAL POBLACION",0,1,1
" 02","MACARENA","PONTEVEDRA","ESPAÑOLES",3,0,3
" 02","MACARENA","PONTEVEDRA","EXTRANJEROS",1,1,2
" 02","MACARENA","PONTEVEDRA","TOTAL POBLACION",4,1,5
" 02","MACARENA","SALAMANCA","ESPAÑOLES",2,2,4
" 02","MACARENA","SALAMANCA","TOTAL POBLACION",2,2,4
" 02","MACARENA","SANTA CRUZ DE TENERIFE","ESPAÑOLES",7,5,12
" 02","MACARENA","SANTA CRUZ DE TENERIFE","EXTRANJEROS",5,2,7
" 02","MACARENA","SANTA CRUZ DE TENERIFE","TOTAL POBLACION",12,7,19
" 02","MACARENA","SEGOVIA","ESPAÑOLES",2,0,2
" 02","MACARENA","SEGOVIA","TOTAL POBLACION",2,0,2
" 02","MACARENA","SEVILLA","ESPAÑOLES",395,415,810
" 02","MACARENA","SEVILLA","EXTRANJEROS",47,78,125
" 02","MACARENA","SEVILLA","NO CONSTA",1,0,1
" 02","MACARENA","SEVILLA","TOTAL POBLACION",443,493,936
" 02","MACARENA","SORIA","EXTRANJEROS",1,1,2
" 02","MACARENA","SORIA","TOTAL POBLACION",1,1,2
" 02","MACARENA","TARRAGONA","ESPAÑOLES",1,0,1
" 02","MACARENA","TARRAGONA","EXTRANJEROS",1,2,3
" 02","MACARENA","TARRAGONA","TOTAL POBLACION",2,2,4
" 02","MACARENA","TERUEL","ESPAÑOLES",2,2,4
" 02","MACARENA","TERUEL","TOTAL POBLACION",2,2,4
" 02","MACARENA","TOLEDO","ESPAÑOLES",1,3,4
" 02","MACARENA","TOLEDO","EXTRANJEROS",0,1,1
" 02","MACARENA","TOLEDO","TOTAL POBLACION",1,4,5
" 02","MACARENA","VALENCIA","ESPAÑOLES",11,15,26
" 02","MACARENA","VALENCIA","EXTRANJEROS",7,6,13
" 02","MACARENA","VALENCIA","TOTAL POBLACION",18,21,39
" 02","MACARENA","VALLADOLID","ESPAÑOLES",0,1,1
" 02","MACARENA","VALLADOLID","EXTRANJEROS",2,0,2
" 02","MACARENA","VALLADOLID","TOTAL POBLACION",2,1,3
" 02","MACARENA","ZAMORA","EXTRANJEROS",1,0,1
" 02","MACARENA","ZAMORA","TOTAL POBLACION",1,0,1
" 02","MACARENA","ZARAGOZA","ESPAÑOLES",4,3,7
" 02","MACARENA","ZARAGOZA","EXTRANJEROS",3,4,7
" 02","MACARENA","ZARAGOZA","TOTAL POBLACION",7,7,14
" 03","NERVION","- TODOS -","ESPAÑOLES",513,542,1055
" 03","NERVION","- TODOS -","EXTRANJEROS",57,68,125
" 03","NERVION","- TODOS -","TOTAL POBLACION",570,610,1180
" 03","NERVION","ALICANTE","ESPAÑOLES",2,5,7
" 03","NERVION","ALICANTE","EXTRANJEROS",2,3,5
" 03","NERVION","ALICANTE","TOTAL POBLACION",4,8,12
" 03","NERVION","ALMERIA","ESPAÑOLES",3,6,9
" 03","NERVION","ALMERIA","TOTAL POBLACION",3,6,9
" 03","NERVION","ARABA/ALAVA","ESPAÑOLES",0,1,1
" 03","NERVION","ARABA/ALAVA","EXTRANJEROS",0,1,1
" 03","NERVION","ARABA/ALAVA","TOTAL POBLACION",0,2,2
" 03","NERVION","ASTURIAS","ESPAÑOLES",2,3,5
" 03","NERVION","ASTURIAS","TOTAL POBLACION",2,3,5
" 03","NERVION","BADAJOZ","ESPAÑOLES",11,9,20
" 03","NERVION","BADAJOZ","TOTAL POBLACION",11,9,20
" 03","NERVION","BALEARES","ESPAÑOLES",11,13,24
" 03","NERVION","BALEARES","EXTRANJEROS",1,0,1
" 03","NERVION","BALEARES","TOTAL POBLACION",12,13,25
" 03","NERVION","BARCELONA","ESPAÑOLES",18,24,42
" 03","NERVION","BARCELONA","EXTRANJEROS",7,5,12
" 03","NERVION","BARCELONA","TOTAL POBLACION",25,29,54
" 03","NERVION","BIZKAIA","ESPAÑOLES",1,3,4
" 03","NERVION","BIZKAIA","TOTAL POBLACION",1,3,4
" 03","NERVION","BURGOS","ESPAÑOLES",0,1,1
" 03","NERVION","BURGOS","TOTAL POBLACION",0,1,1
" 03","NERVION","CACERES","ESPAÑOLES",2,3,5
" 03","NERVION","CACERES","EXTRANJEROS",1,0,1
" 03","NERVION","CACERES","TOTAL POBLACION",3,3,6
" 03","NERVION","CADIZ","ESPAÑOLES",40,37,77
" 03","NERVION","CADIZ","EXTRANJEROS",2,3,5
" 03","NERVION","CADIZ","TOTAL POBLACION",42,40,82
" 03","NERVION","CEUTA","ESPAÑOLES",1,0,1
" 03","NERVION","CEUTA","TOTAL POBLACION",1,0,1
" 03","NERVION","CIUDAD REAL","EXTRANJEROS",2,1,3
" 03","NERVION","CIUDAD REAL","TOTAL POBLACION",2,1,3
" 03","NERVION","CORDOBA","ESPAÑOLES",12,12,24
" 03","NERVION","CORDOBA","EXTRANJEROS",1,0,1
" 03","NERVION","CORDOBA","TOTAL POBLACION",13,12,25
" 03","NERVION","EXTRAJERO","ESPAÑOLES",48,34,82
" 03","NERVION","EXTRAJERO","EXTRANJEROS",2,7,9
" 03","NERVION","EXTRAJERO","TOTAL POBLACION",50,41,91
" 03","NERVION","GERONA","ESPAÑOLES",0,1,1
" 03","NERVION","GERONA","TOTAL POBLACION",0,1,1
" 03","NERVION","GIPUZKOA","ESPAÑOLES",1,1,2
" 03","NERVION","GIPUZKOA","TOTAL POBLACION",1,1,2
" 03","NERVION","GRANADA","ESPAÑOLES",12,19,31
" 03","NERVION","GRANADA","EXTRANJEROS",2,0,2
" 03","NERVION","GRANADA","TOTAL POBLACION",14,19,33
" 03","NERVION","GUADALAJARA","ESPAÑOLES",0,1,1
" 03","NERVION","GUADALAJARA","TOTAL POBLACION",0,1,1
" 03","NERVION","HUELVA","ESPAÑOLES",21,18,39
" 03","NERVION","HUELVA","EXTRANJEROS",2,1,3
" 03","NERVION","HUELVA","TOTAL POBLACION",23,19,42
" 03","NERVION","JAEN","ESPAÑOLES",5,4,9
" 03","NERVION","JAEN","TOTAL POBLACION",5,4,9
" 03","NERVION","LA CORUÑA","ESPAÑOLES",0,1,1
" 03","NERVION","LA CORUÑA","TOTAL POBLACION",0,1,1
" 03","NERVION","LA RIOJA","ESPAÑOLES",0,1,1
" 03","NERVION","LA RIOJA","TOTAL POBLACION",0,1,1
" 03","NERVION","LAS PALMAS","ESPAÑOLES",8,9,17
" 03","NERVION","LAS PALMAS","EXTRANJEROS",1,1,2
" 03","NERVION","LAS PALMAS","TOTAL POBLACION",9,10,19
" 03","NERVION","LLEIDA","ESPAÑOLES",1,2,3
" 03","NERVION","LLEIDA","TOTAL POBLACION",1,2,3
" 03","NERVION","MADRID","ESPAÑOLES",68,79,147
" 03","NERVION","MADRID","EXTRANJEROS",14,13,27
" 03","NERVION","MADRID","TOTAL POBLACION",82,92,174
" 03","NERVION","MALAGA","ESPAÑOLES",19,25,44
" 03","NERVION","MALAGA","EXTRANJEROS",1,5,6
" 03","NERVION","MALAGA","TOTAL POBLACION",20,30,50
" 03","NERVION","MELILLA","ESPAÑOLES",2,2,4
" 03","NERVION","MELILLA","TOTAL POBLACION",2,2,4
" 03","NERVION","MURCIA","ESPAÑOLES",2,2,4
" 03","NERVION","MURCIA","EXTRANJEROS",0,3,3
" 03","NERVION","MURCIA","TOTAL POBLACION",2,5,7
" 03","NERVION","NAVARRA","ESPAÑOLES",1,1,2
" 03","NERVION","NAVARRA","TOTAL POBLACION",1,1,2
" 03","NERVION","PONTEVEDRA","ESPAÑOLES",1,1,2
" 03","NERVION","PONTEVEDRA","TOTAL POBLACION",1,1,2
" 03","NERVION","SALAMANCA","ESPAÑOLES",2,1,3
" 03","NERVION","SALAMANCA","EXTRANJEROS",1,0,1
" 03","NERVION","SALAMANCA","TOTAL POBLACION",3,1,4
" 03","NERVION","SANTA CRUZ DE TENERIFE","ESPAÑOLES",8,8,16
" 03","NERVION","SANTA CRUZ DE TENERIFE","EXTRANJEROS",1,0,1
" 03","NERVION","SANTA CRUZ DE TENERIFE","TOTAL POBLACION",9,8,17
" 03","NERVION","SEVILLA","ESPAÑOLES",199,193,392
" 03","NERVION","SEVILLA","EXTRANJEROS",15,21,36
" 03","NERVION","SEVILLA","TOTAL POBLACION",214,214,428
" 03","NERVION","TARRAGONA","ESPAÑOLES",1,2,3
" 03","NERVION","TARRAGONA","EXTRANJEROS",0,1,1
" 03","NERVION","TARRAGONA","TOTAL POBLACION",1,3,4
" 03","NERVION","TOLEDO","ESPAÑOLES",0,3,3
" 03","NERVION","TOLEDO","TOTAL POBLACION",0,3,3
" 03","NERVION","VALENCIA","ESPAÑOLES",7,8,15
" 03","NERVION","VALENCIA","EXTRANJEROS",2,3,5
" 03","NERVION","VALENCIA","TOTAL POBLACION",9,11,20
" 03","NERVION","VALLADOLID","ESPAÑOLES",1,6,7
" 03","NERVION","VALLADOLID","TOTAL POBLACION",1,6,7
" 03","NERVION","ZARAGOZA","ESPAÑOLES",3,3,6
" 03","NERVION","ZARAGOZA","TOTAL POBLACION",3,3,6
" 04","CERRO-AMATE","- TODOS -","ESPAÑOLES",850,869,1719
" 04","CERRO-AMATE","- TODOS -","EXTRANJEROS",170,217,387
" 04","CERRO-AMATE","- TODOS -","TOTAL POBLACION",1020,1086,2106
" 04","CERRO-AMATE","ALBACETE","ESPAÑOLES",6,6,12
" 04","CERRO-AMATE","ALBACETE","EXTRANJEROS",2,2,4
" 04","CERRO-AMATE","ALBACETE","TOTAL POBLACION",8,8,16
" 04","CERRO-AMATE","ALICANTE","ESPAÑOLES",14,9,23
" 04","CERRO-AMATE","ALICANTE","EXTRANJEROS",4,4,8
" 04","CERRO-AMATE","ALICANTE","TOTAL POBLACION",18,13,31
" 04","CERRO-AMATE","ALMERIA","ESPAÑOLES",6,8,14
" 04","CERRO-AMATE","ALMERIA","EXTRANJEROS",1,2,3
" 04","CERRO-AMATE","ALMERIA","TOTAL POBLACION",7,10,17
" 04","CERRO-AMATE","ARABA/ALAVA","ESPAÑOLES",0,1,1
" 04","CERRO-AMATE","ARABA/ALAVA","EXTRANJEROS",2,0,2
" 04","CERRO-AMATE","ARABA/ALAVA","TOTAL POBLACION",2,1,3
" 04","CERRO-AMATE","ASTURIAS","ESPAÑOLES",4,0,4
" 04","CERRO-AMATE","ASTURIAS","EXTRANJEROS",1,1,2
" 04","CERRO-AMATE","ASTURIAS","TOTAL POBLACION",5,1,6
" 04","CERRO-AMATE","AVILA","ESPAÑOLES",1,1,2
" 04","CERRO-AMATE","AVILA","TOTAL POBLACION",1,1,2
" 04","CERRO-AMATE","BADAJOZ","ESPAÑOLES",13,4,17
" 04","CERRO-AMATE","BADAJOZ","EXTRANJEROS",1,5,6
" 04","CERRO-AMATE","BADAJOZ","TOTAL POBLACION",14,9,23
" 04","CERRO-AMATE","BALEARES","ESPAÑOLES",22,14,36
" 04","CERRO-AMATE","BALEARES","EXTRANJEROS",6,1,7
" 04","CERRO-AMATE","BALEARES","TOTAL POBLACION",28,15,43
" 04","CERRO-AMATE","BARCELONA","ESPAÑOLES",15,18,33
" 04","CERRO-AMATE","BARCELONA","EXTRANJEROS",13,14,27
" 04","CERRO-AMATE","BARCELONA","TOTAL POBLACION",28,32,60
" 04","CERRO-AMATE","BIZKAIA","ESPAÑOLES",4,2,6
" 04","CERRO-AMATE","BIZKAIA","EXTRANJEROS",3,2,5
" 04","CERRO-AMATE","BIZKAIA","TOTAL POBLACION",7,4,11
" 04","CERRO-AMATE","BURGOS","ESPAÑOLES",2,2,4
" 04","CERRO-AMATE","BURGOS","EXTRANJEROS",0,1,1
" 04","CERRO-AMATE","BURGOS","TOTAL POBLACION",2,3,5
" 04","CERRO-AMATE","CACERES","ESPAÑOLES",1,1,2
" 04","CERRO-AMATE","CACERES","EXTRANJEROS",0,1,1
" 04","CERRO-AMATE","CACERES","TOTAL POBLACION",1,2,3
" 04","CERRO-AMATE","CADIZ","ESPAÑOLES",31,28,59
" 04","CERRO-AMATE","CADIZ","EXTRANJEROS",8,10,18
" 04","CERRO-AMATE","CADIZ","TOTAL POBLACION",39,38,77
" 04","CERRO-AMATE","CANTABRIA","ESPAÑOLES",2,2,4
" 04","CERRO-AMATE","CANTABRIA","EXTRANJEROS",2,1,3
" 04","CERRO-AMATE","CANTABRIA","TOTAL POBLACION",4,3,7
" 04","CERRO-AMATE","CASTELLON","ESPAÑOLES",3,1,4
" 04","CERRO-AMATE","CASTELLON","EXTRANJEROS",1,1,2
" 04","CERRO-AMATE","CASTELLON","TOTAL POBLACION",4,2,6
" 04","CERRO-AMATE","CEUTA","ESPAÑOLES",3,2,5
" 04","CERRO-AMATE","CEUTA","EXTRANJEROS",0,2,2
" 04","CERRO-AMATE","CEUTA","TOTAL POBLACION",3,4,7
" 04","CERRO-AMATE","CIUDAD REAL","ESPAÑOLES",1,1,2
" 04","CERRO-AMATE","CIUDAD REAL","TOTAL POBLACION",1,1,2
" 04","CERRO-AMATE","CORDOBA","ESPAÑOLES",6,3,9
" 04","CERRO-AMATE","CORDOBA","EXTRANJEROS",1,3,4
" 04","CERRO-AMATE","CORDOBA","TOTAL POBLACION",7,6,13
" 04","CERRO-AMATE","EXTRAJERO","ESPAÑOLES",55,56,111
" 04","CERRO-AMATE","EXTRAJERO","EXTRANJEROS",4,10,14
" 04","CERRO-AMATE","EXTRAJERO","TOTAL POBLACION",59,66,125
" 04","CERRO-AMATE","GERONA","ESPAÑOLES",2,1,3
" 04","CERRO-AMATE","GERONA","EXTRANJEROS",1,1,2
" 04","CERRO-AMATE","GERONA","TOTAL POBLACION",3,2,5
" 04","CERRO-AMATE","GIPUZKOA","ESPAÑOLES",1,1,2
" 04","CERRO-AMATE","GIPUZKOA","EXTRANJEROS",1,1,2
" 04","CERRO-AMATE","GIPUZKOA","TOTAL POBLACION",2,2,4
" 04","CERRO-AMATE","GRANADA","ESPAÑOLES",7,8,15
" 04","CERRO-AMATE","GRANADA","EXTRANJEROS",3,1,4
" 04","CERRO-AMATE","GRANADA","TOTAL POBLACION",10,9,19
" 04","CERRO-AMATE","GUADALAJARA","ESPAÑOLES",1,2,3
" 04","CERRO-AMATE","GUADALAJARA","TOTAL POBLACION",1,2,3
" 04","CERRO-AMATE","HUELVA","ESPAÑOLES",31,33,64
" 04","CERRO-AMATE","HUELVA","EXTRANJEROS",18,17,35
" 04","CERRO-AMATE","HUELVA","TOTAL POBLACION",49,50,99
" 04","CERRO-AMATE","HUESCA","ESPAÑOLES",2,3,5
" 04","CERRO-AMATE","HUESCA","TOTAL POBLACION",2,3,5
" 04","CERRO-AMATE","JAEN","ESPAÑOLES",6,7,13
" 04","CERRO-AMATE","JAEN","EXTRANJEROS",0,2,2
" 04","CERRO-AMATE","JAEN","TOTAL POBLACION",6,9,15
" 04","CERRO-AMATE","LA CORUÑA","ESPAÑOLES",2,2,4
" 04","CERRO-AMATE","LA CORUÑA","EXTRANJEROS",1,3,4
" 04","CERRO-AMATE","LA CORUÑA","TOTAL POBLACION",3,5,8
" 04","CERRO-AMATE","LA RIOJA","ESPAÑOLES",1,2,3
" 04","CERRO-AMATE","LA RIOJA","TOTAL POBLACION",1,2,3
" 04","CERRO-AMATE","LAS PALMAS","ESPAÑOLES",39,28,67
" 04","CERRO-AMATE","LAS PALMAS","EXTRANJEROS",4,1,5
" 04","CERRO-AMATE","LAS PALMAS","TOTAL POBLACION",43,29,72
" 04","CERRO-AMATE","LEON","ESPAÑOLES",3,9,12
" 04","CERRO-AMATE","LEON","TOTAL POBLACION",3,9,12
" 04","CERRO-AMATE","LLEIDA","ESPAÑOLES",0,1,1
" 04","CERRO-AMATE","LLEIDA","EXTRANJEROS",0,1,1
" 04","CERRO-AMATE","LLEIDA","TOTAL POBLACION",0,2,2
" 04","CERRO-AMATE","MADRID","ESPAÑOLES",31,44,75
" 04","CERRO-AMATE","MADRID","EXTRANJEROS",31,27,58
" 04","CERRO-AMATE","MADRID","TOTAL POBLACION",62,71,133
" 04","CERRO-AMATE","MALAGA","ESPAÑOLES",24,27,51
" 04","CERRO-AMATE","MALAGA","EXTRANJEROS",10,13,23
" 04","CERRO-AMATE","MALAGA","TOTAL POBLACION",34,40,74
" 04","CERRO-AMATE","MELILLA","ESPAÑOLES",0,2,2
" 04","CERRO-AMATE","MELILLA","TOTAL POBLACION",0,2,2
" 04","CERRO-AMATE","MURCIA","ESPAÑOLES",3,8,11
" 04","CERRO-AMATE","MURCIA","EXTRANJEROS",3,2,5
" 04","CERRO-AMATE","MURCIA","TOTAL POBLACION",6,10,16
" 04","CERRO-AMATE","NAVARRA","ESPAÑOLES",3,5,8
" 04","CERRO-AMATE","NAVARRA","EXTRANJEROS",2,1,3
" 04","CERRO-AMATE","NAVARRA","TOTAL POBLACION",5,6,11
" 04","CERRO-AMATE","ORENSE","EXTRANJEROS",0,1,1
" 04","CERRO-AMATE","ORENSE","TOTAL POBLACION",0,1,1
" 04","CERRO-AMATE","PALENCIA","ESPAÑOLES",0,1,1
" 04","CERRO-AMATE","PALENCIA","EXTRANJEROS",0,1,1
" 04","CERRO-AMATE","PALENCIA","TOTAL POBLACION",0,2,2
" 04","CERRO-AMATE","PONTEVEDRA","ESPAÑOLES",2,3,5
" 04","CERRO-AMATE","PONTEVEDRA","EXTRANJEROS",0,1,1
" 04","CERRO-AMATE","PONTEVEDRA","TOTAL POBLACION",2,4,6
" 04","CERRO-AMATE","SALAMANCA","ESPAÑOLES",1,3,4
" 04","CERRO-AMATE","SALAMANCA","TOTAL POBLACION",1,3,4
" 04","CERRO-AMATE","SANTA CRUZ DE TENERIFE","ESPAÑOLES",12,10,22
" 04","CERRO-AMATE","SANTA CRUZ DE TENERIFE","EXTRANJEROS",2,5,7
" 04","CERRO-AMATE","SANTA CRUZ DE TENERIFE","TOTAL POBLACION",14,15,29
" 04","CERRO-AMATE","SEGOVIA","EXTRANJEROS",1,0,1
" 04","CERRO-AMATE","SEGOVIA","TOTAL POBLACION",1,0,1
" 04","CERRO-AMATE","SEVILLA","ESPAÑOLES",475,496,971
" 04","CERRO-AMATE","SEVILLA","EXTRANJEROS",37,71,108
" 04","CERRO-AMATE","SEVILLA","TOTAL POBLACION",512,567,1079
" 04","CERRO-AMATE","SORIA","ESPAÑOLES",0,2,2
" 04","CERRO-AMATE","SORIA","TOTAL POBLACION",0,2,2
" 04","CERRO-AMATE","TARRAGONA","ESPAÑOLES",4,1,5
" 04","CERRO-AMATE","TARRAGONA","EXTRANJEROS",2,0,2
" 04","CERRO-AMATE","TARRAGONA","TOTAL POBLACION",6,1,7
" 04","CERRO-AMATE","TOLEDO","ESPAÑOLES",1,5,6
" 04","CERRO-AMATE","TOLEDO","EXTRANJEROS",0,4,4
" 04","CERRO-AMATE","TOLEDO","TOTAL POBLACION",1,9,10
" 04","CERRO-AMATE","VALENCIA","ESPAÑOLES",5,4,9
" 04","CERRO-AMATE","VALENCIA","EXTRANJEROS",4,4,8
" 04","CERRO-AMATE","VALENCIA","TOTAL POBLACION",9,8,17
" 04","CERRO-AMATE","VALLADOLID","ESPAÑOLES",1,0,1
" 04","CERRO-AMATE","VALLADOLID","TOTAL POBLACION",1,0,1
" 04","CERRO-AMATE","ZAMORA","ESPAÑOLES",1,0,1
" 04","CERRO-AMATE","ZAMORA","TOTAL POBLACION",1,0,1
" 04","CERRO-AMATE","ZARAGOZA","ESPAÑOLES",3,2,5
" 04","CERRO-AMATE","ZARAGOZA","EXTRANJEROS",1,0,1
" 04","CERRO-AMATE","ZARAGOZA","TOTAL POBLACION",4,2,6
" 05","SUR","- TODOS -","ESPAÑOLES",802,823,1625
" 05","SUR","- TODOS -","EXTRANJEROS",99,131,230
" 05","SUR","- TODOS -","NO CONSTA",1,1,2
" 05","SUR","- TODOS -","TOTAL POBLACION",902,955,1857
" 05","SUR","ALBACETE","ESPAÑOLES",1,1,2
" 05","SUR","ALBACETE","TOTAL POBLACION",1,1,2
" 05","SUR","ALICANTE","ESPAÑOLES",5,12,17
" 05","SUR","ALICANTE","EXTRANJEROS",2,2,4
" 05","SUR","ALICANTE","TOTAL POBLACION",7,14,21
" 05","SUR","ALMERIA","ESPAÑOLES",9,4,13
" 05","SUR","ALMERIA","EXTRANJEROS",1,1,2
" 05","SUR","ALMERIA","TOTAL POBLACION",10,5,15
" 05","SUR","ARABA/ALAVA","ESPAÑOLES",0,2,2
" 05","SUR","ARABA/ALAVA","EXTRANJEROS",3,2,5
" 05","SUR","ARABA/ALAVA","TOTAL POBLACION",3,4,7
" 05","SUR","ASTURIAS","ESPAÑOLES",1,3,4
" 05","SUR","ASTURIAS","TOTAL POBLACION",1,3,4
" 05","SUR","BADAJOZ","ESPAÑOLES",12,17,29
" 05","SUR","BADAJOZ","EXTRANJEROS",4,2,6
" 05","SUR","BADAJOZ","TOTAL POBLACION",16,19,35
" 05","SUR","BALEARES","ESPAÑOLES",19,17,36
" 05","SUR","BALEARES","EXTRANJEROS",2,5,7
" 05","SUR","BALEARES","TOTAL POBLACION",21,22,43
" 05","SUR","BARCELONA","ESPAÑOLES",14,17,31
" 05","SUR","BARCELONA","EXTRANJEROS",4,11,15
" 05","SUR","BARCELONA","TOTAL POBLACION",18,28,46
" 05","SUR","BIZKAIA","ESPAÑOLES",4,3,7
" 05","SUR","BIZKAIA","EXTRANJEROS",2,2,4
" 05","SUR","BIZKAIA","TOTAL POBLACION",6,5,11
" 05","SUR","BURGOS","ESPAÑOLES",0,1,1
" 05","SUR","BURGOS","TOTAL POBLACION",0,1,1
" 05","SUR","CACERES","ESPAÑOLES",2,4,6
" 05","SUR","CACERES","EXTRANJEROS",1,1,2
" 05","SUR","CACERES","TOTAL POBLACION",3,5,8
" 05","SUR","CADIZ","ESPAÑOLES",47,47,94
" 05","SUR","CADIZ","EXTRANJEROS",5,7,12
" 05","SUR","CADIZ","TOTAL POBLACION",52,54,106
" 05","SUR","CANTABRIA","ESPAÑOLES",3,2,5
" 05","SUR","CANTABRIA","TOTAL POBLACION",3,2,5
" 05","SUR","CASTELLON","ESPAÑOLES",3,2,5
" 05","SUR","CASTELLON","TOTAL POBLACION",3,2,5
" 05","SUR","CEUTA","ESPAÑOLES",4,4,8
" 05","SUR","CEUTA","TOTAL POBLACION",4,4,8
" 05","SUR","CIUDAD REAL","ESPAÑOLES",1,5,6
" 05","SUR","CIUDAD REAL","EXTRANJEROS",1,0,1
" 05","SUR","CIUDAD REAL","TOTAL POBLACION",2,5,7
" 05","SUR","CORDOBA","ESPAÑOLES",19,13,32
" 05","SUR","CORDOBA","EXTRANJEROS",0,1,1
" 05","SUR","CORDOBA","TOTAL POBLACION",19,14,33
" 05","SUR","CUENCA","ESPAÑOLES",3,1,4
" 05","SUR","CUENCA","TOTAL POBLACION",3,1,4
" 05","SUR","EXTRAJERO","ESPAÑOLES",36,35,71
" 05","SUR","EXTRAJERO","EXTRANJEROS",6,6,12
" 05","SUR","EXTRAJERO","TOTAL POBLACION",42,41,83
" 05","SUR","GERONA","ESPAÑOLES",2,2,4
" 05","SUR","GERONA","TOTAL POBLACION",2,2,4
" 05","SUR","GIPUZKOA","ESPAÑOLES",4,2,6
" 05","SUR","GIPUZKOA","EXTRANJEROS",4,1,5
" 05","SUR","GIPUZKOA","TOTAL POBLACION",8,3,11
" 05","SUR","GRANADA","ESPAÑOLES",14,19,33
" 05","SUR","GRANADA","EXTRANJEROS",5,2,7
" 05","SUR","GRANADA","TOTAL POBLACION",19,21,40
" 05","SUR","HUELVA","ESPAÑOLES",19,25,44
" 05","SUR","HUELVA","EXTRANJEROS",8,6,14
" 05","SUR","HUELVA","TOTAL POBLACION",27,31,58
" 05","SUR","JAEN","ESPAÑOLES",4,3,7
" 05","SUR","JAEN","TOTAL POBLACION",4,3,7
" 05","SUR","LA CORUÑA","ESPAÑOLES",8,3,11
" 05","SUR","LA CORUÑA","EXTRANJEROS",3,1,4
" 05","SUR","LA CORUÑA","TOTAL POBLACION",11,4,15
" 05","SUR","LA RIOJA","ESPAÑOLES",1,0,1
" 05","SUR","LA RIOJA","TOTAL POBLACION",1,0,1
" 05","SUR","LAS PALMAS","ESPAÑOLES",13,15,28
" 05","SUR","LAS PALMAS","EXTRANJEROS",3,5,8
" 05","SUR","LAS PALMAS","TOTAL POBLACION",16,20,36
" 05","SUR","LEON","ESPAÑOLES",2,2,4
" 05","SUR","LEON","TOTAL POBLACION",2,2,4
" 05","SUR","LLEIDA","ESPAÑOLES",2,1,3
" 05","SUR","LLEIDA","EXTRANJEROS",0,1,1
" 05","SUR","LLEIDA","TOTAL POBLACION",2,2,4
" 05","SUR","MADRID","ESPAÑOLES",108,111,219
" 05","SUR","MADRID","EXTRANJEROS",10,17,27
" 05","SUR","MADRID","TOTAL POBLACION",118,128,246
" 05","SUR","MALAGA","ESPAÑOLES",18,30,48
" 05","SUR","MALAGA","EXTRANJEROS",5,8,13
" 05","SUR","MALAGA","TOTAL POBLACION",23,38,61
" 05","SUR","MELILLA","ESPAÑOLES",3,3,6
" 05","SUR","MELILLA","EXTRANJEROS",1,0,1
" 05","SUR","MELILLA","TOTAL POBLACION",4,3,7
" 05","SUR","MURCIA","ESPAÑOLES",1,1,2
" 05","SUR","MURCIA","EXTRANJEROS",1,2,3
" 05","SUR","MURCIA","TOTAL POBLACION",2,3,5
" 05","SUR","NAVARRA","ESPAÑOLES",1,2,3
" 05","SUR","NAVARRA","EXTRANJEROS",0,1,1
" 05","SUR","NAVARRA","TOTAL POBLACION",1,3,4
" 05","SUR","PALENCIA","ESPAÑOLES",1,2,3
" 05","SUR","PALENCIA","TOTAL POBLACION",1,2,3
" 05","SUR","PONTEVEDRA","ESPAÑOLES",3,1,4
" 05","SUR","PONTEVEDRA","EXTRANJEROS",1,0,1
" 05","SUR","PONTEVEDRA","TOTAL POBLACION",4,1,5
" 05","SUR","SALAMANCA","ESPAÑOLES",1,0,1
" 05","SUR","SALAMANCA","TOTAL POBLACION",1,0,1
" 05","SUR","SANTA CRUZ DE TENERIFE","ESPAÑOLES",8,6,14
" 05","SUR","SANTA CRUZ DE TENERIFE","EXTRANJEROS",1,1,2
" 05","SUR","SANTA CRUZ DE TENERIFE","TOTAL POBLACION",9,7,16
" 05","SUR","SEGOVIA","ESPAÑOLES",1,1,2
" 05","SUR","SEGOVIA","TOTAL POBLACION",1,1,2
" 05","SUR","SEVILLA","ESPAÑOLES",395,388,783
" 05","SUR","SEVILLA","EXTRANJEROS",15,42,57
" 05","SUR","SEVILLA","NO CONSTA",1,1,2
" 05","SUR","SEVILLA","TOTAL POBLACION",411,431,842
" 05","SUR","SORIA","ESPAÑOLES",1,1,2
" 05","SUR","SORIA","TOTAL POBLACION",1,1,2
" 05","SUR","TARRAGONA","ESPAÑOLES",1,0,1
" 05","SUR","TARRAGONA","EXTRANJEROS",2,1,3
" 05","SUR","TARRAGONA","TOTAL POBLACION",3,1,4
" 05","SUR","TERUEL","ESPAÑOLES",0,2,2
" 05","SUR","TERUEL","TOTAL POBLACION",0,2,2
" 05","SUR","TOLEDO","ESPAÑOLES",2,2,4
" 05","SUR","TOLEDO","TOTAL POBLACION",2,2,4
" 05","SUR","VALENCIA","ESPAÑOLES",3,6,9
" 05","SUR","VALENCIA","EXTRANJEROS",5,2,7
" 05","SUR","VALENCIA","TOTAL POBLACION",8,8,16
" 05","SUR","VALLADOLID","ESPAÑOLES",1,3,4
" 05","SUR","VALLADOLID","EXTRANJEROS",1,0,1
" 05","SUR","VALLADOLID","TOTAL POBLACION",2,3,5
" 05","SUR","ZAMORA","EXTRANJEROS",1,1,2
" 05","SUR","ZAMORA","TOTAL POBLACION",1,1,2
" 05","SUR","ZARAGOZA","ESPAÑOLES",2,2,4
" 05","SUR","ZARAGOZA","EXTRANJEROS",2,0,2
" 05","SUR","ZARAGOZA","TOTAL POBLACION",4,2,6
" 06","TRIANA","- TODOS -","ESPAÑOLES",541,545,1086
" 06","TRIANA","- TODOS -","EXTRANJEROS",61,87,148
" 06","TRIANA","- TODOS -","NO CONSTA",1,1,2
" 06","TRIANA","- TODOS -","TOTAL POBLACION",603,633,1236
" 06","TRIANA","ALBACETE","EXTRANJEROS",0,2,2
" 06","TRIANA","ALBACETE","TOTAL POBLACION",0,2,2
" 06","TRIANA","ALICANTE","ESPAÑOLES",3,2,5
" 06","TRIANA","ALICANTE","EXTRANJEROS",2,0,2
" 06","TRIANA","ALICANTE","TOTAL POBLACION",5,2,7
" 06","TRIANA","ALMERIA","ESPAÑOLES",1,1,2
" 06","TRIANA","ALMERIA","TOTAL POBLACION",1,1,2
" 06","TRIANA","ARABA/ALAVA","ESPAÑOLES",1,0,1
" 06","TRIANA","ARABA/ALAVA","TOTAL POBLACION",1,0,1
" 06","TRIANA","ASTURIAS","ESPAÑOLES",1,3,4
" 06","TRIANA","ASTURIAS","TOTAL POBLACION",1,3,4
" 06","TRIANA","AVILA","ESPAÑOLES",1,0,1
" 06","TRIANA","AVILA","TOTAL POBLACION",1,0,1
" 06","TRIANA","BADAJOZ","ESPAÑOLES",7,10,17
" 06","TRIANA","BADAJOZ","EXTRANJEROS",1,0,1
" 06","TRIANA","BADAJOZ","TOTAL POBLACION",8,10,18
" 06","TRIANA","BALEARES","ESPAÑOLES",9,8,17
" 06","TRIANA","BALEARES","EXTRANJEROS",2,1,3
" 06","TRIANA","BALEARES","TOTAL POBLACION",11,9,20
" 06","TRIANA","BARCELONA","ESPAÑOLES",11,14,25
" 06","TRIANA","BARCELONA","EXTRANJEROS",6,10,16
" 06","TRIANA","BARCELONA","TOTAL POBLACION",17,24,41
" 06","TRIANA","BIZKAIA","ESPAÑOLES",2,1,3
" 06","TRIANA","BIZKAIA","TOTAL POBLACION",2,1,3
" 06","TRIANA","CACERES","ESPAÑOLES",0,1,1
" 06","TRIANA","CACERES","TOTAL POBLACION",0,1,1
" 06","TRIANA","CADIZ","ESPAÑOLES",28,25,53
" 06","TRIANA","CADIZ","EXTRANJEROS",0,4,4
" 06","TRIANA","CADIZ","TOTAL POBLACION",28,29,57
" 06","TRIANA","CANTABRIA","ESPAÑOLES",1,0,1
" 06","TRIANA","CANTABRIA","EXTRANJEROS",1,0,1
" 06","TRIANA","CANTABRIA","TOTAL POBLACION",2,0,2
" 06","TRIANA","CASTELLON","ESPAÑOLES",0,1,1
" 06","TRIANA","CASTELLON","TOTAL POBLACION",0,1,1
" 06","TRIANA","CEUTA","ESPAÑOLES",2,3,5
" 06","TRIANA","CEUTA","TOTAL POBLACION",2,3,5
" 06","TRIANA","CIUDAD REAL","ESPAÑOLES",1,1,2
" 06","TRIANA","CIUDAD REAL","TOTAL POBLACION",1,1,2
" 06","TRIANA","CORDOBA","ESPAÑOLES",6,5,11
" 06","TRIANA","CORDOBA","TOTAL POBLACION",6,5,11
" 06","TRIANA","EXTRAJERO","ESPAÑOLES",31,40,71
" 06","TRIANA","EXTRAJERO","EXTRANJEROS",4,5,9
" 06","TRIANA","EXTRAJERO","TOTAL POBLACION",35,45,80
" 06","TRIANA","GERONA","ESPAÑOLES",0,2,2
" 06","TRIANA","GERONA","TOTAL POBLACION",0,2,2
" 06","TRIANA","GRANADA","ESPAÑOLES",4,4,8
" 06","TRIANA","GRANADA","TOTAL POBLACION",4,4,8
" 06","TRIANA","GUADALAJARA","ESPAÑOLES",1,0,1
" 06","TRIANA","GUADALAJARA","TOTAL POBLACION",1,0,1
" 06","TRIANA","HUELVA","ESPAÑOLES",19,16,35
" 06","TRIANA","HUELVA","EXTRANJEROS",5,4,9
" 06","TRIANA","HUELVA","TOTAL POBLACION",24,20,44
" 06","TRIANA","JAEN","ESPAÑOLES",7,7,14
" 06","TRIANA","JAEN","EXTRANJEROS",0,1,1
" 06","TRIANA","JAEN","TOTAL POBLACION",7,8,15
" 06","TRIANA","LA CORUÑA","ESPAÑOLES",3,5,8
" 06","TRIANA","LA CORUÑA","EXTRANJEROS",1,1,2
" 06","TRIANA","LA CORUÑA","TOTAL POBLACION",4,6,10
" 06","TRIANA","LA RIOJA","ESPAÑOLES",2,0,2
" 06","TRIANA","LA RIOJA","TOTAL POBLACION",2,0,2
" 06","TRIANA","LAS PALMAS","ESPAÑOLES",9,8,17
" 06","TRIANA","LAS PALMAS","EXTRANJEROS",2,2,4
" 06","TRIANA","LAS PALMAS","TOTAL POBLACION",11,10,21
" 06","TRIANA","LEON","ESPAÑOLES",3,1,4
" 06","TRIANA","LEON","TOTAL POBLACION",3,1,4
" 06","TRIANA","LLEIDA","EXTRANJEROS",1,1,2
" 06","TRIANA","LLEIDA","TOTAL POBLACION",1,1,2
" 06","TRIANA","MADRID","ESPAÑOLES",67,55,122
" 06","TRIANA","MADRID","EXTRANJEROS",8,16,24
" 06","TRIANA","MADRID","TOTAL POBLACION",75,71,146
" 06","TRIANA","MALAGA","ESPAÑOLES",16,17,33
" 06","TRIANA","MALAGA","EXTRANJEROS",1,5,6
" 06","TRIANA","MALAGA","TOTAL POBLACION",17,22,39
" 06","TRIANA","MURCIA","ESPAÑOLES",4,0,4
" 06","TRIANA","MURCIA","TOTAL POBLACION",4,0,4
" 06","TRIANA","NAVARRA","ESPAÑOLES",3,2,5
" 06","TRIANA","NAVARRA","TOTAL POBLACION",3,2,5
" 06","TRIANA","PALENCIA","EXTRANJEROS",1,0,1
" 06","TRIANA","PALENCIA","TOTAL POBLACION",1,0,1
" 06","TRIANA","PONTEVEDRA","EXTRANJEROS",0,1,1
" 06","TRIANA","PONTEVEDRA","TOTAL POBLACION",0,1,1
" 06","TRIANA","SALAMANCA","ESPAÑOLES",1,1,2
" 06","TRIANA","SALAMANCA","TOTAL POBLACION",1,1,2
" 06","TRIANA","SANTA CRUZ DE TENERIFE","ESPAÑOLES",5,7,12
" 06","TRIANA","SANTA CRUZ DE TENERIFE","TOTAL POBLACION",5,7,12
" 06","TRIANA","SEGOVIA","ESPAÑOLES",1,0,1
" 06","TRIANA","SEGOVIA","TOTAL POBLACION",1,0,1
" 06","TRIANA","SEVILLA","ESPAÑOLES",283,295,578
" 06","TRIANA","SEVILLA","EXTRANJEROS",22,30,52
" 06","TRIANA","SEVILLA","NO CONSTA",1,1,2
" 06","TRIANA","SEVILLA","TOTAL POBLACION",306,326,632
" 06","TRIANA","TARRAGONA","EXTRANJEROS",0,2,2
" 06","TRIANA","TARRAGONA","TOTAL POBLACION",0,2,2
" 06","TRIANA","TERUEL","ESPAÑOLES",1,1,2
" 06","TRIANA","TERUEL","EXTRANJEROS",1,0,1
" 06","TRIANA","TERUEL","TOTAL POBLACION",2,1,3
" 06","TRIANA","TOLEDO","ESPAÑOLES",1,1,2
" 06","TRIANA","TOLEDO","EXTRANJEROS",0,1,1
" 06","TRIANA","TOLEDO","TOTAL POBLACION",1,2,3
" 06","TRIANA","VALENCIA","ESPAÑOLES",3,2,5
" 06","TRIANA","VALENCIA","EXTRANJEROS",1,0,1
" 06","TRIANA","VALENCIA","TOTAL POBLACION",4,2,6
" 06","TRIANA","VALLADOLID","ESPAÑOLES",0,2,2
" 06","TRIANA","VALLADOLID","TOTAL POBLACION",0,2,2
" 06","TRIANA","ZARAGOZA","ESPAÑOLES",3,4,7
" 06","TRIANA","ZARAGOZA","EXTRANJEROS",2,1,3
" 06","TRIANA","ZARAGOZA","TOTAL POBLACION",5,5,10
" 07","NORTE","- TODOS -","ESPAÑOLES",566,682,1248
" 07","NORTE","- TODOS -","EXTRANJEROS",63,64,127
" 07","NORTE","- TODOS -","NO CONSTA",0,1,1
" 07","NORTE","- TODOS -","TOTAL POBLACION",629,747,1376
" 07","NORTE","ALBACETE","EXTRANJEROS",0,2,2
" 07","NORTE","ALBACETE","TOTAL POBLACION",0,2,2
" 07","NORTE","ALICANTE","ESPAÑOLES",4,4,8
" 07","NORTE","ALICANTE","EXTRANJEROS",0,3,3
" 07","NORTE","ALICANTE","TOTAL POBLACION",4,7,11
" 07","NORTE","ALMERIA","ESPAÑOLES",3,3,6
" 07","NORTE","ALMERIA","EXTRANJEROS",2,1,3
" 07","NORTE","ALMERIA","TOTAL POBLACION",5,4,9
" 07","NORTE","ARABA/ALAVA","EXTRANJEROS",2,2,4
" 07","NORTE","ARABA/ALAVA","TOTAL POBLACION",2,2,4
" 07","NORTE","ASTURIAS","ESPAÑOLES",2,0,2
" 07","NORTE","ASTURIAS","EXTRANJEROS",0,1,1
" 07","NORTE","ASTURIAS","TOTAL POBLACION",2,1,3
" 07","NORTE","AVILA","ESPAÑOLES",0,1,1
" 07","NORTE","AVILA","TOTAL POBLACION",0,1,1
" 07","NORTE","BADAJOZ","ESPAÑOLES",2,2,4
" 07","NORTE","BADAJOZ","EXTRANJEROS",1,0,1
" 07","NORTE","BADAJOZ","TOTAL POBLACION",3,2,5
" 07","NORTE","BALEARES","ESPAÑOLES",11,10,21
" 07","NORTE","BALEARES","EXTRANJEROS",5,0,5
" 07","NORTE","BALEARES","TOTAL POBLACION",16,10,26
" 07","NORTE","BARCELONA","ESPAÑOLES",20,15,35
" 07","NORTE","BARCELONA","EXTRANJEROS",3,2,5
" 07","NORTE","BARCELONA","TOTAL POBLACION",23,17,40
" 07","NORTE","BIZKAIA","ESPAÑOLES",2,0,2
" 07","NORTE","BIZKAIA","EXTRANJEROS",2,2,4
" 07","NORTE","BIZKAIA","TOTAL POBLACION",4,2,6
" 07","NORTE","CACERES","ESPAÑOLES",1,2,3
" 07","NORTE","CACERES","EXTRANJEROS",1,0,1
" 07","NORTE","CACERES","TOTAL POBLACION",2,2,4
" 07","NORTE","CADIZ","ESPAÑOLES",19,31,50
" 07","NORTE","CADIZ","EXTRANJEROS",0,2,2
" 07","NORTE","CADIZ","TOTAL POBLACION",19,33,52
" 07","NORTE","CANTABRIA","ESPAÑOLES",2,4,6
" 07","NORTE","CANTABRIA","TOTAL POBLACION",2,4,6
" 07","NORTE","CASTELLON","ESPAÑOLES",1,0,1
" 07","NORTE","CASTELLON","EXTRANJEROS",1,0,1
" 07","NORTE","CASTELLON","TOTAL POBLACION",2,0,2
" 07","NORTE","CEUTA","ESPAÑOLES",1,1,2
" 07","NORTE","CEUTA","TOTAL POBLACION",1,1,2
" 07","NORTE","CIUDAD REAL","EXTRANJEROS",0,1,1
" 07","NORTE","CIUDAD REAL","TOTAL POBLACION",0,1,1
" 07","NORTE","CORDOBA","ESPAÑOLES",7,10,17
" 07","NORTE","CORDOBA","TOTAL POBLACION",7,10,17
" 07","NORTE","CUENCA","EXTRANJEROS",1,1,2
" 07","NORTE","CUENCA","TOTAL POBLACION",1,1,2
" 07","NORTE","EXTRAJERO","ESPAÑOLES",21,37,58
" 07","NORTE","EXTRAJERO","EXTRANJEROS",1,1,2
" 07","NORTE","EXTRAJERO","TOTAL POBLACION",22,38,60
" 07","NORTE","GERONA","ESPAÑOLES",0,4,4
" 07","NORTE","GERONA","TOTAL POBLACION",0,4,4
" 07","NORTE","GIPUZKOA","ESPAÑOLES",2,1,3
" 07","NORTE","GIPUZKOA","TOTAL POBLACION",2,1,3
" 07","NORTE","GRANADA","ESPAÑOLES",0,7,7
" 07","NORTE","GRANADA","EXTRANJEROS",1,0,1
" 07","NORTE","GRANADA","TOTAL POBLACION",1,7,8
" 07","NORTE","GUADALAJARA","ESPAÑOLES",0,1,1
" 07","NORTE","GUADALAJARA","EXTRANJEROS",1,0,1
" 07","NORTE","GUADALAJARA","TOTAL POBLACION",1,1,2
" 07","NORTE","HUELVA","ESPAÑOLES",22,24,46
" 07","NORTE","HUELVA","EXTRANJEROS",5,3,8
" 07","NORTE","HUELVA","TOTAL POBLACION",27,27,54
" 07","NORTE","JAEN","ESPAÑOLES",0,5,5
" 07","NORTE","JAEN","TOTAL POBLACION",0,5,5
" 07","NORTE","LA CORUÑA","ESPAÑOLES",2,0,2
" 07","NORTE","LA CORUÑA","TOTAL POBLACION",2,0,2
" 07","NORTE","LAS PALMAS","ESPAÑOLES",15,16,31
" 07","NORTE","LAS PALMAS","TOTAL POBLACION",15,16,31
" 07","NORTE","LEON","EXTRANJEROS",0,1,1
" 07","NORTE","LEON","TOTAL POBLACION",0,1,1
" 07","NORTE","LLEIDA","ESPAÑOLES",1,0,1
" 07","NORTE","LLEIDA","TOTAL POBLACION",1,0,1
" 07","NORTE","MADRID","ESPAÑOLES",33,30,63
" 07","NORTE","MADRID","EXTRANJEROS",9,5,14
" 07","NORTE","MADRID","NO CONSTA",0,1,1
" 07","NORTE","MADRID","TOTAL POBLACION",42,36,78
" 07","NORTE","MALAGA","ESPAÑOLES",14,12,26
" 07","NORTE","MALAGA","EXTRANJEROS",6,2,8
" 07","NORTE","MALAGA","TOTAL POBLACION",20,14,34
" 07","NORTE","MELILLA","ESPAÑOLES",1,0,1
" 07","NORTE","MELILLA","TOTAL POBLACION",1,0,1
" 07","NORTE","MURCIA","ESPAÑOLES",1,6,7
" 07","NORTE","MURCIA","EXTRANJEROS",2,1,3
" 07","NORTE","MURCIA","TOTAL POBLACION",3,7,10
" 07","NORTE","NAVARRA","ESPAÑOLES",0,1,1
" 07","NORTE","NAVARRA","EXTRANJEROS",0,3,3
" 07","NORTE","NAVARRA","TOTAL POBLACION",0,4,4
" 07","NORTE","PALENCIA","ESPAÑOLES",0,1,1
" 07","NORTE","PALENCIA","TOTAL POBLACION",0,1,1
" 07","NORTE","SALAMANCA","ESPAÑOLES",0,1,1
" 07","NORTE","SALAMANCA","TOTAL POBLACION",0,1,1
" 07","NORTE","SANTA CRUZ DE TENERIFE","ESPAÑOLES",8,11,19
" 07","NORTE","SANTA CRUZ DE TENERIFE","EXTRANJEROS",0,2,2
" 07","NORTE","SANTA CRUZ DE TENERIFE","TOTAL POBLACION",8,13,21
" 07","NORTE","SEVILLA","ESPAÑOLES",359,436,795
" 07","NORTE","SEVILLA","EXTRANJEROS",19,26,45
" 07","NORTE","SEVILLA","TOTAL POBLACION",378,462,840
" 07","NORTE","TARRAGONA","ESPAÑOLES",3,3,6
" 07","NORTE","TARRAGONA","TOTAL POBLACION",3,3,6
" 07","NORTE","TOLEDO","ESPAÑOLES",5,1,6
" 07","NORTE","TOLEDO","TOTAL POBLACION",5,1,6
" 07","NORTE","VALENCIA","ESPAÑOLES",1,0,1
" 07","NORTE","VALENCIA","EXTRANJEROS",1,2,3
" 07","NORTE","VALENCIA","TOTAL POBLACION",2,2,4
" 07","NORTE","VALLADOLID","ESPAÑOLES",2,1,3
" 07","NORTE","VALLADOLID","TOTAL POBLACION",2,1,3
" 07","NORTE","ZAMORA","ESPAÑOLES",0,1,1
" 07","NORTE","ZAMORA","TOTAL POBLACION",0,1,1
" 07","NORTE","ZARAGOZA","ESPAÑOLES",1,0,1
" 07","NORTE","ZARAGOZA","EXTRANJEROS",0,1,1
" 07","NORTE","ZARAGOZA","TOTAL POBLACION",1,1,2
" 08","S. PABLO-STA. JUSTA","- TODOS -","ESPAÑOLES",551,605,1156
" 08","S. PABLO-STA. JUSTA","- TODOS -","EXTRANJEROS",68,88,156
" 08","S. PABLO-STA. JUSTA","- TODOS -","NO CONSTA",1,0,1
" 08","S. PABLO-STA. JUSTA","- TODOS -","TOTAL POBLACION",620,693,1313
" 08","S. PABLO-STA. JUSTA","ALBACETE","ESPAÑOLES",1,0,1
" 08","S. PABLO-STA. JUSTA","ALBACETE","EXTRANJEROS",0,1,1
" 08","S. PABLO-STA. JUSTA","ALBACETE","TOTAL POBLACION",1,1,2
" 08","S. PABLO-STA. JUSTA","ALICANTE","ESPAÑOLES",5,5,10
" 08","S. PABLO-STA. JUSTA","ALICANTE","EXTRANJEROS",1,4,5
" 08","S. PABLO-STA. JUSTA","ALICANTE","TOTAL POBLACION",6,9,15
" 08","S. PABLO-STA. JUSTA","ALMERIA","ESPAÑOLES",1,2,3
" 08","S. PABLO-STA. JUSTA","ALMERIA","TOTAL POBLACION",1,2,3
" 08","S. PABLO-STA. JUSTA","ARABA/ALAVA","EXTRANJEROS",0,1,1
" 08","S. PABLO-STA. JUSTA","ARABA/ALAVA","TOTAL POBLACION",0,1,1
" 08","S. PABLO-STA. JUSTA","ASTURIAS","ESPAÑOLES",2,0,2
" 08","S. PABLO-STA. JUSTA","ASTURIAS","TOTAL POBLACION",2,0,2
" 08","S. PABLO-STA. JUSTA","BADAJOZ","ESPAÑOLES",7,8,15
" 08","S. PABLO-STA. JUSTA","BADAJOZ","EXTRANJEROS",2,1,3
" 08","S. PABLO-STA. JUSTA","BADAJOZ","TOTAL POBLACION",9,9,18
" 08","S. PABLO-STA. JUSTA","BALEARES","ESPAÑOLES",10,13,23
" 08","S. PABLO-STA. JUSTA","BALEARES","EXTRANJEROS",2,3,5
" 08","S. PABLO-STA. JUSTA","BALEARES","TOTAL POBLACION",12,16,28
" 08","S. PABLO-STA. JUSTA","BARCELONA","ESPAÑOLES",14,15,29
" 08","S. PABLO-STA. JUSTA","BARCELONA","EXTRANJEROS",7,8,15
" 08","S. PABLO-STA. JUSTA","BARCELONA","TOTAL POBLACION",21,23,44
" 08","S. PABLO-STA. JUSTA","BIZKAIA","ESPAÑOLES",4,5,9
" 08","S. PABLO-STA. JUSTA","BIZKAIA","EXTRANJEROS",1,0,1
" 08","S. PABLO-STA. JUSTA","BIZKAIA","TOTAL POBLACION",5,5,10
" 08","S. PABLO-STA. JUSTA","CACERES","ESPAÑOLES",3,2,5
" 08","S. PABLO-STA. JUSTA","CACERES","TOTAL POBLACION",3,2,5
" 08","S. PABLO-STA. JUSTA","CADIZ","ESPAÑOLES",35,53,88
" 08","S. PABLO-STA. JUSTA","CADIZ","EXTRANJEROS",4,5,9
" 08","S. PABLO-STA. JUSTA","CADIZ","TOTAL POBLACION",39,58,97
" 08","S. PABLO-STA. JUSTA","CANTABRIA","ESPAÑOLES",0,1,1
" 08","S. PABLO-STA. JUSTA","CANTABRIA","TOTAL POBLACION",0,1,1
" 08","S. PABLO-STA. JUSTA","CASTELLON","EXTRANJEROS",0,1,1
" 08","S. PABLO-STA. JUSTA","CASTELLON","TOTAL POBLACION",0,1,1
" 08","S. PABLO-STA. JUSTA","CEUTA","ESPAÑOLES",0,2,2
" 08","S. PABLO-STA. JUSTA","CEUTA","TOTAL POBLACION",0,2,2
" 08","S. PABLO-STA. JUSTA","CIUDAD REAL","ESPAÑOLES",3,6,9
" 08","S. PABLO-STA. JUSTA","CIUDAD REAL","TOTAL POBLACION",3,6,9
" 08","S. PABLO-STA. JUSTA","CORDOBA","ESPAÑOLES",5,5,10
" 08","S. PABLO-STA. JUSTA","CORDOBA","EXTRANJEROS",1,1,2
" 08","S. PABLO-STA. JUSTA","CORDOBA","TOTAL POBLACION",6,6,12
" 08","S. PABLO-STA. JUSTA","EXTRAJERO","ESPAÑOLES",42,39,81
" 08","S. PABLO-STA. JUSTA","EXTRAJERO","EXTRANJEROS",4,2,6
" 08","S. PABLO-STA. JUSTA","EXTRAJERO","TOTAL POBLACION",46,41,87
" 08","S. PABLO-STA. JUSTA","GERONA","ESPAÑOLES",0,1,1
" 08","S. PABLO-STA. JUSTA","GERONA","TOTAL POBLACION",0,1,1
" 08","S. PABLO-STA. JUSTA","GIPUZKOA","ESPAÑOLES",1,5,6
" 08","S. PABLO-STA. JUSTA","GIPUZKOA","TOTAL POBLACION",1,5,6
" 08","S. PABLO-STA. JUSTA","GRANADA","ESPAÑOLES",5,9,14
" 08","S. PABLO-STA. JUSTA","GRANADA","EXTRANJEROS",2,1,3
" 08","S. PABLO-STA. JUSTA","GRANADA","TOTAL POBLACION",7,10,17
" 08","S. PABLO-STA. JUSTA","GUADALAJARA","ESPAÑOLES",2,0,2
" 08","S. PABLO-STA. JUSTA","GUADALAJARA","TOTAL POBLACION",2,0,2
" 08","S. PABLO-STA. JUSTA","HUELVA","ESPAÑOLES",20,26,46
" 08","S. PABLO-STA. JUSTA","HUELVA","EXTRANJEROS",1,1,2
" 08","S. PABLO-STA. JUSTA","HUELVA","TOTAL POBLACION",21,27,48
" 08","S. PABLO-STA. JUSTA","HUESCA","ESPAÑOLES",3,3,6
" 08","S. PABLO-STA. JUSTA","HUESCA","EXTRANJEROS",1,1,2
" 08","S. PABLO-STA. JUSTA","HUESCA","TOTAL POBLACION",4,4,8
" 08","S. PABLO-STA. JUSTA","JAEN","ESPAÑOLES",4,4,8
" 08","S. PABLO-STA. JUSTA","JAEN","TOTAL POBLACION",4,4,8
" 08","S. PABLO-STA. JUSTA","LA CORUÑA","ESPAÑOLES",2,0,2
" 08","S. PABLO-STA. JUSTA","LA CORUÑA","EXTRANJEROS",1,1,2
" 08","S. PABLO-STA. JUSTA","LA CORUÑA","TOTAL POBLACION",3,1,4
" 08","S. PABLO-STA. JUSTA","LA RIOJA","ESPAÑOLES",1,2,3
" 08","S. PABLO-STA. JUSTA","LA RIOJA","TOTAL POBLACION",1,2,3
" 08","S. PABLO-STA. JUSTA","LAS PALMAS","ESPAÑOLES",8,5,13
" 08","S. PABLO-STA. JUSTA","LAS PALMAS","EXTRANJEROS",2,0,2
" 08","S. PABLO-STA. JUSTA","LAS PALMAS","TOTAL POBLACION",10,5,15
" 08","S. PABLO-STA. JUSTA","LEON","ESPAÑOLES",1,3,4
" 08","S. PABLO-STA. JUSTA","LEON","EXTRANJEROS",1,0,1
" 08","S. PABLO-STA. JUSTA","LEON","TOTAL POBLACION",2,3,5
" 08","S. PABLO-STA. JUSTA","LLEIDA","ESPAÑOLES",1,0,1
" 08","S. PABLO-STA. JUSTA","LLEIDA","TOTAL POBLACION",1,0,1
" 08","S. PABLO-STA. JUSTA","MADRID","ESPAÑOLES",61,61,122
" 08","S. PABLO-STA. JUSTA","MADRID","EXTRANJEROS",5,10,15
" 08","S. PABLO-STA. JUSTA","MADRID","TOTAL POBLACION",66,71,137
" 08","S. PABLO-STA. JUSTA","MALAGA","ESPAÑOLES",14,21,35
" 08","S. PABLO-STA. JUSTA","MALAGA","EXTRANJEROS",6,7,13
" 08","S. PABLO-STA. JUSTA","MALAGA","TOTAL POBLACION",20,28,48
" 08","S. PABLO-STA. JUSTA","MELILLA","ESPAÑOLES",2,1,3
" 08","S. PABLO-STA. JUSTA","MELILLA","TOTAL POBLACION",2,1,3
" 08","S. PABLO-STA. JUSTA","MURCIA","ESPAÑOLES",3,3,6
" 08","S. PABLO-STA. JUSTA","MURCIA","EXTRANJEROS",0,4,4
" 08","S. PABLO-STA. JUSTA","MURCIA","TOTAL POBLACION",3,7,10
" 08","S. PABLO-STA. JUSTA","NAVARRA","ESPAÑOLES",1,0,1
" 08","S. PABLO-STA. JUSTA","NAVARRA","TOTAL POBLACION",1,0,1
" 08","S. PABLO-STA. JUSTA","ORENSE","ESPAÑOLES",1,0,1
" 08","S. PABLO-STA. JUSTA","ORENSE","TOTAL POBLACION",1,0,1
" 08","S. PABLO-STA. JUSTA","PONTEVEDRA","ESPAÑOLES",0,3,3
" 08","S. PABLO-STA. JUSTA","PONTEVEDRA","EXTRANJEROS",0,1,1
" 08","S. PABLO-STA. JUSTA","PONTEVEDRA","TOTAL POBLACION",0,4,4
" 08","S. PABLO-STA. JUSTA","SANTA CRUZ DE TENERIFE","ESPAÑOLES",8,10,18
" 08","S. PABLO-STA. JUSTA","SANTA CRUZ DE TENERIFE","EXTRANJEROS",2,0,2
" 08","S. PABLO-STA. JUSTA","SANTA CRUZ DE TENERIFE","TOTAL POBLACION",10,10,20
" 08","S. PABLO-STA. JUSTA","SEVILLA","ESPAÑOLES",273,282,555
" 08","S. PABLO-STA. JUSTA","SEVILLA","EXTRANJEROS",16,29,45
" 08","S. PABLO-STA. JUSTA","SEVILLA","TOTAL POBLACION",289,311,600
" 08","S. PABLO-STA. JUSTA","TARRAGONA","ESPAÑOLES",3,4,7
" 08","S. PABLO-STA. JUSTA","TARRAGONA","EXTRANJEROS",1,3,4
" 08","S. PABLO-STA. JUSTA","TARRAGONA","NO CONSTA",1,0,1
" 08","S. PABLO-STA. JUSTA","TARRAGONA","TOTAL POBLACION",5,7,12
" 08","S. PABLO-STA. JUSTA","TERUEL","ESPAÑOLES",1,0,1
" 08","S. PABLO-STA. JUSTA","TERUEL","TOTAL POBLACION",1,0,1
" 08","S. PABLO-STA. JUSTA","TOLEDO","ESPAÑOLES",1,1,2
" 08","S. PABLO-STA. JUSTA","TOLEDO","TOTAL POBLACION",1,1,2
" 08","S. PABLO-STA. JUSTA","VALENCIA","ESPAÑOLES",2,4,6
" 08","S. PABLO-STA. JUSTA","VALENCIA","EXTRANJEROS",5,2,7
" 08","S. PABLO-STA. JUSTA","VALENCIA","TOTAL POBLACION",7,6,13
" 08","S. PABLO-STA. JUSTA","ZAMORA","ESPAÑOLES",0,1,1
" 08","S. PABLO-STA. JUSTA","ZAMORA","TOTAL POBLACION",0,1,1
" 08","S. PABLO-STA. JUSTA","ZARAGOZA","ESPAÑOLES",1,0,1
" 08","S. PABLO-STA. JUSTA","ZARAGOZA","EXTRANJEROS",3,1,4
" 08","S. PABLO-STA. JUSTA","ZARAGOZA","TOTAL POBLACION",4,1,5
" 09","ESTE","- TODOS -","ESPAÑOLES",904,932,1836
" 09","ESTE","- TODOS -","EXTRANJEROS",128,132,260
" 09","ESTE","- TODOS -","TOTAL POBLACION",1032,1064,2096
" 09","ESTE","ALBACETE","ESPAÑOLES",1,0,1
" 09","ESTE","ALBACETE","TOTAL POBLACION",1,0,1
" 09","ESTE","ALICANTE","ESPAÑOLES",9,12,21
" 09","ESTE","ALICANTE","EXTRANJEROS",5,7,12
" 09","ESTE","ALICANTE","TOTAL POBLACION",14,19,33
" 09","ESTE","ALMERIA","ESPAÑOLES",13,16,29
" 09","ESTE","ALMERIA","EXTRANJEROS",1,2,3
" 09","ESTE","ALMERIA","TOTAL POBLACION",14,18,32
" 09","ESTE","ARABA/ALAVA","ESPAÑOLES",1,0,1
" 09","ESTE","ARABA/ALAVA","EXTRANJEROS",0,1,1
" 09","ESTE","ARABA/ALAVA","TOTAL POBLACION",1,1,2
" 09","ESTE","ASTURIAS","ESPAÑOLES",2,2,4
" 09","ESTE","ASTURIAS","EXTRANJEROS",0,1,1
" 09","ESTE","ASTURIAS","TOTAL POBLACION",2,3,5
" 09","ESTE","AVILA","ESPAÑOLES",1,0,1
" 09","ESTE","AVILA","TOTAL POBLACION",1,0,1
" 09","ESTE","BADAJOZ","ESPAÑOLES",7,12,19
" 09","ESTE","BADAJOZ","EXTRANJEROS",7,2,9
" 09","ESTE","BADAJOZ","TOTAL POBLACION",14,14,28
" 09","ESTE","BALEARES","ESPAÑOLES",24,30,54
" 09","ESTE","BALEARES","EXTRANJEROS",1,1,2
" 09","ESTE","BALEARES","TOTAL POBLACION",25,31,56
" 09","ESTE","BARCELONA","ESPAÑOLES",30,18,48
" 09","ESTE","BARCELONA","EXTRANJEROS",10,7,17
" 09","ESTE","BARCELONA","TOTAL POBLACION",40,25,65
" 09","ESTE","BIZKAIA","ESPAÑOLES",2,1,3
" 09","ESTE","BIZKAIA","EXTRANJEROS",0,1,1
" 09","ESTE","BIZKAIA","TOTAL POBLACION",2,2,4
" 09","ESTE","BURGOS","ESPAÑOLES",3,2,5
" 09","ESTE","BURGOS","TOTAL POBLACION",3,2,5
" 09","ESTE","CACERES","ESPAÑOLES",1,3,4
" 09","ESTE","CACERES","EXTRANJEROS",1,0,1
" 09","ESTE","CACERES","TOTAL POBLACION",2,3,5
" 09","ESTE","CADIZ","ESPAÑOLES",41,37,78
" 09","ESTE","CADIZ","EXTRANJEROS",4,4,8
" 09","ESTE","CADIZ","TOTAL POBLACION",45,41,86
" 09","ESTE","CANTABRIA","ESPAÑOLES",0,2,2
" 09","ESTE","CANTABRIA","TOTAL POBLACION",0,2,2
" 09","ESTE","CASTELLON","ESPAÑOLES",2,0,2
" 09","ESTE","CASTELLON","TOTAL POBLACION",2,0,2
" 09","ESTE","CEUTA","ESPAÑOLES",4,0,4
" 09","ESTE","CEUTA","EXTRANJEROS",1,0,1
" 09","ESTE","CEUTA","TOTAL POBLACION",5,0,5
" 09","ESTE","CIUDAD REAL","ESPAÑOLES",5,3,8
" 09","ESTE","CIUDAD REAL","EXTRANJEROS",1,0,1
" 09","ESTE","CIUDAD REAL","TOTAL POBLACION",6,3,9
" 09","ESTE","CORDOBA","ESPAÑOLES",24,17,41
" 09","ESTE","CORDOBA","EXTRANJEROS",0,3,3
" 09","ESTE","CORDOBA","TOTAL POBLACION",24,20,44
" 09","ESTE","EXTRAJERO","ESPAÑOLES",37,54,91
" 09","ESTE","EXTRAJERO","EXTRANJEROS",9,4,13
" 09","ESTE","EXTRAJERO","TOTAL POBLACION",46,58,104
" 09","ESTE","GERONA","ESPAÑOLES",2,2,4
" 09","ESTE","GERONA","TOTAL POBLACION",2,2,4
" 09","ESTE","GIPUZKOA","ESPAÑOLES",1,0,1
" 09","ESTE","GIPUZKOA","EXTRANJEROS",3,3,6
" 09","ESTE","GIPUZKOA","TOTAL POBLACION",4,3,7
" 09","ESTE","GRANADA","ESPAÑOLES",10,8,18
" 09","ESTE","GRANADA","EXTRANJEROS",3,1,4
" 09","ESTE","GRANADA","TOTAL POBLACION",13,9,22
" 09","ESTE","GUADALAJARA","ESPAÑOLES",1,1,2
" 09","ESTE","GUADALAJARA","TOTAL POBLACION",1,1,2
" 09","ESTE","HUELVA","ESPAÑOLES",30,35,65
" 09","ESTE","HUELVA","EXTRANJEROS",2,3,5
" 09","ESTE","HUELVA","TOTAL POBLACION",32,38,70
" 09","ESTE","HUESCA","ESPAÑOLES",0,1,1
" 09","ESTE","HUESCA","EXTRANJEROS",2,0,2
" 09","ESTE","HUESCA","TOTAL POBLACION",2,1,3
" 09","ESTE","JAEN","ESPAÑOLES",9,8,17
" 09","ESTE","JAEN","EXTRANJEROS",1,0,1
" 09","ESTE","JAEN","TOTAL POBLACION",10,8,18
" 09","ESTE","LA CORUÑA","ESPAÑOLES",3,2,5
" 09","ESTE","LA CORUÑA","EXTRANJEROS",3,1,4
" 09","ESTE","LA CORUÑA","TOTAL POBLACION",6,3,9
" 09","ESTE","LA RIOJA","EXTRANJEROS",0,1,1
" 09","ESTE","LA RIOJA","TOTAL POBLACION",0,1,1
" 09","ESTE","LAS PALMAS","ESPAÑOLES",27,11,38
" 09","ESTE","LAS PALMAS","EXTRANJEROS",1,4,5
" 09","ESTE","LAS PALMAS","TOTAL POBLACION",28,15,43
" 09","ESTE","LEON","ESPAÑOLES",2,1,3
" 09","ESTE","LEON","TOTAL POBLACION",2,1,3
" 09","ESTE","LLEIDA","ESPAÑOLES",2,0,2
" 09","ESTE","LLEIDA","EXTRANJEROS",1,1,2
" 09","ESTE","LLEIDA","TOTAL POBLACION",3,1,4
" 09","ESTE","LUGO","ESPAÑOLES",1,2,3
" 09","ESTE","LUGO","TOTAL POBLACION",1,2,3
" 09","ESTE","MADRID","ESPAÑOLES",64,60,124
" 09","ESTE","MADRID","EXTRANJEROS",20,22,42
" 09","ESTE","MADRID","TOTAL POBLACION",84,82,166
" 09","ESTE","MALAGA","ESPAÑOLES",22,36,58
" 09","ESTE","MALAGA","EXTRANJEROS",6,12,18
" 09","ESTE","MALAGA","TOTAL POBLACION",28,48,76
" 09","ESTE","MELILLA","ESPAÑOLES",2,2,4
" 09","ESTE","MELILLA","TOTAL POBLACION",2,2,4
" 09","ESTE","MURCIA","ESPAÑOLES",2,6,8
" 09","ESTE","MURCIA","EXTRANJEROS",3,1,4
" 09","ESTE","MURCIA","TOTAL POBLACION",5,7,12
" 09","ESTE","NAVARRA","ESPAÑOLES",1,3,4
" 09","ESTE","NAVARRA","EXTRANJEROS",4,5,9
" 09","ESTE","NAVARRA","TOTAL POBLACION",5,8,13
" 09","ESTE","PONTEVEDRA","ESPAÑOLES",7,4,11
" 09","ESTE","PONTEVEDRA","TOTAL POBLACION",7,4,11
" 09","ESTE","SALAMANCA","ESPAÑOLES",1,1,2
" 09","ESTE","SALAMANCA","TOTAL POBLACION",1,1,2
" 09","ESTE","SANTA CRUZ DE TENERIFE","ESPAÑOLES",19,16,35
" 09","ESTE","SANTA CRUZ DE TENERIFE","EXTRANJEROS",2,1,3
" 09","ESTE","SANTA CRUZ DE TENERIFE","TOTAL POBLACION",21,17,38
" 09","ESTE","SEVILLA","ESPAÑOLES",467,499,966
" 09","ESTE","SEVILLA","EXTRANJEROS",27,37,64
" 09","ESTE","SEVILLA","TOTAL POBLACION",494,536,1030
" 09","ESTE","TARRAGONA","ESPAÑOLES",2,6,8
" 09","ESTE","TARRAGONA","EXTRANJEROS",0,1,1
" 09","ESTE","TARRAGONA","TOTAL POBLACION",2,7,9
" 09","ESTE","TOLEDO","ESPAÑOLES",2,3,5
" 09","ESTE","TOLEDO","EXTRANJEROS",1,1,2
" 09","ESTE","TOLEDO","TOTAL POBLACION",3,4,7
" 09","ESTE","VALENCIA","ESPAÑOLES",11,7,18
" 09","ESTE","VALENCIA","EXTRANJEROS",4,1,5
" 09","ESTE","VALENCIA","TOTAL POBLACION",15,8,23
" 09","ESTE","VALLADOLID","ESPAÑOLES",2,1,3
" 09","ESTE","VALLADOLID","TOTAL POBLACION",2,1,3
" 09","ESTE","ZAMORA","ESPAÑOLES",0,1,1
" 09","ESTE","ZAMORA","TOTAL POBLACION",0,1,1
" 09","ESTE","ZARAGOZA","ESPAÑOLES",7,7,14
" 09","ESTE","ZARAGOZA","EXTRANJEROS",5,4,9
" 09","ESTE","ZARAGOZA","TOTAL POBLACION",12,11,23
" 10","BELLAVISTA-LA PALMERA","- TODOS -","ESPAÑOLES",534,475,1009
" 10","BELLAVISTA-LA PALMERA","- TODOS -","EXTRANJEROS",57,75,132
" 10","BELLAVISTA-LA PALMERA","- TODOS -","TOTAL POBLACION",591,550,1141
" 10","BELLAVISTA-LA PALMERA","ALBACETE","ESPAÑOLES",1,1,2
" 10","BELLAVISTA-LA PALMERA","ALBACETE","TOTAL POBLACION",1,1,2
" 10","BELLAVISTA-LA PALMERA","ALICANTE","ESPAÑOLES",7,0,7
" 10","BELLAVISTA-LA PALMERA","ALICANTE","TOTAL POBLACION",7,0,7
" 10","BELLAVISTA-LA PALMERA","ALMERIA","ESPAÑOLES",0,2,2
" 10","BELLAVISTA-LA PALMERA","ALMERIA","TOTAL POBLACION",0,2,2
" 10","BELLAVISTA-LA PALMERA","ARABA/ALAVA","ESPAÑOLES",0,1,1
" 10","BELLAVISTA-LA PALMERA","ARABA/ALAVA","TOTAL POBLACION",0,1,1
" 10","BELLAVISTA-LA PALMERA","ASTURIAS","ESPAÑOLES",2,2,4
" 10","BELLAVISTA-LA PALMERA","ASTURIAS","TOTAL POBLACION",2,2,4
" 10","BELLAVISTA-LA PALMERA","AVILA","ESPAÑOLES",2,2,4
" 10","BELLAVISTA-LA PALMERA","AVILA","TOTAL POBLACION",2,2,4
" 10","BELLAVISTA-LA PALMERA","BADAJOZ","ESPAÑOLES",6,1,7
" 10","BELLAVISTA-LA PALMERA","BADAJOZ","TOTAL POBLACION",6,1,7
" 10","BELLAVISTA-LA PALMERA","BALEARES","ESPAÑOLES",14,8,22
" 10","BELLAVISTA-LA PALMERA","BALEARES","EXTRANJEROS",1,1,2
" 10","BELLAVISTA-LA PALMERA","BALEARES","TOTAL POBLACION",15,9,24
" 10","BELLAVISTA-LA PALMERA","BARCELONA","ESPAÑOLES",15,7,22
" 10","BELLAVISTA-LA PALMERA","BARCELONA","EXTRANJEROS",5,6,11
" 10","BELLAVISTA-LA PALMERA","BARCELONA","TOTAL POBLACION",20,13,33
" 10","BELLAVISTA-LA PALMERA","BIZKAIA","ESPAÑOLES",1,0,1
" 10","BELLAVISTA-LA PALMERA","BIZKAIA","EXTRANJEROS",1,2,3
" 10","BELLAVISTA-LA PALMERA","BIZKAIA","TOTAL POBLACION",2,2,4
" 10","BELLAVISTA-LA PALMERA","BURGOS","ESPAÑOLES",1,0,1
" 10","BELLAVISTA-LA PALMERA","BURGOS","TOTAL POBLACION",1,0,1
" 10","BELLAVISTA-LA PALMERA","CACERES","ESPAÑOLES",5,2,7
" 10","BELLAVISTA-LA PALMERA","CACERES","EXTRANJEROS",1,0,1
" 10","BELLAVISTA-LA PALMERA","CACERES","TOTAL POBLACION",6,2,8
" 10","BELLAVISTA-LA PALMERA","CADIZ","ESPAÑOLES",27,35,62
" 10","BELLAVISTA-LA PALMERA","CADIZ","EXTRANJEROS",0,1,1
" 10","BELLAVISTA-LA PALMERA","CADIZ","TOTAL POBLACION",27,36,63
" 10","BELLAVISTA-LA PALMERA","CANTABRIA","ESPAÑOLES",1,0,1
" 10","BELLAVISTA-LA PALMERA","CANTABRIA","EXTRANJEROS",0,1,1
" 10","BELLAVISTA-LA PALMERA","CANTABRIA","TOTAL POBLACION",1,1,2
" 10","BELLAVISTA-LA PALMERA","CASTELLON","ESPAÑOLES",2,0,2
" 10","BELLAVISTA-LA PALMERA","CASTELLON","TOTAL POBLACION",2,0,2
" 10","BELLAVISTA-LA PALMERA","CEUTA","ESPAÑOLES",3,1,4
" 10","BELLAVISTA-LA PALMERA","CEUTA","TOTAL POBLACION",3,1,4
" 10","BELLAVISTA-LA PALMERA","CIUDAD REAL","ESPAÑOLES",0,2,2
" 10","BELLAVISTA-LA PALMERA","CIUDAD REAL","TOTAL POBLACION",0,2,2
" 10","BELLAVISTA-LA PALMERA","CORDOBA","ESPAÑOLES",10,9,19
" 10","BELLAVISTA-LA PALMERA","CORDOBA","EXTRANJEROS",2,1,3
" 10","BELLAVISTA-LA PALMERA","CORDOBA","TOTAL POBLACION",12,10,22
" 10","BELLAVISTA-LA PALMERA","EXTRAJERO","ESPAÑOLES",38,38,76
" 10","BELLAVISTA-LA PALMERA","EXTRAJERO","EXTRANJEROS",4,2,6
" 10","BELLAVISTA-LA PALMERA","EXTRAJERO","TOTAL POBLACION",42,40,82
" 10","BELLAVISTA-LA PALMERA","GERONA","ESPAÑOLES",1,3,4
" 10","BELLAVISTA-LA PALMERA","GERONA","EXTRANJEROS",1,0,1
" 10","BELLAVISTA-LA PALMERA","GERONA","TOTAL POBLACION",2,3,5
" 10","BELLAVISTA-LA PALMERA","GIPUZKOA","ESPAÑOLES",0,1,1
" 10","BELLAVISTA-LA PALMERA","GIPUZKOA","EXTRANJEROS",2,3,5
" 10","BELLAVISTA-LA PALMERA","GIPUZKOA","TOTAL POBLACION",2,4,6
" 10","BELLAVISTA-LA PALMERA","GRANADA","ESPAÑOLES",4,4,8
" 10","BELLAVISTA-LA PALMERA","GRANADA","TOTAL POBLACION",4,4,8
" 10","BELLAVISTA-LA PALMERA","GUADALAJARA","EXTRANJEROS",1,1,2
" 10","BELLAVISTA-LA PALMERA","GUADALAJARA","TOTAL POBLACION",1,1,2
" 10","BELLAVISTA-LA PALMERA","HUELVA","ESPAÑOLES",10,13,23
" 10","BELLAVISTA-LA PALMERA","HUELVA","EXTRANJEROS",1,3,4
" 10","BELLAVISTA-LA PALMERA","HUELVA","TOTAL POBLACION",11,16,27
" 10","BELLAVISTA-LA PALMERA","HUESCA","ESPAÑOLES",0,1,1
" 10","BELLAVISTA-LA PALMERA","HUESCA","TOTAL POBLACION",0,1,1
" 10","BELLAVISTA-LA PALMERA","JAEN","ESPAÑOLES",2,7,9
" 10","BELLAVISTA-LA PALMERA","JAEN","EXTRANJEROS",1,0,1
" 10","BELLAVISTA-LA PALMERA","JAEN","TOTAL POBLACION",3,7,10
" 10","BELLAVISTA-LA PALMERA","LA CORUÑA","ESPAÑOLES",4,3,7
" 10","BELLAVISTA-LA PALMERA","LA CORUÑA","TOTAL POBLACION",4,3,7
" 10","BELLAVISTA-LA PALMERA","LAS PALMAS","ESPAÑOLES",17,11,28
" 10","BELLAVISTA-LA PALMERA","LAS PALMAS","EXTRANJEROS",1,1,2
" 10","BELLAVISTA-LA PALMERA","LAS PALMAS","TOTAL POBLACION",18,12,30
" 10","BELLAVISTA-LA PALMERA","LEON","EXTRANJEROS",0,1,1
" 10","BELLAVISTA-LA PALMERA","LEON","TOTAL POBLACION",0,1,1
" 10","BELLAVISTA-LA PALMERA","LLEIDA","ESPAÑOLES",0,1,1
" 10","BELLAVISTA-LA PALMERA","LLEIDA","TOTAL POBLACION",0,1,1
" 10","BELLAVISTA-LA PALMERA","LUGO","EXTRANJEROS",1,0,1
" 10","BELLAVISTA-LA PALMERA","LUGO","TOTAL POBLACION",1,0,1
" 10","BELLAVISTA-LA PALMERA","MADRID","ESPAÑOLES",69,61,130
" 10","BELLAVISTA-LA PALMERA","MADRID","EXTRANJEROS",4,9,13
" 10","BELLAVISTA-LA PALMERA","MADRID","TOTAL POBLACION",73,70,143
" 10","BELLAVISTA-LA PALMERA","MALAGA","ESPAÑOLES",19,13,32
" 10","BELLAVISTA-LA PALMERA","MALAGA","EXTRANJEROS",1,5,6
" 10","BELLAVISTA-LA PALMERA","MALAGA","TOTAL POBLACION",20,18,38
" 10","BELLAVISTA-LA PALMERA","MELILLA","ESPAÑOLES",2,0,2
" 10","BELLAVISTA-LA PALMERA","MELILLA","TOTAL POBLACION",2,0,2
" 10","BELLAVISTA-LA PALMERA","MURCIA","ESPAÑOLES",3,0,3
" 10","BELLAVISTA-LA PALMERA","MURCIA","EXTRANJEROS",0,1,1
" 10","BELLAVISTA-LA PALMERA","MURCIA","TOTAL POBLACION",3,1,4
" 10","BELLAVISTA-LA PALMERA","NAVARRA","ESPAÑOLES",1,1,2
" 10","BELLAVISTA-LA PALMERA","NAVARRA","TOTAL POBLACION",1,1,2
" 10","BELLAVISTA-LA PALMERA","PONTEVEDRA","ESPAÑOLES",1,1,2
" 10","BELLAVISTA-LA PALMERA","PONTEVEDRA","EXTRANJEROS",1,0,1
" 10","BELLAVISTA-LA PALMERA","PONTEVEDRA","TOTAL POBLACION",2,1,3
" 10","BELLAVISTA-LA PALMERA","SANTA CRUZ DE TENERIFE","ESPAÑOLES",5,2,7
" 10","BELLAVISTA-LA PALMERA","SANTA CRUZ DE TENERIFE","EXTRANJEROS",0,1,1
" 10","BELLAVISTA-LA PALMERA","SANTA CRUZ DE TENERIFE","TOTAL POBLACION",5,3,8
" 10","BELLAVISTA-LA PALMERA","SEVILLA","ESPAÑOLES",244,235,479
" 10","BELLAVISTA-LA PALMERA","SEVILLA","EXTRANJEROS",25,31,56
" 10","BELLAVISTA-LA PALMERA","SEVILLA","TOTAL POBLACION",269,266,535
" 10","BELLAVISTA-LA PALMERA","TARRAGONA","ESPAÑOLES",2,1,3
" 10","BELLAVISTA-LA PALMERA","TARRAGONA","TOTAL POBLACION",2,1,3
" 10","BELLAVISTA-LA PALMERA","TOLEDO","ESPAÑOLES",5,2,7
" 10","BELLAVISTA-LA PALMERA","TOLEDO","EXTRANJEROS",0,1,1
" 10","BELLAVISTA-LA PALMERA","TOLEDO","TOTAL POBLACION",5,3,8
" 10","BELLAVISTA-LA PALMERA","VALENCIA","ESPAÑOLES",5,2,7
" 10","BELLAVISTA-LA PALMERA","VALENCIA","EXTRANJEROS",1,0,1
" 10","BELLAVISTA-LA PALMERA","VALENCIA","TOTAL POBLACION",6,2,8
" 10","BELLAVISTA-LA PALMERA","VALLADOLID","ESPAÑOLES",1,0,1
" 10","BELLAVISTA-LA PALMERA","VALLADOLID","EXTRANJEROS",2,1,3
" 10","BELLAVISTA-LA PALMERA","VALLADOLID","TOTAL POBLACION",3,1,4
" 10","BELLAVISTA-LA PALMERA","ZARAGOZA","ESPAÑOLES",4,2,6
" 10","BELLAVISTA-LA PALMERA","ZARAGOZA","EXTRANJEROS",1,3,4
" 10","BELLAVISTA-LA PALMERA","ZARAGOZA","TOTAL POBLACION",5,5,10
" 11","LOS REMEDIOS","- TODOS -","ESPAÑOLES",291,308,599
" 11","LOS REMEDIOS","- TODOS -","EXTRANJEROS",25,38,63
" 11","LOS REMEDIOS","- TODOS -","TOTAL POBLACION",316,346,662
" 11","LOS REMEDIOS","ALBACETE","ESPAÑOLES",1,1,2
" 11","LOS REMEDIOS","ALBACETE","TOTAL POBLACION",1,1,2
" 11","LOS REMEDIOS","ALICANTE","ESPAÑOLES",1,0,1
" 11","LOS REMEDIOS","ALICANTE","EXTRANJEROS",2,0,2
" 11","LOS REMEDIOS","ALICANTE","TOTAL POBLACION",3,0,3
" 11","LOS REMEDIOS","ALMERIA","ESPAÑOLES",0,1,1
" 11","LOS REMEDIOS","ALMERIA","TOTAL POBLACION",0,1,1
" 11","LOS REMEDIOS","BADAJOZ","ESPAÑOLES",1,1,2
" 11","LOS REMEDIOS","BADAJOZ","TOTAL POBLACION",1,1,2
" 11","LOS REMEDIOS","BALEARES","ESPAÑOLES",4,4,8
" 11","LOS REMEDIOS","BALEARES","EXTRANJEROS",4,2,6
" 11","LOS REMEDIOS","BALEARES","TOTAL POBLACION",8,6,14
" 11","LOS REMEDIOS","BARCELONA","ESPAÑOLES",6,15,21
" 11","LOS REMEDIOS","BARCELONA","EXTRANJEROS",3,5,8
" 11","LOS REMEDIOS","BARCELONA","TOTAL POBLACION",9,20,29
" 11","LOS REMEDIOS","BIZKAIA","ESPAÑOLES",0,1,1
" 11","LOS REMEDIOS","BIZKAIA","EXTRANJEROS",1,1,2
" 11","LOS REMEDIOS","BIZKAIA","TOTAL POBLACION",1,2,3
" 11","LOS REMEDIOS","CACERES","ESPAÑOLES",0,1,1
" 11","LOS REMEDIOS","CACERES","TOTAL POBLACION",0,1,1
" 11","LOS REMEDIOS","CADIZ","ESPAÑOLES",18,17,35
" 11","LOS REMEDIOS","CADIZ","TOTAL POBLACION",18,17,35
" 11","LOS REMEDIOS","CASTELLON","ESPAÑOLES",1,1,2
" 11","LOS REMEDIOS","CASTELLON","EXTRANJEROS",1,0,1
" 11","LOS REMEDIOS","CASTELLON","TOTAL POBLACION",2,1,3
" 11","LOS REMEDIOS","CEUTA","ESPAÑOLES",0,2,2
" 11","LOS REMEDIOS","CEUTA","TOTAL POBLACION",0,2,2
" 11","LOS REMEDIOS","CIUDAD REAL","ESPAÑOLES",1,1,2
" 11","LOS REMEDIOS","CIUDAD REAL","TOTAL POBLACION",1,1,2
" 11","LOS REMEDIOS","CORDOBA","ESPAÑOLES",4,2,6
" 11","LOS REMEDIOS","CORDOBA","TOTAL POBLACION",4,2,6
" 11","LOS REMEDIOS","EXTRAJERO","ESPAÑOLES",33,32,65
" 11","LOS REMEDIOS","EXTRAJERO","EXTRANJEROS",1,3,4
" 11","LOS REMEDIOS","EXTRAJERO","TOTAL POBLACION",34,35,69
" 11","LOS REMEDIOS","GRANADA","ESPAÑOLES",1,1,2
" 11","LOS REMEDIOS","GRANADA","TOTAL POBLACION",1,1,2
" 11","LOS REMEDIOS","HUELVA","ESPAÑOLES",11,12,23
" 11","LOS REMEDIOS","HUELVA","EXTRANJEROS",0,3,3
" 11","LOS REMEDIOS","HUELVA","TOTAL POBLACION",11,15,26
" 11","LOS REMEDIOS","HUESCA","EXTRANJEROS",1,0,1
" 11","LOS REMEDIOS","HUESCA","TOTAL POBLACION",1,0,1
" 11","LOS REMEDIOS","LA CORUÑA","ESPAÑOLES",0,2,2
" 11","LOS REMEDIOS","LA CORUÑA","EXTRANJEROS",0,1,1
" 11","LOS REMEDIOS","LA CORUÑA","TOTAL POBLACION",0,3,3
" 11","LOS REMEDIOS","LA RIOJA","ESPAÑOLES",0,2,2
" 11","LOS REMEDIOS","LA RIOJA","EXTRANJEROS",1,0,1
" 11","LOS REMEDIOS","LA RIOJA","TOTAL POBLACION",1,2,3
" 11","LOS REMEDIOS","LAS PALMAS","ESPAÑOLES",7,7,14
" 11","LOS REMEDIOS","LAS PALMAS","TOTAL POBLACION",7,7,14
" 11","LOS REMEDIOS","LEON","ESPAÑOLES",0,1,1
" 11","LOS REMEDIOS","LEON","EXTRANJEROS",1,0,1
" 11","LOS REMEDIOS","LEON","TOTAL POBLACION",1,1,2
" 11","LOS REMEDIOS","LLEIDA","ESPAÑOLES",0,1,1
" 11","LOS REMEDIOS","LLEIDA","TOTAL POBLACION",0,1,1
" 11","LOS REMEDIOS","MADRID","ESPAÑOLES",45,43,88
" 11","LOS REMEDIOS","MADRID","EXTRANJEROS",2,6,8
" 11","LOS REMEDIOS","MADRID","TOTAL POBLACION",47,49,96
" 11","LOS REMEDIOS","MALAGA","ESPAÑOLES",10,10,20
" 11","LOS REMEDIOS","MALAGA","EXTRANJEROS",1,1,2
" 11","LOS REMEDIOS","MALAGA","TOTAL POBLACION",11,11,22
" 11","LOS REMEDIOS","MELILLA","ESPAÑOLES",0,2,2
" 11","LOS REMEDIOS","MELILLA","TOTAL POBLACION",0,2,2
" 11","LOS REMEDIOS","MURCIA","ESPAÑOLES",1,5,6
" 11","LOS REMEDIOS","MURCIA","EXTRANJEROS",0,1,1
" 11","LOS REMEDIOS","MURCIA","TOTAL POBLACION",1,6,7
" 11","LOS REMEDIOS","ORENSE","ESPAÑOLES",0,1,1
" 11","LOS REMEDIOS","ORENSE","TOTAL POBLACION",0,1,1
" 11","LOS REMEDIOS","PONTEVEDRA","ESPAÑOLES",2,3,5
" 11","LOS REMEDIOS","PONTEVEDRA","TOTAL POBLACION",2,3,5
" 11","LOS REMEDIOS","SALAMANCA","ESPAÑOLES",1,0,1
" 11","LOS REMEDIOS","SALAMANCA","TOTAL POBLACION",1,0,1
" 11","LOS REMEDIOS","SANTA CRUZ DE TENERIFE","ESPAÑOLES",6,3,9
" 11","LOS REMEDIOS","SANTA CRUZ DE TENERIFE","TOTAL POBLACION",6,3,9
" 11","LOS REMEDIOS","SEVILLA","ESPAÑOLES",133,133,266
" 11","LOS REMEDIOS","SEVILLA","EXTRANJEROS",7,14,21
" 11","LOS REMEDIOS","SEVILLA","TOTAL POBLACION",140,147,287
" 11","LOS REMEDIOS","TOLEDO","ESPAÑOLES",0,1,1
" 11","LOS REMEDIOS","TOLEDO","EXTRANJEROS",0,1,1
" 11","LOS REMEDIOS","TOLEDO","TOTAL POBLACION",0,2,2
" 11","LOS REMEDIOS","VALENCIA","ESPAÑOLES",4,2,6
" 11","LOS REMEDIOS","VALENCIA","TOTAL POBLACION",4,2,6
